的	白勹丶
了	了
我	手戈
是	日一止
在	大丨土
你	亻⺈小
和	禾口
有	大月
不	不
就	亠口小尤
都	者阝
也	也
要	西女
邑	口巴
好	女子
他	亻也
去	土厶
到	至刂
上	上
那	刀二阝
入	人
看	手目
中	中
呢	口尸匕
她	女也
等	⺮土寸
用	用
把	扌巴
下	一卜
恩	因大心
能	厶月匕匕
很	行艮
多	夕夕
做	亻十口攵
想	木目心
被	衤皮
地	土也
而	而
一	一
又	又
再	一冂土
但	亻日一
打	扌丁
大	大
年	矢㐄
啦	口扌立
以	厶人
着	羊目
小	小
得	行日一寸
先	牛儿
啊	口阝丁口
或	戈口一
呀	口牙
找	扌戈
新	立木斤
及	㇆人
跟	足艮
犬	大丶
嘛	口广木木
日	日
才	寸丿
可	丁口
比	匕匕
玩	王二儿
最	日耳又
月	月
真	十且八
吃	口矢乙
它	宀匕
其	其
叫	口凵
出	凵山
哈	口人一口
向	自口
家	宀豕
之	之
更	一日乂
走	走
快	忄㇕大
前	䒑月刂
由	由
高	亠口冂口
您	亻⺈小心
加	力口
所	斤㇕斤
天	一大
己	己
里	甲二
啥	口人舌
老	者匕
搞	扌亠冂口
行	行
事	寸口彐
拿	人一口手
如	女口
死	一夕匕
像	亻⺈口豕
使	亻大口丶
成	戊㇆
叭	口八
哪	口刀二阝
回	因口
少	小丿
元	二儿
卡	上卜
靠	牛口非
算	⺮目艹
者	者
忙	忄亡
起	走己
各	夂口
分	八刀
水	水
改	己攵
唉	口厶矢
三	三
放	方攵
全	人王
按	扌宀女
早	日十
拉	扌立
弄	王艹
本	木一
偶	亻日冂厶
性	忄生
第	⺮弓亻
完	宀二儿
同	冂一口
花	艹亻匕
怕	忄白
女	女
些	止匕二
住	亻丶王
名	夕口
跑	足勹巳
次	冫欠
睡	目千艹二
哦	口手戈
挺	扌廴丿士
王	王
掉	扌卜日十
路	足夂口
正	一止
外	夕卜
二	二
生	生
心	心
因	因大
子	子
作	亻矢卜
送	之䒑大
每	矢母
法	氵土厶
乖	千丬匕
拍	扌白
市	亠巾
撒	扌廿月攵
至	至
接	扌立女
美	羊大
表	丰𧘇
未	二小
非	非
即	艮冂
哎	口艹乂
此	止匕
差	羊工
版	片斤又
副	一口田刂
系	丿絲
收	凵攵
男	田力
俺	亻大日乚
字	宀子
股	月殳
便	亻一日乂
考	者了
手	手
道	之䒑自
米	米
座	广人人土
聊	耳氏冂
取	耳又
低	亻氏丶
哇	口土土
受	爪冖又
包	勹巳
阿	阝丁口
喝	口日人乚
白	白
金	金
四	四
近	之斤
管	⺮宀㠯
定	宀一止
交	亠八乂
李	木子
笑	⺮丿大
自	自
型	一艹刂土
黑	四二灬
慢	忄日四又
刷	尸巾刂
穿	穴牙
越	走戈乚
位	亻立
部	立口阝
站	立卜口
牛	牛
怪	忄又土
省	小丿目
倒	亻至刂
曾	丷四日
累	田絲
汗	氵一十
查	木日一
象	⺈口豕
半	半
格	木夂口
五	工㇕
方	方
某	甘木
海	氵矢母
相	木目
光	小尤
咋	口矢卜
且	且
林	木木
化	亻匕
班	王刂王
滴	氵亠十口
店	广卜口
安	宀女
坐	人人土
度	广廿又
俄	亻手戈
歌	丁口口欠
信	亻言
若	艹大口
原	厂白小
文	文
冕	日⺈口儿
量	日一甲二
村	木寸
式	弋工
空	穴工
山	山
毛	毛
重	千日二
主	丶王
另	口力
伐	亻戈
血	丿皿
爽	大乂乂乂
往	行丶王
片	片
狗	犭勹口
共	廿八
西	西
周	冂土口
超	走刀口
明	日月
均	土勹冫
期	其月
照	日刀口灬
切	七刀
留	氏丶刀田
特	牛土寸
神	礻申
教	者子攵
哥	丁口丁口
甘	甘
值	亻十且
么	丿厶
陪	阝立口
既	艮七儿
獸	口口大丶
力	力
建	廴彐二
洗	氵牛儿
懂	忄艹日二
口	口
指	扌匕日
球	王寸氵丶
仍	亻㇆丿
活	氵舌
跌	足牛人
清	氵丰月
提	扌日一止
除	阝人禾
通	之又用
酒	氵酉
票	西示
六	亠八
病	疒
假	亻㇕㇕又
久	⺈丶
段	亻三殳
平	丁䒑
抓	扌爪
套	大長
急	⺈彐心
城	土戊㇆
任	亻丿士
草	艹日十
理	王甲二
令	人之
雨	雨
唱	口日日
左	大工
常	小冖口巾
色	⺈巴
菜	艹爪木
集	隹木
感	戊一口心
房	户方
混	氵日匕匕
敢	㇕耳攵
火	火
操	扌口口木
南	十冂半
退	之艮
件	亻牛
破	石皮
德	行十一心
雪	雨彐
局	尸㇆口
整	木口一止
傻	亻鬼八夂
克	十口儿
喊	口戊一口
跳	足氵儿
沈	氵冖儿
反	斤又
篇	⺮户冂艹
待	行土寸
砸	石匚巾
深	氵冖八木
根	木艮
求	寸氵丶
投	扌殳
款	士示欠
知	矢口
八	八
配	酉己
器	口口大口
何	亻丁口
率	亠幺氵十
鬼	鬼
修	亻丨夂彡
面	石因卜丨
北	丬匕
木	木
份	亻八刀
情	忄丰月
肉	冂人人
需	雨而
七	七
流	氵亠厶川
招	扌刀口
痛	疒又用
列	一夕刂
石	石
香	禾日
封	土土寸
眼	目艮
易	日勹彡
冷	冫人之
借	亻廿日
派	氵斤氏
付	亻寸
十	十
油	氵由
胡	十口月
排	扌非
停	亻亠冖丁
合	人一口
身	身
章	立日十
科	禾冫十
星	日生
牌	片鬼十
翻	釆田习习
帖	巾卜口
商	亠丷八口
物	牛勹彡
泡	氵勹巳
玉	王丶
追	之丿㠯
背	丬匕月
解	⺈用刀牛
室	宀至
底	广氏丶
代	亻弋
朱	牛小
亦	亠川八
乾	十日矢乙
工	工
咱	口自
刀	刀
波	氵皮
推	扌隹
落	艹氵夂口
春	春
笨	⺮木一
九	九
江	氵工
短	矢一口䒑
含	人丶㇕口
千	千
炒	火小丿
藉	艹三廿日
丫	丷丨
徐	行人禾
秒	禾小丿
青	丰月
耍	而女
夜	亠亻夂丶
吹	口欠
板	木斤又
土	土
姐	女且
直	十且
公	八厶
苦	艹十口
秀	禾㇆丿
博	十甫寸
皮	皮
朝	十日十月
君	尹口
利	禾刂
素	丰絲
立	立
存	大丨子
吾	一韋口
民	巳七
命	人一口冂
忘	亡心
茶	艹人木
冰	冫水
供	亻廿八
案	宀女木
田	田
初	衤刀
品	口口口
抽	扌由
造	之牛口
抱	扌勹巳
野	甲二㇕丨
胖	月半
故	十口攵
服	月冂又
百	一白
兵	丘八
英	艹冂大
般	舟殳
演	氵宀由八
嘴	口止⺈用
填	土十且八
果	日木
保	亻口木
唐	广彐口
夏	一自夂
莫	艹日大
硬	石一日乂
寒	宀甘八冫
挖	扌穴乙
凡	凡
言	言
防	阝方
街	行土土
距	足匚㇕
挑	扌氵儿
欲	八人口欠
竟	立日儿
源	氵厂白小
官	宀㠯
寄	宀大丁口
古	十口
首	䒑自
思	田心
郭	亠口子阝
亮	亠口冖几
干	一十
粉	米八刀
爆	火日八水
戴	土田八戈
然	夕大丶灬
疼	疒夂冫
雷	雨田
港	氵廿八巳
租	禾且
狼	犭丶艮
狂	犭王
布	大巾
弔	弓丨
捏	扌日土
佛	亻弓川
食	食
船	舟几口
今	人丶㇕
恨	忄艮
宋	宀木
猛	犭子皿
客	宀夂口
友	大又
句	勹口
斯	其斤
沙	氵小丿
哼	口亠口了
望	亡月王
腿	月之艮
丁	丁
祝	礻口儿
界	田八川
抗	扌亠几
步	止小
河	氵丁口
缺	牛山㇕大
尚	小冂口
似	亻厶人
羊	羊
福	礻一口田
必	心丿
遭	之艹日日
否	不口
端	立山而
猜	犭丰月
伊	亻尹
秦	春禾
秋	禾火
毒	丰母
架	力口木
熊	厶月匕灬
持	扌土寸
插	扌千臼
折	扌斤
意	立日心
呆	口木
基	其土
困	因木
圈	因半巳
迷	之米
踢	足日勹彡
史	口乂
甲	甲
呵	口丁口
搬	扌舟殳
乃	㇆丿
右	大口
塔	土艹一口
拖	扌矢也
摸	扌艹日大
院	阝宀二儿
散	廿月攵
松	木人厶
爸	八乂巴
喜	士口䒑口
洋	氵羊
呈	口王
治	氵厶口
降	阝夂㐄
富	宀一口田
姓	女生
料	米冫十
咬	口亠八乂
梅	木矢母
批	扌匕匕
足	足
爬	爪巴
醒	酉日生
狠	犭艮
逛	之犭王
精	米丰月
瘦	疒臼丨又
踩	足釆
偷	亻人月刂
支	十又
杜	木土
鞋	革土土
展	尸艹展
咧	口一夕刂
依	亻亠𧘇
倍	亻立口
康	广彐氵
堂	小冖口土
救	寸氵丶攵
音	立日
世	廿乚
著	艹者
仲	亻中
舞	矢廿夕㐄
守	宀寸
露	雨足夂口
冒	日目
弱	弓冫弓冫
影	日亠小彡
州	⺍川
替	夫夫日
逼	之一口田
曲	日刂
牙	牙
箱	⺮木目
遍	之户冂艹
巴	巴
武	一弋止
湖	氵十口月
程	禾口王
柳	木氏丿冂
偏	亻户冂艹
印	氏一冂
味	口二小
零	雨人之
角	⺈用
紫	止匕絲
勒	革力
熟	亠口丸灬
孔	子乚
寸	寸
厚	厂日子
答	⺮人一口
社	礻土
兼	䒑彐刂八
娘	女丶艮
登	癶一口䒑
微	行山几攵
佳	亻土土
瞭	目人日小
雅	牙隹
魔	广木木鬼
司	㇆一口
志	士心
奇	大丁口
瓦	一乚㇆丶
居	尸十口
盛	戊㇆皿
奶	女㇆丿
虎	虎
后	斤一口
洞	氵冂一口
台	厶口
形	一艹彡
川	川
充	亠厶儿
害	宀丰口
喂	口田展
免	⺈口儿
晾	日亠口小
曹	艹日日
煮	者灬
良	丶艮
蛋	㇕止虫
吐	口土
肥	月巴
仙	亻山
碰	石䒑业
酸	酉厶八夂
侯	亻㇕矢
塞	宀甘八土
欠	欠
擦	扌宀夗示
藏	艹戈爿臣
皆	匕匕白
屁	尸匕匕
永	丶水
夫	夫
琴	王王丶㇕
宏	宀大厶
例	亻一夕刂
砍	石欠
兄	口儿
善	羊䒑口
增	土丷四日
施	方矢也
暗	日立日
忍	刀丶心
肯	止月
母	母
艾	艹乂
致	至攵
宗	宀示
麻	广木木
怒	女又心
扔	扌㇆丿
游	氵方矢子
腰	月西女
嫩	女木口攵
肖	小月
罪	四非
仔	亻子
丑	㇕十
敏	矢母攵
棒	木春工
臭	自大丶
拆	扌斤丶
蔡	艹夗示
校	木亠八乂
氏	氏
糖	米广彐口
吉	士口
押	扌甲
吵	口小丿
谷	八人口
衣	亠𧘇
宇	宀一寸
末	一木
潘	氵釆田
告	牛口
旁	亠丷冖方
耐	而寸
董	艹千日二
榜	木亠冖方
醉	酉亠人十
妹	女二小
宜	宀且
尼	尸匕
灰	大火
屋	尸至
楚	木木㇕止
丹	冂亠
乘	丿木丬匕
刻	亠乡人刂
俊	亻厶八夂
芳	艹方
抄	扌小丿
酷	酉牛口
京	亠口小
返	之斤又
瑞	王山而
仁	亻二
添	氵一大忄
催	亻山隹
具	且八
威	戊一女
核	木亠乡人
瓶	䒑艹㇆丶
犯	犭巳
族	方矢矢
季	禾子
骨	骨
嘿	口四二灬
黎	禾勹人水
密	宀心丿山
士	士
炸	火矢卜
洪	氵廿八
容	穴人口
射	身寸
智	矢口日
索	十冖絲
聚	耳又豕
拼	扌䒑艹
燕	廿口匕灬
撞	扌立甲二
膜	月艹日大
普	䒑业日
竹	⺮
魏	禾女鬼
范	艹氵巳
搭	扌艹一口
袁	土口𧘇
扯	扌止
彭	士口䒑彡
薄	艹氵甫寸
曰	因一
胃	田月
堆	土隹
赴	走卜
躲	身几木
孟	子皿
抵	扌氏丶
甜	舌甘
彩	爪木彡
甚	其乚
粗	米且
申	申
念	人丶㇕心
惹	艹大口心
盒	人一口皿
逃	之氵儿
嘉	士口力口
升	丿艹
姚	女氵儿
休	亻木
症	疒一止
斤	斤
功	工力
喇	口木口刂
浪	氵丶艮
扣	扌口
泰	春水
忠	中心
梁	氵刀八木
吸	口㇆人
跨	足大一了
森	木木木
瞎	目宀丰口
卷	半巳
于	一寸
井	二川
蛇	虫宀匕
寺	土寸
屏	尸䒑艹
灌	氵艹口隹
埋	土甲二
略	田夂口
目	目
蒙	艹冖一豕
托	扌丿七
巧	工了
淡	氵火火
拜	手一丰
冬	夂冫
娜	女刀二阝
池	氵也
敲	亠口卜又
愁	禾火心
勇	又用力
泥	氵尸匕
昏	氏日
遇	之日冂厶
巨	匚㇕
怎	矢卜心
磨	广木木石
呼	口丿丷寸
液	氵亠亻夂
泉	白水
嫁	女宀豕
汪	氵王
稍	禾小月
薛	艹丿㠯辛
豆	一口䒑
旺	日王
攻	工攵
祥	礻羊
委	禾女
佐	亻大工
隔	阝一丷丁
崔	山隹
碗	石宀夗
吻	口勹彡
健	亻廴彐二
速	之木口
失	牛人
雄	大厶隹
胸	月勹乂凵
框	木匚王
暴	日廿八水
娃	女土土
唯	口隹
漏	氵尸雨
拔	扌大又丶
洛	氵夂口
探	扌冖八木
碟	石廿乚木
郎	丶艮阝
珠	王牛小
尿	尸水
透	之禾㇆丿
惠	車心
府	广亻寸
菲	艹非
叼	口㇆一
父	八乂
耳	耳
窗	穴鬼夂
搜	扌臼丨又
希	乂大巾
患	口中心
尾	尸毛
播	扌釆田
岩	山石
逗	之一口䒑
限	阝艮
帝	亠丷冖巾
昌	日日
模	木艹日大
扁	户冂艹
舒	人舌㇕丨
嫌	女䒑刂八
陶	阝勹牛山
苗	艹田
剪	䒑月刂刀
羽	习习
哩	口甲二
稿	禾亠冂口
邦	丰阝
玲	王人之
坑	土亠几
袋	亻弋亠𧘇
趁	走人彡
妖	女丿大
甩	月乚
琳	王木木
乙	乙
伴	亻半
尊	丷酉寸
熬	丰力攵灬
吊	口巾
霜	雨木目
沿	氵几口
伯	亻白
浩	氵牛口
剩	禾丬匕刂
域	土戈口一
祖	礻且
肺	月一巾
附	阝亻寸
制	牛巾刂
玄	亠幺
置	四十且
豪	亠口冖豕
助	且力
幽	幺幺山
欣	斤欠
辣	辛木口
煤	火甘木
瓜	瓜
慧	丰丰彐心
墨	四二灬土
娶	耳又女
炎	火火
震	雨辰
遂	之丷豕
斌	文一弋止
控	扌穴工
覆	西行日夂
趟	走小冂口
禁	木木示
烤	火者了
童	立甲二
杯	木不
晴	日丰月
魂	二厶鬼
益	䒑八皿
庭	广廴丿士
肝	月一十
坊	土方
晨	日辰
振	扌辰
割	宀丰口刂
消	氵小月
兆	氵儿
隆	阝夂一生
撤	扌亠月攵
粥	弓米弓
馨	士尸禾日
滑	氵骨
曼	日四又
暖	日爪大又
止	止
柱	木丶王
妻	一彐女
盾	斤十目
奔	大十艹
政	一止攵
爹	八乂夕夕
刺	木冂刂
冠	冖二儿寸
躺	身小冂口
舍	人舌
售	隹口
婚	女氏日
兔	⺈口儿丶
敬	艹勹口攵
潮	氵十十月
昂	日氏冂
咳	口亠乡人
邪	牙阝
促	亻足
鼠	臼巛
葛	艹日人乚
串	口中
桑	又又又木
苑	艹夗
迎	之氏冂
弓	弓
碎	石亠人十
余	人禾
承	㇕水三
迪	之由
臣	臣
勤	廿口丰力
摔	扌亠氵十
蒸	艹㇕一灬
凌	冫土八夂
辛	辛
旗	方矢其
妙	女小丿
始	女厶口
符	⺮亻寸
亭	亠口冖丁
吼	口子乚
云	二厶
研	石一艹
咪	口米
俗	亻八人口
珍	王人彡
卓	卜日十
捧	扌春工
舔	舌一大忄
愈	人一刂心
溪	氵爪幺大
歪	不一止
晃	日小尤
斜	人禾冫十
尤	尤
洲	氵⺍川
乎	丿丷寸
湘	氵木目
翔	羊习习
枝	木十又
逸	之⺈儿丶
哄	口廿八
餐	卜夕又食
染	氵九木
粘	米卜口
炮	火勹巳
桌	卜日木
芬	艹八刀
萍	艹氵一䒑
晶	日日日
勾	勹厶
戒	戈艹
桂	木土土
朗	丶艮月
堵	土者
矣	厶矢
捐	扌口月
荷	艹亻丁口
棉	木白巾
私	禾厶
姜	羊女
鼓	士口十又
霞	雨㇕㇕又
瞧	目隹灬
皇	白王
企	人止
互	一彑
沉	氵冖几
箭	⺮䒑月刂
柏	木白
焦	隹灬
憋	水冂攵心
盟	日月皿
延	廴丿止
柔	又㇕亻木
粒	米立
盆	八刀皿
眉	尸目
碧	王白石
籍	⺮三廿日
刮	舌刂
勿	勹彡
坤	土申
汁	氵十
浴	氵八人口
翼	习习廿八
哲	扌斤口
涵	氵㇕水凵
菌	艹因禾
桶	木又用
抹	扌一木
判	半刂
弟	丷弓亻
傅	亻甫寸
衰	亠日𧘇
叔	上小又
肩	户月
殿	尸廿八殳
番	釆田
怡	忄厶口
旭	九日
航	舟亠几
妮	女尸匕
坡	土皮
旅	方矢氏
赤	土川八
技	扌十又
摘	扌亠十口
翠	习习人十
孝	者子
移	禾夕夕
予	又㇕丨
岳	丘山
屎	尸米
融	一口丁虫
棋	木其
扶	扌夫
介	人川
渡	氵广廿又
芯	艹心
采	爪木
乳	爪子乚
拳	半手
薇	艹行几攵
淫	氵爪丿士
拽	扌日乚丿
宅	宀丿七
掌	小冖口手
培	土立口
莉	艹禾刂
盼	目八刀
握	扌尸至
截	土隹戈
孤	子瓜
什	亻十
宣	宀二日
尖	小大
醋	酉廿日
朵	几木
穆	禾白小彡
啃	口止月
耗	三小毛
息	自心
伍	亻工㇕
塘	土广彐口
逢	之夂丰
桃	木氵儿
壁	尸口辛土
霍	雨隹
漆	氵木人水
虹	虫工
丸	丸
券	半刀
俱	亻且八
菊	艹勹米
奴	女又
岸	山厂一十
凝	冫匕㇕止
芝	艹之
烈	一夕刂灬
矮	矢禾女
婆	氵皮女
蝶	虫廿乚木
枕	木冖儿
避	之尸口辛
帕	巾白
浮	氵爪子
盈	㇆丿又皿
枚	木攵
材	木寸丿
扎	扌乚
翁	八厶习习
幻	幺㇆
衫	衤彡
杆	木一十
固	因十口
耀	小尤习隹
槽	木艹日日
穴	穴
幅	巾一口田
伸	亻申
悲	非心
殷	斤彐㇆殳
萌	艹日月
斑	王文王
澡	氵口口木
屈	尸凵山
娟	女口月
怨	夗心
恐	工凡心
柴	止匕木
逆	之䒑凵
渣	氵木日一
熙	臣巳灬
抖	扌冫十
忽	勹彡心
津	氵彐二
胎	月厶口
准	冫隹
摩	广木木手
漫	氵日四又
溜	氵氏刀田
扇	户习习
堡	亻口木土
淘	氵勹牛山
墓	艹日大土
鹿	鹿
彬	木木彡
蹭	足丷四日
卿	氏丿艮冂
函	㇕水凵
奈	大示
茂	艹戊
肌	月几
映	日冂大
鼻	自田一川
泵	石水
育	亠厶月
澳	氵自米大
候	亻丨㇕矢
种	禾中
邀	之白方攵
佩	亻几一巾
策	⺮木冂
藤	艹月半水
仿	亻方
磊	石石石
雁	厂亻隹
窄	穴矢卜
昨	日矢卜
戈	戈
爪	爪
癌	疒口口山
效	亠八乂攵
拷	扌者了
猴	犭亻㇕矢
掏	扌勹牛山
汝	氵女
撮	扌日耳又
幸	土半
揉	扌又亻木
舟	舟
盯	目丁
蜜	宀心丿虫
漂	氵西示
序	广又㇕丨
巷	廿八巳
梨	禾刂木
舌	舌
蒂	艹亠冖巾
腹	月矢日夂
蟹	⺈用牛虫
陷	阝⺈臼
捉	扌足
疑	匕矢㇕止
鼎	目爿片
慌	忄艹亡川
瘤	疒氏刀田
彼	行皮
辰	辰
忌	己心
踏	足水日
捷	扌一彐止
罐	牛山口隹
伏	亻大丶
默	四二大丶
赫	土川川八
杰	木灬
孩	子亠乡人
咖	口力口
悟	忄工㇕口
帽	巾日目
幼	幺力
旋	方矢㇕止
壹	士冖口䒑
霸	雨革月
席	广廿巾
叉	又丶
妃	女己
典	冂廿八
儒	亻雨而
裸	衤日木
奉	春工
御	行牛止冂
腔	月穴工
突	穴大丶
刑	一艹刂
痕	疒艮
午	矢十
蕾	艹雨田
宰	宀辛
囊	一中甘𧘇
弘	弓厶
境	土立日儿
拒	扌匚㇕
毅	立豕殳
煎	䒑月刂灬
弦	弓亠幺
渝	氵人月刂
罩	四卜日十
蓉	艹穴人口
卵	氏丿冂丶
尺	尸丶
逾	之人月刂
垂	千艹二
惜	忄廿日
浦	氵甫
警	艹勹攵言
扛	扌工
氧	气羊
揭	扌日人乚
逐	之豕
昭	日刀口
宿	宀亻一白
裂	一夕亠𧘇
僧	亻丷四日
裙	衤尹口
彪	虎彡
淋	氵木木
杏	木口
牢	宀牛
揍	扌春一大
劫	土厶力
拓	扌石
扮	扌八刀
喻	口人月刂
律	行彐二
株	木牛小
砂	石小丿
埃	土厶矢
斗	冫十
坪	土一䒑
仇	亻九
吞	一大口
亡	亡
沾	氵卜口
牧	牛攵
兜	白氏㇕儿
寨	宀甘八木
掐	扌⺈臼
稀	禾乂大巾
恰	忄人一口
棍	木日匕匕
淑	氵上小又
慕	艹日大忄
歇	日勹乚欠
疏	㇕止厶川
膏	亠口口月
陵	阝土八夂
姆	女母
碳	石山大火
廷	廴丿士
糊	米十口月
蚊	虫文
祭	夗示
拾	扌人一口
朋	月月
媚	女尸目
吟	口人丶㇕
筒	⺮冂一口
丘	丘
趴	足八
繁	矢母攵絲
坦	土日一
穗	禾車心
屯	七凵
虐	虎匚
蹲	足丷酉寸
惟	忄隹
幕	艹日大巾
扒	扌八
搓	扌羊工
遮	之广廿灬
庚	广彐人
哉	土口戈
涉	氵止小
臂	尸口辛月
敷	甫方攵
丙	一冂人
署	四者
示	示
夕	夕
趣	走耳又
渠	氵匚㇕木
杭	木亠几
疾	疒矢
崇	山宀示
裕	衤八人口
挪	扌刀二阝
荒	艹亡川
筋	⺮月力
孕	㇆丿子
撕	扌其斤
戳	习习隹戈
帆	巾凡
阻	阝且
享	亠口子
棚	木月月
傲	亻丰力攵
蹦	足山月月
焊	火日一十
召	刀口
徒	行走
脂	月匕日
几	几
艘	舟臼丨又
靖	立丰月
奏	春一大
咒	口口几
盲	亡目
姿	冫欠女
炫	火亠幺
坎	土欠
拌	扌半
缸	牛山工
弗	弓川
狐	犭瓜
栽	土木戈
硅	石土土
述	之木丶
泛	氵丿之
甫	甫
佑	亻大口
卦	土土卜
耿	耳火
咽	口因大
袖	衤由
糟	米艹日日
激	氵白方攵
珊	王冂冂一
潭	氵西日十
蠢	春虫虫
植	木十且
占	卜口
倚	亻大丁口
姨	女大弓
幢	巾立甲二
焉	一止乚灬
桐	木冂一口
痰	疒火火
捂	扌工㇕口
万	一力
蒲	艹氵甫
芽	艹牙
碑	石鬼十
嚼	口爪艮寸
燃	火夕丶灬
朴	木卜
杖	木一乂
磷	石米夕㐄
脆	月⺈厂巳
刃	刀丶
姑	女十口
衡	行⺈田大
措	扌廿日
眠	目巳七
途	之人禾
鄂	口口了阝
捅	扌又用
禾	禾
磁	石䒑幺幺
沃	氵丿大
肚	月土
哀	亠口𧘇
浸	氵彐冖又
柄	木一冂人
跪	足⺈厂巳
瓷	冫欠㇆丶
凸	丨一㇆一
磅	石亠冖方
宴	宀日女
堪	土其乚
仗	亻一乂
崩	山月月
革	革
聘	耳由了
刊	一十刂
裁	土亠𧘇戈
郁	大月阝
逝	之扌斤
塌	土日习习
崖	山厂土土
廉	广䒑刂八
婉	女宀夗
攀	木乂大手
喘	口山而
氮	气火火
鞍	革宀女
巫	工人人
沁	氵心
瑟	王王心丿
揪	扌禾火
棵	木日木
拐	扌口力
披	扌皮
削	小月刂
悠	亻丨攵心
凹	冂一冂一
葬	艹一匕艹
瞪	目癶口䒑
授	扌爪冖又
卸	牛止冂
慈	䒑幺幺心
瞄	目艹田
鞭	革亻日乂
危	⺈厂巳
泊	氵白
喉	口亻㇕矢
溶	氵穴人口
拎	扌人之
察	宀夗示
昆	日匕匕
禹	丿口冂厶
娥	女手戈
醇	酉亠口子
橙	木癶口䒑
辨	辛刂辛
暮	艹日大日
薪	艹立木斤
巢	巛日木
脾	月鬼十
愚	日冂厶心
蜀	四勹虫
裹	亠日木𧘇
藕	艹三冂厶
劈	尸口辛刀
堤	土日一止
拱	扌廿八
夸	大一了
傍	亻亠冖方
燥	火口口木
允	厶儿
芒	艹亡
畔	田半
豹	豸勹丶
澄	氵癶口䒑
冥	冖日亠八
媒	女甘木
酥	酉禾
垮	土大一了
枯	木十口
塑	䒑凵月土
卜	卜
茅	艹又㇕亻
搏	扌甫寸
沐	氵木
豫	又㇕口豕
蒜	艹示示
雀	小丿隹
腐	广亻人人
皓	白牛口
央	冂大
冤	冖⺈儿丶
据	扌尸十口
浙	氵扌斤
栓	木人王
梳	木亠厶川
冀	丬匕廿八
冉	冂土
彤	冂亠彡
卑	鬼十
誓	扌斤言
蜂	虫夂丰
勺	勹丶
迅	之乙十
虫	虫
匹	匚儿
仰	亻氏冂
煞	⺈彐攵灬
羞	羊㇕十
注	氵丶王
嫂	女臼丨又
瞳	目立甲二
拂	扌弓川
挨	扌厶矢
泄	氵廿乚
夷	大弓
慎	忄十且八
汽	氵气
恭	廿八忄
弊	水冂攵艹
旦	日一
涂	氵人禾
氯	气彐水
乍	矢卜
耕	三小二川
稻	禾爪臼
屠	尸者
笛	⺮由
捕	扌甫
蕊	艹心心心
氨	气宀女
愣	忄四方
悔	忄矢母
敦	亠口子攵
葵	艹癶一大
磕	石土厶皿
渴	氵日人乚
曝	日日八水
撇	扌用冂攵
梗	木一日乂
蔚	艹尸示寸
翅	十又习习
估	亻十口
瓣	辛瓜辛
淮	氵隹
惑	戈口一心
巡	之巛
墩	土亠子攵
徽	行山絲攵
蓄	艹亠幺田
匪	匚非
溢	氵䒑八皿
寇	宀二卜又
蓬	艹之夂丰
硫	石亠厶川
俏	亻小月
迫	之白
貌	豸白儿
茄	艹力口
炭	山大火
挂	扌土土
掀	扌斤欠
翰	十日习习
掩	扌大日乚
蹬	足癶口䒑
泳	氵丶水
玫	王攵
椅	木大丁口
侍	亻土寸
抑	扌氏冂
毫	亠口冖毛
侵	亻彐冖又
妥	爪女
概	木艮七儿
援	扌爪大又
昔	廿日
逮	之彐氵
卒	亠人人十
捆	扌因木
菱	艹土八夂
梯	木丷弓亻
籽	米子
腕	月宀夗
挫	扌人人土
膝	月木人水
嗦	口十冖絲
眨	目丿之
循	行斤十目
臀	尸廿殳月
矛	又㇕亻
努	女又力
黔	四二丶㇕
乏	丿之
魅	鬼二小
凶	乂凵
掘	扌尸凵山
雌	止匕隹
旱	日一十
掰	手八刀手
蛙	虫土土
雕	冂土口隹
隋	阝大工月
芙	艹夫
刁	㇆一
禽	人亠冂厶
腺	月白水
欺	其欠
杉	木彡
党	小冖口儿
玖	王⺈丶
肆	長彐二
悉	釆心
掂	扌广卜口
冶	冫厶口
遣	之中一㠯
皖	白宀二儿
糕	米羊灬
址	土止
茵	艹因大
簿	⺮氵甫寸
旬	勹日
丈	一乂
咸	戊一口
碘	石冂廿八
瞅	目禾火
廊	广丶艮阝
焰	火⺈臼
淳	氵亠口子
畏	田展
屑	尸小月
嵌	山甘欠
泣	氵立
袍	衤勹巳
僵	亻三田田
沫	氵一木
寂	宀上小又
秤	禾丁䒑
藻	艹氵口木
螺	虫田絲
恤	忄丿皿
污	氵一了
涯	氵厂土土
滋	氵䒑幺幺
嗜	口者匕日
陡	阝走
栗	西木
捻	扌人㇕心
勃	十冖子力
矩	矢匚㇕
沽	氵十口
淤	氵方人冫
描	扌艹田
契	丰刀大
祠	礻㇆一口
峻	山厶八夂
稠	禾冂土口
爵	爪四艮寸
秉	禾彐
刨	勹巳刂
群	尹口羊
役	行殳
烙	火夂口
灾	宀火
强	弓口虫
痘	疒一口䒑
髓	骨之工月
募	艹日大力
苟	艹勹口
析	木斤
魁	鬼冫十
斥	斤丶
棕	木宀示
倦	亻半巳
疆	弓土田田
蔓	艹日四又
靴	革亻匕
烟	火因大
巾	巾
殊	一夕牛小
叮	口丁
艇	舟廴丿士
熔	火穴人口
芹	艹斤
寡	宀石八刀
瞬	目爪夕㐄
榕	木穴人口
庸	广彐月
棠	小冖口木
埠	土丿㠯十
茬	艹大丨土
嗅	口自大丶
滇	氵十且八
寅	宀一由八
蛾	虫手戈
慰	尸示寸心
履	尸行日夂
宛	宀夗
涮	氵尸巾刂
督	上小又目
衍	行氵
劣	小丿力
祈	礻斤
魄	白鬼
斧	八乂斤
淌	氵小冂口
簇	⺮方矢矢
沛	氵一巾
掠	扌亠口小
崎	山大丁口
菇	艹女十口
砌	石七刀
眯	目米
辱	辰寸
匠	匚斤
肘	月寸
淹	氵大日乚
洽	氵人一口
究	穴九
矢	矢
澈	氵亠月攵
椰	木耳阝
梢	木小月
障	阝立日十
霄	雨小月
揣	扌山而
槐	木鬼
粟	西米
唆	口厶八夂
拴	扌人王
吏	大口丶
堰	土匚日女
棺	木宀㠯
腥	月日生
胞	月勹巳
剖	立口刂
羹	羊灬羊大
剃	丷弓亻刂
寓	宀日冂厶
撩	扌大日小
扳	扌斤又
桔	木士口
妄	亡女
陌	阝一白
弧	弓瓜
撰	扌巳廿八
蛤	虫人一口
擒	扌人冂厶
哨	口小月
皂	白七
汞	工水
芭	艹巴
椒	木上小又
戎	戈大
肋	月力
煌	火白王
疤	疒巴
昧	日二小
柒	氵七木
旨	匕日
巳	巳
辜	十口辛
筐	⺮匚王
膊	月甫寸
遵	之丷酉寸
愧	忄鬼
拙	扌凵山
竿	⺮一十
甸	勹田
衷	亠中𧘇
脊	氵人月
憨	㇕耳攵心
捶	扌千艹二
苔	艹厶口
奸	女一十
舅	臼田力
恕	女口心
啼	口亠冖巾
睹	目者
疲	疒皮
褪	衤之艮
鞠	革勹米
彰	立日十彡
酬	酉⺍川
橘	木又八口
啪	口扌白
睛	目丰月
哆	口夕夕
窟	穴尸凵山
垢	土斤一口
愿	厂白小心
腮	月田心
枉	木王
笙	⺮生
沸	氵弓川
妓	女十又
猿	犭土口𧘇
漠	氵艹日大
撬	扌毛毛毛
巍	山禾女鬼
漾	氵羊丶水
擎	艹勹攵手
靶	革巴
俐	亻禾刂
胚	月不一
楷	木匕匕白
迭	之牛人
蹄	足亠冖巾
褐	衤日人乚
梭	木厶八夂
畜	亠幺田
宵	宀小月
榆	木人月刂
嚷	口亠甘𧘇
絮	女口絲
戊	戊
罕	冖八一十
叩	口冂
俯	亻广亻寸
瀑	氵日八水
肇	户攵彐二
暇	日㇕㇕又
睬	目爪木
郊	亠八乂阝
璧	尸口王丶
捎	扌小月
嘀	口亠十口
犁	禾刂牛
怔	忄一止
焚	木木火
灼	火勹丶
孽	艹丿辛子
匙	日一止匕
嚎	口亠冖豕
摧	扌山隹
械	木戈艹
乞	矢乙
卯	氏丿冂
喧	口宀二日
瓢	西示瓜
裳	小冖亠𧘇
竭	立日人乚
妨	女方
玻	王皮
擅	扌亠日一
烹	亠口了灬
卉	十艹
括	扌舌
檐	木⺈八言
尸	尸
椎	木隹
恬	忄舌
檀	木亠日一
坯	土不一
葡	艹勹甫
伙	亻火
拘	扌勹口
躁	足口口木
囚	因人
匣	匚甲
凳	癶一䒑几
隙	阝小日小
伶	亻人之
拭	扌弋工
墅	甲二丨土
碾	石尸艹展
榨	木穴矢卜
黯	四二立日
苞	艹勹巳
戚	戊上小
倘	亻小冂口
怯	忄土厶
礁	石隹灬
瞻	目⺈八言
躬	身弓
脖	月十冖子
襟	衤木木示
尉	尸示寸
亥	亠乡人
肢	月十又
悄	忄小月
厘	厂甲二
憎	忄丷四日
糙	米之牛口
盔	大火皿
睦	目土八土
炕	火亠几
荔	艹力力力
奢	大者
尬	尤人川
趾	足止
悼	忄卜日十
憾	忄戊口心
稚	禾隹
褒	亠亻木𧘇
烘	火廿八
嘻	口士䒑口
熄	火自心
薯	艹四者
蕉	艹隹灬
泪	氵目
拗	扌幺力
毯	毛火火
莽	艹大丶艹
勉	⺈口儿力
亢	亠几
涌	氵又用
妒	女户
暑	日者
疫	疒殳
歉	䒑彐八欠
樟	木立日十
豁	宀丰人口
窖	穴牛口
脉	月丶水
启	户口
扭	扌㇕十
胰	月大弓
帘	穴巾
隅	阝日冂厶
岔	八刀山
弛	弓也
秘	禾心丿
撼	扌戊口心
瘟	疒日皿
歧	止十又
椿	木春
确	石⺈用
价	亻人川
悍	忄日一十
啤	口鬼十
壬	丿士
叛	半斤又
捌	扌口力刂
勘	其乚力
啄	口豕
倡	亻日日
肛	月工
蔽	艹水冂攵
糯	米雨而
茫	艹氵亡
凰	几白王
溺	氵弓弓冫
硝	石小月
囤	因七凵
吭	口亠几
靡	广木木非
跺	足几木
扼	扌厂巳
吱	口十又
圃	因甫
瘸	疒力人人
琢	王豕
酉	酉
棗	木冂木冂
蚌	虫丰
恍	忄小尤
糠	米广彐氵
渺	氵目小丿
祀	礻巳
琅	王丶艮
苛	艹丁口
唬	口虎
夭	丿大
橡	木⺈口豕
茸	艹耳
倔	亻尸凵山
丰	丰
耙	三小巴
跋	足大又丶
踱	足广廿又
恢	忄大火
舵	舟宀匕
璃	王亠冂厶
懈	忄⺈刀牛
宦	宀臣
漱	氵木口欠
庶	广廿灬
挎	扌大一了
茉	艹一木
匾	匚户冂艹
筑	⺮工凡
痹	疒田一川
恃	忄土寸
舀	爪臼
搔	扌又丶虫
梧	木工㇕口
屹	山矢乙
灸	⺈丶火
蹈	足爪臼
牡	牛土
秧	禾冂大
狸	犭甲二
沼	氵刀口
夯	大力
炬	火匚㇕
逞	之口王
簧	⺮廿由八
窘	穴尹口
赦	土川八攵
溯	氵䒑凵月
宙	宀由
斟	其乚冫十
柑	木甘
匿	匚艹大口
剔	日勹彡刂
眷	半目
癸	癶一大
嘲	口十十月
噩	王口口口
筷	⺮忄㇕大
侄	亻至
滔	氵爪臼
丐	一卜乚
戌	戊一
疹	疒人彡
炊	火欠
涕	氵丷弓亻
摹	艹日大手
羚	羊人之
渤	氵十子力
墟	土虎业
柿	木亠巾
噪	口口口木
膨	月士䒑彡
琉	王亠厶川
抒	扌又㇕丨
酌	酉勹丶
殖	一夕十且
眶	目匚王
稼	禾宀豕
粹	米亠人十
褂	衤土土卜
廓	广亠子阝
豚	月豕
犀	尸水牛
垛	土几木
擂	扌雨田
檬	木艹一豕
咕	口十口
嘶	口其斤
吮	口厶儿
厂	厂
芋	艹一寸
萎	艹禾女
嗡	口八习习
吠	口大丶
篷	⺮之夂丰
聆	耳人之
碌	石彐水
怠	厶口心
杠	木工
砰	石丁䒑
曙	日四者
稽	禾尤匕日
偎	亻田展
敞	小冂口攵
徙	行止止
拇	扌母
兢	十口口儿
峨	山手戈
姊	女丿乚亻
愉	忄人月刂
衙	行工㇕口
鄙	口十口阝
澎	氵士䒑彡
煽	火户习习
惶	忄白王
酣	酉甘
庇	广匕匕
芥	艹人川
蝗	虫白王
床	广木
陋	阝一人乚
壤	土亠甘𧘇
愕	忄口一了
唧	口艮冂
慨	忄艮七儿
乒	丘丿
朦	月艹一豕
粱	氵刀八米
征	行一止
柬	木四
秩	禾牛人
朽	木了
蛛	虫牛小
啡	口非
晦	日矢母
嫉	女疒矢
广	广
幌	巾日小尤
臼	臼
怖	忄大巾
灶	火土
宁	宀丁
哺	口甫
婿	女㇕止月
挽	扌⺈口儿
歹	一夕
矗	十且十且
叨	口刀
晰	日木斤
揩	扌匕匕白
酪	酉夂口
瑰	王鬼
蔗	艹广廿灬
嗓	口又又木
膛	月小口土
汛	氵乙十
剿	巛日木刂
蔬	艹㇕厶川
腋	月亠夂丶
吆	口幺
拄	扌丶王
吝	文口
皿	皿
徊	行因口
嗽	口木口欠
悖	忄十冖子
耘	三小二厶
榴	木氏刀田
伺	亻㇆一口
胜	月生
筏	⺮亻戈
辟	尸口辛
姥	女者匕
坷	土丁口
仆	亻卜
脯	月甫
痢	疒禾刂
汰	氵大丶
峭	山小月
僚	亻大日小
忿	八刀心
孵	氏丿爪子
紊	文絲
捺	扌大示
帷	巾隹
寞	宀艹日大
畸	田大丁口
箕	⺮其
匆	勹彡丶
渲	氵宀二日
耽	其冖儿
猩	犭日生
舶	舟白
殃	一夕冂大
遏	之日人乚
匕	匕
隘	阝䒑八皿
泌	氵心丿
俘	亻爪子
晌	日自口
睫	目一彐止
捍	扌日一十
蝠	虫一口田
膀	月亠冖方
姻	女因大
窒	穴至
熏	千四二灬
氓	亡巳七
忱	忄冖儿
雇	户隹
媳	女自心
荐	艹大丨子
埂	土一日乂
僻	亻尸口辛
瓤	亠口𧘇瓜
拯	扌㇕水一
奠	丷酉大
翩	户冂习习
祟	凵山示
殉	一夕勹日
跤	足亠八乂
牲	牛生
菩	艹立口
佣	亻用
喳	口木日一
蘑	艹广木石
跛	足皮
盹	目七凵
哮	口者子
乓	丘丶
狡	犭亠八乂
蹋	足日习习
篡	⺮目大厶
竣	立厶八夂
韭	非一
肪	月方
秸	禾士口
崛	山尸凵山
庵	广大日乚
隧	阝之丷豕
蜈	虫口一大
惰	忄大工月
蚤	又丶虫
苹	艹丁䒑
藐	艹豸白儿
酵	酉者子
匈	勹乂凵
唾	口千艹二
瑙	王巛鬼乂
蛀	虫丶王
适	之舌
慷	忄广彐氵
寥	宀习人彡
蔑	艹四戊丶
迄	之矢乙
臊	月口口木
懦	忄雨而
羔	羊灬
肴	乂大月
湃	氵手一丰
疚	疒⺈丶
窿	穴阝一生
漓	氵亠冂厶
迂	之一寸
氛	气八刀
垃	土立
佃	亻田
腊	月廿日
沮	氵且
并	䒑艹
懊	忄自米大
萄	艹勹牛山
达	之大
唇	辰口
况	冫口儿
冗	冖几
侮	亻矢母
悴	忄亠人十
梆	木丰阝
蟆	虫艹日大
溉	氵艮七儿
嘹	口大日小
蟀	虫亠氵艹
惕	忄日勹彡
惦	忄广卜口
蜓	虫廴丿士
榔	木丶艮阝
蚓	虫弓丨
葫	艹十口月
譬	尸口辛言
豺	豸寸丿
柜	木匚㇕
帚	彐冖巾
茁	艹凵山
咨	冫欠口
淀	氵宀一止
吩	口八刀
蚪	虫冫十
褥	衤辰寸
菠	艹氵皮
徘	行非
蜒	虫廴丿止
蜡	虫廿日
憔	忄隹灬
雹	雨勹巳
橄	艹㇕耳攵
婪	木木女
疙	疒矢乙
侈	亻夕夕
蝴	虫十口月
峰	山夂丰
呻	日申
咄	口凵山
蜘	虫矢口
唁	口言
棱	木土八夂
圾	土㇆人
咐	口亻寸
甥	生田力
霹	雨尸口辛
蚣	虫八厶
霎	雨立女
簸	⺮其皮
惋	忄宀夗
蚯	虫丘
蠕	虫雨而
瘩	疒艹一口
迢	之刀口
胳	月夂口
猖	犭日日
蜻	虫丰月
猾	犭骨
冲	冫中
痊	疒人王
迹	之亠川八
儿	儿
玷	王卜口
栖	木西
凭	亻丿士几
韵	立日勹冫
踊	足又用
叶	口十
蹂	足又亻木
袱	衤亻大丶
豌	一口宀夗
蝌	虫禾冫十
淆	氵乂大月
酗	酉乂凵
吁	口一寸
螃	虫亠冖方
蟋	虫釆心
亏	一了
划	戈刂
蝙	虫户冂艹
坏	土不
够	勹口夕夕
圣	又土
弃	亠厶艹
极	木㇆人
葱	艹勹丶心
猫	犭艹田
猪	犭者
册	冂冂一
机	木几
隶	彐氵
垒	厶厶厶土
号	口了
扑	扌卜
赶	走一十
窑	穴牛山
听	口斤
柠	木宀丁
猬	犭田月
猎	犭廿日
凄	冫一彐女
晋	一业日
痴	疒矢口
叙	人禾又
离	亠乂冂厶
滚	氵亠厶𧘇
屉	尸廿乚
无	一尤
与	一乚一
样	木羊
国	因王丶
吨	口七凵
户	户
巩	工凡
却	土厶冂
担	扌日一
撑	扌小口手
携	扌隹㇆丿
抬	扌厶口
构	木勹厶
医	匚矢
蝎	虫日人乚
咏	口丶水
踪	足宀示
叹	口又
网	冂乂乂
冈	冂乂
岭	山人之
复	矢日夂
笋	⺮尹
众	人人人
脚	月土厶冂
胆	月日一
庄	广土
凉	冫亠口小
决	冫㇕大
恒	忄二日
潜	氵夫夫日
汹	氵乂凵
袜	衤一木
宫	宀口口
异	巳艹
栅	木冂冂一
吕	口口
秆	禾一十
删	冂冂一刂
胶	月亠八乂
泞	氵宀丁
扰	扌尤
芜	艹一尤
芦	艹户
碱	石戊一口
奋	大田
邮	由阝
毁	臼工殳
体	亻木一
优	亻尤
犹	犭尤
肮	月亠几
凑	冫春一大
痒	疒羊
烛	火虫
怜	忄人之
惊	忄亠口小
羡	羊冫欠
洁	氵士口
垦	艮土
篱	⺮亠冂厶
灯	火丁
橱	木厂䒑寸
减	冫戊一口
耻	耳止
厨	厂一䒑寸
凛	冫亠口示
厦	厂一自夂
亲	立木
届	尸由
厢	厂木目
忧	忄尤
禀	亠因口示
叠	又又冖且
开	一艹
录	彐水
献	十冂大丶
园	因二儿
杀	乂木
寻	彐寸
邓	又阝
吓	口一卜
触	⺈用虫
权	木又
杂	九木
丽	一冂冂丶
币	丿巾
仅	亻又
沟	氵勹厶
灵	彐火
茧	艹虫
怀	忄不
积	禾口八
敌	舌攵
块	土㇕大
备	夂田
关	䒑大
队	阝人
宪	宀牛儿
現	王見
个	人丨
说	言丷口儿
为	丷㇆丶
没	氵殳
这	之文
对	又寸
发	乚丿又丶
两	一冂人人
項	工頁
专	二乚丶
来	二水
动	二厶力
長	長
联	耳䒑大
帮	丰阝巾
热	扌丸灬
拨	扌乚又丶
带	艹冖巾
节	艹冂
标	木示
橫	木廿由八
龍	龍
頁	頁
顾	厂巳頁
車	車
区	匚乂
暫	車斤日
軌	車九
軟	車欠
点	卜口灬
旧	丨日
齒	齒
別	口力刂
員	口貝
嗎	口馬
时	日寸
业	业
当	小彐
电	日乚
贱	貝戈
敗	貝攵
內	冂人
販	貝斤又
見	見
賠	貝立口
县	且厶
税	禾丷口儿
气	气
传	亻二乚丶
順	川頁
們	亻門
伪	亻丷㇆丶
会	人二厶
領	人之頁
从	人人
鎮	金十且八
須	彡頁
钱	金戈
钻	金卜口
钢	金冂乂
铁	金牛人
脹	月長
膩	月弋二貝
独	犭虫
肿	月中
风	几乂
脱	月丷口儿
魚	魚
条	夂木
乐	氏小
争	⺈彐
鳥	鳥
讲	言二川
让	言上
調	言冂土口
齐	文川
訴	言斤丶
設	言殳
該	言亠乡人
变	亠刂八又
装	丬士亠𧘇
聞	門耳
閉	門寸丿
問	門口
間	門日
門	門
将	丬夕寸
应	广⺍一
疗	疒了
废	广乚又丶
类	米大
炼	火七㇆八
总	丷口心
单	丷日十
粮	米丶艮
数	米女攵
洒	氵西
滤	氵虎心
測	氵貝刂
学	⺍冖子
汉	氵又
泼	氵乚又丶
宽	宀艹見
軍	冖車
补	衤卜
审	宀申
实	宀冫大
馬	馬
层	尸二厶
頗	皮頁
观	又見
难	又隹
验	馬人二⺍
买	㇕冫大
騙	馬户冂艹
張	弓長
阳	阝日
費	弓川貝
办	力八
阴	阝月
习	习
弹	弓丷日十
随	阝之大月
紅	絲工
续	絲十冫大
純	絲七凵
細	絲田
組	絲且
統	絲亠厶儿
断	米乚斤
編	絲户冂艹
经	絲㇕丶工
蚕	一大虫
頂	丁頁
鵡	一弋止鳥
严	一业丿
亞	一业
惡	一业心
画	一田凵
残	一夕戈
歼	一夕千
灭	一火
迈	之一力
坛	土二厶
墙	土十因口
盐	土卜皿
坝	土貝
进	之二川
規	夫見
赵	走乂
頑	二儿頁
远	之二儿
趋	走⺈彐
坟	土文
颊	二火頁
夹	二火
壺	士冖业
壳	士冖几
声	士尸
场	土㇆彡
运	之二厶
寿	丰寸
环	王不
职	耳口八
責	丰貝
静	丰月⺈彐
艳	丰⺈巴
聪	耳丷口心
鬓	長彡丘八
瑪	王馬
聂	耳又又
抚	扌一尤
挟	扌二火
摄	扌耳又又
捞	扌艹冖力
攏	扌龍
拣	扌七㇆八
抠	扌匚乂
損	扌口貝
挡	扌小彐
摆	扌四土厶
拥	扌用
捡	扌人二⺍
抡	扌人匕
抢	扌人巳
摇	扌爪牛山
垫	扌丸土
挚	扌丸手
执	扌丸
抛	扌九力
换	扌⺈冂大
搀	扌⺈儿冫
挣	扌⺈彐
挤	扌文川
过	之寸
扩	扌广
擱	扌門夂口
掷	扌䒑大阝
搂	扌米女
搅	扌⺍冖見
拧	扌宀丁
揮	扌冖車
护	扌户
扫	扌彐
摊	扌又隹
扬	扌㇆彡
报	扌冂又
掺	扌厶大彡
拟	扌厶人
苇	艹工㇆
协	十力八
載	土車戈
蓮	艹之車
蓝	艹刂⺮皿
黄	廿由八
顛	十且八頁
获	艹犭大丶
藹	艹言人乚
蒋	艹丬夕寸
丧	十丷展
荡	艹氵㇆彡
莹	艹冖王丶
荣	艹冖木
葷	艹冖車
萤	艹冖虫
营	艹冖口口
荧	艹冖火
劳	艹冖力
茎	艹㇕丶工
萧	艹彐川八
卖	十㇕冫大
艺	艹乙
苏	艹力八
荫	艹阝月
萨	艹阝立丿
蕴	艹絲日皿
药	艹絲勹丶
飄	西示風
梦	木木夕
雳	雨厂力
栋	木七小
栈	木戈
枢	木匚乂
档	木小彐
賈	西貝
枣	木冂冫
桥	木丿大川
霉	雨矢母
检	木人二⺍
枪	木人巳
楓	木風
賴	木口⺈貝
术	木丶
酿	酉丶艮
桩	木广土
楼	木米女
树	木又寸
椭	木阝大月
杨	木㇆彡
厅	厂丁
厉	厂一力
压	厂土丶
砖	石二乚丶
夺	大寸
碩	石頁
厌	厂大丶
还	之不
碍	石日一寸
厕	厂貝刂
硯	石見
壟	龍土
襲	龍亠𧘇
态	大丶心
矿	石广
牵	大冖牛
碼	石馬
历	厂力
础	石凵山
軒	車一十
辆	車一人人
貳	弋二貝
转	車二乚丶
連	之車
轰	車又又
軋	車乚
輔	車甫
尧	戈尤
翘	戈尤习习
卧	臣卜
輯	車口耳
軸	車由
东	七小
盏	戈皿
轿	車丿大川
輸	車人月刂
殴	匚乂殳
轮	車人匕
鴉	牙鳥
較	車亠八乂
轍	車亠月攵
轄	車宀丰口
轻	車㇕丶工
輾	車尸艹展
頓	七凵頁
战	卜口戈
蝇	虫口日乚
蜗	虫口冂人
卤	卜因乂
頻	止小頁
虛	虎业
貞	卜貝
齡	齒人之
蜕	虫丷口儿
蝉	虫丷日十
虑	虎心
颅	卜尸頁
卢	卜尸
螞	虫馬
虏	虎力
吴	口一大
啞	口一业
貴	中一貝
围	因工㇆
团	因寸丿
喷	口十艹貝
躪	足艹門隹
嚨	口龍
跷	足戈尤
践	足戈
呕	口匚乂
虽	口虫
圓	因口貝
骂	口口馬
啰	口四夕
跃	足丿大
响	口自口
哗	口亻匕十
呛	口人匕
叽	口几
鵑	口月鳥
唤	口⺈冂大
图	因夂冫
鳴	口鳥
嘱	口尸冂厶
啸	口彐川八
喲	口絲勹丶
題	日一止頁
师	刂一巾
畴	田丰寸
顆	日木頁
晒	日西
輝	小尤冖車
輩	非車
晓	日戈尤
鴨	甲鳥
显	日业
帅	刂巾
临	刂⺮日
监	刂⺮皿
览	刂⺮見
鉴	刂⺮金
尘	小土
旷	日广
凿	业半凵
尝	小冖二厶
暉	日冖車
賞	小冖口貝
归	刂彐
贤	刂又貝
肾	刂又月
竖	刂又立
紧	刂又絲
畅	申㇆彡
賦	貝一弋止
屿	山一乚一
峡	山二火
罢	四土厶
帳	巾長
賬	貝長
財	貝寸丿
瞒	目艹人人
巔	山十八頁
赎	貝十冫大
賄	貝大月
鴦	冂大鳥
賊	貝戈大
岖	山匚乂
嶄	山車斤
貼	貝卜口
帜	巾口八
刚	冂乂刂
賜	貝日勹彡
嬰	貝貝女
貝	貝
賭	貝者
則	貝刂
賂	貝夂口
岁	山夕
睁	目⺈彐
购	貝勹厶
罰	四言刂
赃	貝广土
贈	貝丷四日
賺	貝䒑刂八
贮	貝宀一
瞩	目尸冂厶
凯	山己几
岂	山己
悬	且厶心
丢	丿土厶
筹	⺮丰寸
迁	之千
籠	⺮龍
乔	丿大川
毡	毛卜口
乱	舌乚
篮	⺮刂⺮皿
笔	⺮毛
签	⺮人二⺍
秃	禾几
颓	禾几頁
称	禾⺈小
贊	牛儿儿貝
选	之牛儿
稳	禾⺈彐心
鵝	手戈鳥
辞	舌辛
簡	⺮門日
篓	⺮米女
氢	气㇕丶工
箫	⺮彐川八
俩	亻一人人
粤	鬼米了
侠	亻二火
伟	亻工㇆
債	亻丰貝
侥	亻戈尤
貸	亻弋貝
輿	臼車八
躯	身匚乂
偵	亻卜貝
侣	亻口口
側	亻貝刂
侨	亻丿大川
賃	亻丿士貝
伤	亻矢力
俭	亻人二⺍
伦	亻人匕
华	亻匕十
傾	亻匕頁
貨	亻匕貝
儲	亻言者
奥	自米大
亿	亻乙
剑	人二⺍刂
敛	人二⺍攵
餌	食耳
仓	人巳
馍	食艹日大
刹	乂木刂
饶	食戈尤
彻	行七刀
銜	行金
馈	食中一貝
餓	食手戈
飾	食矢巾
丛	人人一
耸	人人耳
爷	八乂冂
飯	食斤又
餒	食爪女
飢	食几
馋	食⺈儿冫
餡	食⺈臼
飲	食欠
仑	人匕
餾	食氏刀田
飽	食勹巳
貪	人丶㇕貝
伞	人䒑丨
餅	食䒑艹
邻	人之阝
館	食宀㠯
蝕	食虫
飼	食㇆一口
頒	八刀頁
创	人巳刂
貧	八刀貝
頌	八厶頁
釘	金丁
銬	金者了
铸	金丰寸
鉗	金甘
針	金十
錯	金廿日
质	斤十貝
鋪	金甫
鏈	金之車
钟	金中
铝	金口口
锅	金口冂人
鎖	金小貝
鈔	金小丿
銷	金小月
錫	金日勹彡
铛	金小彐
銅	金冂一口
盘	舟皿
鈉	金冂人
舰	舟見
鋤	金且力
鍬	金禾火
锈	金禾㇆丿
鍛	金亻三殳
錐	金隹
錦	金白巾
鈴	金人之
舱	舟人巳
鉛	金几口
钥	金月
鋒	金夂丰
銘	金夕口
欽	金欠
釣	金勹丶
鈞	金勹冫
钩	金勹厶
鋅	金辛
鏡	金立日儿
铲	金立丿
鎊	金亠冖方
鍍	金广廿又
鐮	金广刂八
锐	金丷口儿
爱	爪冖大又
释	釆又工
鋸	金尸十口
銀	金艮
錳	金子皿
鍵	金廴彐二
肤	月二人
狭	犭二火
朧	月龍
狽	犭貝
脸	月人二⺍
鵬	月月鳥
狰	犭⺈彐
獄	犭言大丶
脐	月文川
脑	月亠乂凵
脏	月广土
騰	月半馬
狞	犭宀丁
脓	月冖𧘇
胁	月力八
鰭	魚者匕日
頃	匕頁
处	夂卜
鯉	魚甲二
尔	⺈小
魯	魚日
龟	⺈日乚
島	鳥山
負	⺈貝
穎	匕禾頁
毕	匕匕十
鮑	魚勹巳
贸	氏丶刀貝
鮮	魚羊
鱗	魚米夕㐄
鴕	鳥宀匕
雏	⺈彐隹
皱	⺈彐皮
鯽	魚艮冂
务	夂力
鴛	夗鳥
匀	勹冫
烏	烏
訂	言丁
評	言丁䒑
詩	言土寸
諸	言者
誣	言工人人
語	言工㇕口
讳	言工㇆
請	言丰月
討	言寸
計	言十
謀	言甘木
諜	言廿乚木
諾	言艹大口
謊	言艹亡川
读	言十冫大
譚	言西日十
斋	文而
試	言弋工
誡	言戈艹
訝	言牙
誠	言戊㇆
誤	言口一大
顫	亠因一頁
识	言口八
贏	亡口貝凡
诽	言非
刘	文刂
課	言日木
亩	亠田
蛮	亠刂八虫
謂	言田月
弯	亠刂八弓
許	言矢十
話	言舌
颜	立丿彡頁
誘	言禾㇆丿
誨	言矢母
訓	言川
誰	言隹
剂	文川刂
认	言人
診	言人彡
论	言人匕
义	丶乂
谣	言爪牛山
讥	言几
諷	言風
詭	言⺈厂巳
詢	言勹日
諧	言匕匕白
諒	言亠口小
諺	言立丿彡
议	言丶乂
辯	辛言辛
謗	言亠冖方
訪	言方
詳	言羊
产	立丿
談	言火火
謎	言之米
謙	言䒑刂八
譴	言之一㠯
誼	言宀且
译	言又工
訣	言㇕大
誦	言又用
詞	言㇆一口
訊	言乙十
誕	言廴丿止
記	言己
辮	辛絲辛
閨	門土土
馮	冫馬
头	冫大
庆	广大
庫	广車
龐	广龍
状	丬大丶
冻	冫七小
壮	丬士
閘	門甲
閏	門王
閑	門木
閩	門虫
闖	門馬
閥	門亻戈
鹰	疒亻隹鳥
瘪	疒自人匕
閃	門人
疮	疒人巳
瘋	疒風
桨	丬夕木
奖	丬夕大
浆	丬夕水
資	冫欠貝
閻	門⺈臼
癬	疒魚羊
净	冫⺈彐
闹	門亠巾
阅	門丷口儿
阐	門丷日十
闊	門氵舌
庐	广户
悶	門心
瘫	疒又隹
癮	疒阝彐心
妆	丬女
兰	䒑二
誊	半言
憤	忄十艹貝
懶	忄木⺈貝
娄	米女
煩	火頁
郑	䒑大阝
烧	火戈尤
慚	忄車斤
兑	丷口儿
兽	丷田一口
灿	火山
惧	忄且八
养	羊川
烁	火氏小
焕	火⺈冂大
恼	忄亠乂凵
憫	忄門文
悦	忄丷口儿
忆	忄乙
递	之丷弓亻
惨	忄厶大彡
慣	忄母貝
兹	䒑幺幺
举	⺍一八工
兴	⺍一八
誉	⺍一八言
洼	氵土土
鴻	氵工鳥
涛	氵丰寸
满	氵艹人人
滞	氵艹冖巾
潇	氵艹川八
沥	氵厂力
浇	氵戈尤
浅	氵戈
漸	氵車斤
汇	氵匚
浊	氵虫
涡	氵口冂人
湿	氵日业
温	氵日皿
溅	氵貝戈
渊	氵川米
沦	氵人匕
涤	氵夂木
涣	氵⺈冂大
漁	氵魚
潤	氵門王
瀾	氵門木四
澗	氵門日
渾	氵冖車
觉	⺍冖見
沪	氵户
滨	氵宀丘八
浓	氵冖𧘇
泽	氵又工
滩	氵又隹
漲	氵弓長
汤	氵㇆彡
涩	氵刀丶止
烫	氵㇆彡火
渗	氵厶大彡
写	冖一乚一
窍	穴工了
窥	穴二人見
违	之工㇆
祷	礻丰寸
宝	宀王丶
賽	宀甘八貝
寵	宀龍
窃	穴七刀
遺	之中一貝
祸	礻口冂人
視	礻見
袄	衤丿大
鶴	冖隹鳥
穷	穴力
遥	之爪牛山
宾	宀丘八
額	宀夂口頁
农	冖𧘇
礼	礻乚
褲	衤广車
禅	礻丷日十
迟	之尸丶
逊	之子小
边	之力
辽	之了
颈	㇕丶工頁
劲	㇕丶工力
驟	馬耳又豕
剧	尸十口刂
騎	馬大丁口
馱	馬大
戏	又戈
驱	馬匚乂
駛	馬口乂
剥	彐水刂
騾	馬田絲
骄	馬丿大川
属	尸丿冂厶
馴	馬川
肃	彐川八
駁	馬乂乂
駒	馬勹口
駱	馬夂口
欢	又欠
鸡	又鳥
駐	馬丶王
昼	尸丶日一
尽	尸丶冫
駭	馬亠乡人
屡	尸米女
驴	馬户
駝	馬宀匕
恳	艮心
預	又㇕丨頁
艰	又艮
馳	馬也
劝	又力
駿	馬厶八夂
卫	冂一
际	阝示
陕	阝二火
陆	阝二山
陣	阝車
陈	阝七小
賀	力口貝
駕	力口馬
孙	子小
坠	阝人土
阶	阝人川
弥	弓⺈小
隐	阝⺈彐心
飞	乙冫
导	巳寸
結	絲士口
緒	絲者
纬	絲工㇆
绩	絲丰貝
綁	絲丰阝
縛	絲甫寸
叁	厶大三
緬	絲石卜丨
参	厶大彡
绕	絲戈尤
线	絲戈
练	絲七㇆八
綽	絲卜日十
娱	女口一大
緝	絲口耳
绳	絲口日乚
织	絲口八
絹	絲口月
紗	絲小丿
綢	絲冂土口
纲	絲冂乂
納	絲冂人
纤	絲千
媽	女馬
绣	絲禾㇆丿
緞	絲亻三殳
維	絲隹
綿	絲白巾
缴	絲白方攵
給	絲人一口
绘	絲人二厶
纵	絲人人
紛	絲八刀
緩	絲爪大又
绷	絲月月
紙	絲氏
絡	絲夂口
絢	絲勹日
約	絲勹丶
終	絲夂冫
绝	絲⺈巴
紋	絲文
紡	絲方
缠	石广甲二
絆	絲半
继	絲米乚
綜	絲宀示
綻	絲宀一止
婶	女宀申
縮	絲宀一白
縫	絲之夂丰
妇	女彐
紐	絲㇕十
绿	絲彐水
紹	絲刀口
貫	母貝
級	絲㇆人
紉	絲刀丶
紀	絲己
丝	絲絲一
緣	絲彑豕
糾	絲凵
乡	乡
貢	工貝
韧	工㇆刀丶
击	二山
贅	丰力攵貝
麦	丰夂
瑣	王小貝
琼	王亠口小
撵	扌二人車
挠	扌戈尤
揽	扌刂⺮見
势	扌丸力
搗	扌鳥山
拦	扌䒑二
择	扌又工
荊	艹一艹刂
鵲	廿日鳥
莱	艹二水
韩	十日工㇆
萝	艹四夕
苍	艹人巳
莺	艹冖鳥
酝	酉二厶
榄	木刂⺮見
槛	木刂⺮皿
櫻	木貝貝女
桦	木亻匕十
栏	木䒑二
雾	雨夂力
励	厂一力力
聾	龍耳
矾	石凡
砾	石氏小
尴	尤刂⺮皿
輻	車一口田
斬	車斤
欧	匚乂欠
鸥	匚乂鳥
虾	虫一卜
蚁	虫丶乂
唠	口艹冖力
囂	口口頁口
吶	口冂人
勛	口貝力
嗚	口烏
坚	刂又土
鱉	水冂攵魚
睐	目二水
罗	四夕
逻	之四夕
岗	山冂乂
貶	貝丿之
贍	貝⺈八言
貽	貝厶口
鸚	貝貝女鳥
矫	矢丿大川
牺	牛西
秽	禾山夕
筛	⺮刂一巾
箩	⺮四夕
衅	丿皿半
筝	⺮⺈彐
囱	鬼夂
偿	亻小二厶
仪	亻丶乂
鴿	人一口鳥
惩	行一止心
径	行㇕丶工
饅	食日四又
餃	食亠八乂
鈣	金一卜乚
錨	金艹田
鈍	金七凵
鉀	金甲
锣	金四夕
錘	金千艹二
鑲	金亠甘𧘇
镐	金亠冂口
覓	爪見
鈕	金㇕十
凤	几又
狮	犭刂一巾
肠	月㇆彡
鳄	魚口一了
毙	匕匕夕匕
鯨	魚亠口小
惫	夂田心
証	言一止
謹	言廿口丰
峦	亠刂八山
恋	亠刂八心
詐	言矢卜
謝	言身寸
訛	言亻匕
訟	言八厶
諄	言亠口子
贛	立日工貝
竞	立口儿
譜	言䒑业日
謬	言习人彡
盗	冫欠皿
庙	广由
疟	疒匚
酱	丬夕酉
閣	門夂口
痪	疒⺈冂大
盖	羊皿
粪	米廿八
烂	火䒑二
炉	火户
涝	氵艹冖力
瀕	氵止小頁
潰	氵中一貝
滥	氵刂⺮皿
鯊	氵小丿魚
沧	氵人巳
浏	氵文刂
济	氵文川
湾	氵亠八弓
泻	氵冖乚一
寝	宀丬冖又
窜	穴口中
窝	穴口冂人
禄	礻彐水
衬	衤寸
双	又又
騷	馬又丶虫
书	㇕㇆丨丶
墮	阝大月土
隕	阝口貝
险	阝人二⺍
缰	絲三田田
繚	絲大日小
絨	絲戈大
紳	絲申
缆	絲刂⺮見
娇	女丿大川
絞	絲亠八乂
締	絲亠冖巾
缕	絲米女
缤	絲宀丘八
绎	絲又工
綴	絲又又又
說	言八口儿
沒	氵力又
還	之四口𧘇
對	业羊寸
個	亻因十口
來	木人人
會	人一四日
與	臼一丨八
這	之言
點	四二卜口
後	行幺夂
從	行人人止
將	爿夕寸
時	日土寸
過	之咼
麼	广木木幺
買	四貝
讓	言亠甘𧘇
嗯	口因大心
於	方人冫
號	口了虎
發	癶弓殳
並	䒑业
錢	金戈戈
開	門一艹
當	小冖口田
卻	八人口冂
寫	宀臼勹灬
帶	廿冖巾
賣	士四貝
剛	冂䒑山刂
無	矢廿灬
換	扌⺈八大
愛	爪冖心夂
聽	耳王一心
幫	土土白巾
學	臼乂乂子
咯	口夂口
總	絲鬼夂心
區	匚口口口
萬	艹日冂厶
機	木幺戈人
進	之隹
講	言甘冂土
殺	乂木殳
網	絲冂䒑亡
裝	爿士亠𧘇
圖	因口因口
頭	一口䒑頁
應	广亻隹心
強	弓厶虫
類	米大丶頁
書	彐二日
辦	辛力辛
併	亻䒑艹
兩	丁冂人人
轉	車車寸
塊	土鬼
線	絲白水
黃	廿一由八
豬	豕者
難	廿口夫隹
兒	臼儿
傳	亻車寸
樣	木羊丶水
夠	夕夕勹口
邊	之自穴方
稱	禾爪冂土
處	虎夂几
選	之巳廿八
經	絲一巛工
數	數女攵
據	扌虎豕
變	言絲絲攵
陳	阝木日
幹	十日一十
樓	木數女
讀	言士四貝
條	亻丨夂木
亂	爪又又乚
唔	口一韋口
遠	之土口𧘇
單	口口日十
熱	土八丸灬
風	風
滿	氵廿人人
掛	扌土土卜
關	門幺凵二
飛	乙冫乙冫
劉	氏丶金刂
種	禾千日二
報	土半冂又
裡	衤甲二
盤	舟殳皿
隊	阝丷豕
楊	木日勹彡
臺	士口冖至
國	因戈口一
歲	止戊一小
壞	土亠水𧘇
離	亠乂厶隹
佔	亻卜口
達	之土羊
動	千日二力
氣	气米
係	亻丿絲
畫	彐二田一
夢	艹四冖夕
蠻	言絲絲虫
罵	四馬
雙	隹隹又
杳	木日
練	絲木四
億	亻立日心
貓	豸艹田
藥	艹白幺木
羅	四絲隹
藍	艹臣⺮皿
縣	且小丿絲
搶	扌人户口
臉	月人人人
吳	口乚大
聲	士尸殳耳
雲	雨二厶
噢	口自米大
華	艹一艹工
呃	口厂巳
養	羊丶艮
補	衤甫
團	因車寸
樂	白幺幺木
電	雨日乚
親	立木見
葉	艹廿乚木
僅	亻廿口丰
層	尸丷四日
週	之冂土口
趙	走小月
論	言人冂艹
帥	丿㠯巾
廠	广小口攵
陽	阝日勹彡
樹	木士䒑寸
奧	自丿釆大
倆	亻丁人人
權	木艹口隹
隨	阝之工月
場	土日勹彡
價	亻西貝
寶	宀王山貝
體	骨日口䒑
傷	亻矢勹彡
腳	月八口冂
丟	王厶
劍	人一人刂
業	业丷三小
孫	子丿絲
舊	艹隹臼
喔	口尸至
證	言癶口䒑
鐵	金土王戈
節	⺮艮冂
輕	車一巛工
師	丿㠯一巾
爛	火門木四
靜	丰月爪彐
燒	火土土尤
斷	幺幺乚斤
虧	虎隹一了
湯	氵日勹彡
極	木了又一
綠	絲彑水
獎	爿夕大丶
緊	臣又絲
盡	彐一灬皿
蘇	艹魚禾
簽	⺮人人人
雞	爪幺大隹
髮	長彡又丶
鬧	刂王亠巾
戲	虎一䒑戈
橋	木丿冂口
燈	火癶口䒑
屬	尸水勹虫
窮	穴身弓
韓	十日口㐄
刪	冂艹刂
衝	行千日二
蓋	艹土厶皿
蘭	艹門木四
壓	厂日丶土
齊	亠丷氏川
隻	隹又
黨	小冖二灬
雖	口虫隹
戰	口口十戈
沖	氵中
園	因土口𧘇
鄉	乡丶艮阝
鄭	丷酉大阝
煙	火西土
廣	广廿由八
歸	丿㠯冖巾
滾	氵亠口𧘇
靈	雨口人人
趕	走日一十
勝	月半力
獲	犭艹隹又
覺	臼乂乂見
準	氵隹十
慘	忄厶人彡
漢	氵廿口夫
嘎	口一自戈
戶	斤㇕
寧	宀心皿丁
槍	木人户口
麗	一冂丶鹿
興	臼冂口八
觀	艹口隹見
製	牛巾亠𧘇
餘	食人禾
筆	⺮彐二
榮	火火冖木
陸	阝土八土
願	厂白小頁
嚇	口土川八
莊	艹爿士
寬	宀艹見丶
狀	爿大丶
閒	門月
聯	耳幺凵二
實	宀母貝
環	王四口𧘇
耶	耳阝
標	木西示
歐	匚口口欠
顧	户隹頁
滅	氵戊一火
運	之冖車
輪	車人冂艹
溫	氵因人皿
拋	扌尤力
憑	冫馬心
檔	木小口田
牆	爿土因口
擬	扌匕㇕止
穩	禾爪彐心
曉	日土土尤
宮	宀口鬼
嘍	口數女
脫	月八口儿
勁	一巛工力
創	人户口刂
爾	丁八乂乂
掙	扌爪彐
錄	金彑水
餵	食田展
稅	禾八口儿
專	車寸
繼	絲幺幺乚
產	文厂生
淚	氵户大丶
聖	耳口王
遊	之方矢子
偉	亻韋口㐄
爭	爪彐
鄧	癶一䒑阝
淨	氵爪彐
彈	弓口日十
減	氵戊一口
義	羊手戈
響	乡丶立日
絲	絲絲
麥	木人人夕
雜	亠人木隹
鍾	金千日二
鋼	金冂䒑山
蔣	艹爿寸
幣	水冂攵巾
絕	絲刀巴
幾	幺幺戈人
屆	尸土凵
認	言刀丶心
夾	大人人
嚴	口口耳攵
礦	石广由八
廳	广耳一心
註	言丶王
劇	虎豕刂
農	日刂辰
尋	彐工口寸
顯	日幺灬頁
擺	扌四匕匕
擠	扌亠氏川
術	行木丶
祇	礻氏
腦	月巛鬼乂
禮	礻日口䒑
澤	氵四土半
呂	口鬼
鳳	几一鳥
鑽	金牛儿貝
陰	阝人二厶
唸	口人㇕心
涼	氵亠口小
鹽	臣矢乂皿
獨	犭四勹虫
窩	穴咼
舉	臼一八工
厄	厂巳
傑	亻夕㐄木
噸	口七凵頁
慶	鹿㇕心夂
衛	行韋口㐄
蕭	艹彐片爿
勸	艹口隹力
讚	言牛儿貝
倉	人户口
釦	金口
盧	虎田皿
購	貝甘冂土
導	之䒑自寸
噴	口十十貝
優	亻一心夂
掃	扌彐冖巾
託	言丿七
賤	貝戈戈
懷	忄亠水𧘇
凱	山一䒑几
鐘	金立甲二
薩	艹阝丿生
揚	扌日勹彡
鍊	金木四
質	斤斤貝
喬	丿大冂口
欄	木門木四
鍋	金咼
儀	亻羊手戈
遲	之尸水牛
捲	扌半巳
儂	亻日刂辰
臨	臣矢口口
繞	絲土土尤
輛	車丁人人
溝	氵甘冂土
鬥	刂王王
湊	氵春一大
識	言立日戈
劑	亠丷川刂
營	火火口鬼
殘	一夕戈戈
廢	广癶弓殳
賢	臣又貝
磚	石車寸
棟	木木日
撿	扌人人人
驚	艹勹攵馬
備	亻廿丿用
撥	扌癶弓殳
溼	氵一幺土
淺	氵戈戈
顏	文厂彡頁
匯	匚氵隹
盜	氵欠皿
恆	忄二夕
濤	氵士日寸
豐	丰丰口䒑
戀	言絲絲心
圍	因韋口㐄
俾	亻鬼十
蝦	虫㇕㇕又
險	阝人人人
撐	扌小口牙
殼	士冖几殳
擋	扌小口田
盃	不皿
蟲	虫虫虫
徵	行山王攵
暨	艮七日一
濃	氵日刂辰
塵	鹿土
滬	氵户口巴
塗	氵人禾土
灣	氵言絲弓
尹	尹
廖	广习人彡
攝	扌耳耳耳
醫	匚矢殳酉
妞	女㇕十
邱	丘阝
續	絲士四貝
膠	月习人彡
牠	牛也
撈	扌火扌力
倫	亻人冂艹
鋁	金口鬼
爺	八乂耳阝
霧	雨又夂力
韋	韋口㐄
歡	艹口隹欠
嗨	口氵矢母
積	禾丰貝
喃	口十冂半
豔	丰丰厶皿
鄒	勹凵凵阝
罷	四厶匕匕
妳	女⺈小
異	田廿八
隱	阝爪彐心
藝	艹土二厶
攜	扌山八口
腎	臣又月
撲	扌业羊
彎	言絲絲弓
薑	艹三田田
畝	亠田⺈丶
擊	車凵殳手
潔	氵丰刀絲
嶺	山人之頁
檢	木人人人
護	言艹隹又
傘	人人人十
燙	氵日彡火
冊	冂艹
敵	亠丷口攵
譯	言四土半
柯	木丁口
驢	馬虎田皿
勢	土八丸力
蒐	艹鬼
萊	艹木人人
兇	乂凵儿
鷹	广亻隹鳥
韻	立日口貝
邁	之艹冂厶
搖	扌夕牛山
畢	甲艹二
勞	火火冖力
採	扌爪木
奪	大隹寸
齣	齒勹口
職	耳立日戈
櫃	木匚一貝
廟	广十十月
壯	爿士
邵	刀口阝
墊	土半丸土
妍	女一艹
膽	月⺈八言
姬	女臣
龜	丿黽
壽	士㇕口寸
晉	二厶厶日
爐	火虎田皿
辭	爪又又辛
兮	八了
脈	月斤氏
嚐	口小匕日
俞	人一月刂
誇	言大一了
毀	臼土殳
悅	忄八口儿
獻	虎一大丶
審	宀釆田
茲	艹幺幺
牽	亠幺冖牛
癢	疒羊丶艮
凍	冫木日
複	衤矢日夂
糧	米日甲二
濟	氵亠氏川
參	厶厶人彡
紮	木乚絲
彥	文厂彡
棄	亠厶廿木
婷	女亠冖丁
菸	艹方人冫
脣	辰月
憂	一白心夂
嬌	女丿冂口
遞	之斤虎
琪	王其
確	石冖隹
郡	尹口阝
協	十力力力
瓊	王⺈目夂
髒	骨艹匕艹
薰	艹千二灬
粵	鬼釆了
堅	臣又土
妝	爿女
決	氵㇕大
適	之亠十口
俠	亻大人人
腸	月日勹彡
倪	亻臼儿
務	又㇕夂力
雯	雨文
醬	爿夕寸酉
態	厶月匕心
繡	絲彐片爿
蒼	艹人户口
蔥	艹鬼夂心
執	土半丸
龔	龍廿八
腫	月千日二
縱	絲行人止
壇	土亠日一
觸	⺈用勹虫
懸	且小絲心
瑩	火火冖王
幀	巾卜貝
灑	氵一丶鹿
燉	火亠子攵
擁	扌亠乡隹
聶	耳耳耳
猶	犭丷酉
繫	車凵殳絲
擔	扌⺈八言
賓	宀一小貝
攤	扌廿夫隹
頸	一巛工頁
臟	月艹戈臣
憶	忄立日心
遷	之西大巳
禍	礻咼
潛	氵七儿日
郵	千艹二阝
齋	亠丷川小
仕	亻士
鉤	金勹口
疊	田田冖且
遙	之夕牛山
霖	雨木木
監	臣⺮皿
牴	牛氏丶
朕	月䒑大
饒	食土土尤
壩	土雨革月
纏	絲广八土
鹹	卜因一口
聰	耳鬼夂心
捱	扌厂土土
銳	金八口儿
驗	馬人人人
翹	土土习习
楠	木十冂半
裴	非亠𧘇
堯	土土土尤
澆	氵土土尤
樁	木春臼
禪	礻口日十
佬	亻者匕
瑤	王夕牛山
習	习习白
臥	臣人
阮	阝二儿
歷	厂禾禾止
躍	足习习隹
範	⺮車巳
邢	一艹阝
擰	扌宀皿丁
莎	艹氵小丿
糞	米田廿八
嵐	山風
濱	氵宀小貝
議	言羊手戈
閱	門八口儿
繩	絲黽
擴	扌广由八
傢	亻宀豕
婦	女彐冖巾
嘆	口廿口夫
艦	舟臣⺮皿
籌	⺮士口寸
奎	大土土
趨	走勹勹凵
競	立口口儿
釋	釆四土半
湧	氵又用力
潑	氵癶弓殳
樊	木乂木大
漿	爿夕寸水
攪	扌臼乂見
倩	亻丰月
階	阝匕匕白
嘯	口彐片爿
徑	行一巛工
屍	尸一夕匕
灘	氵廿夫隹
災	巛火
暢	申日勹彡
詠	言丶水
茹	艹女口
鄰	米夕㐄阝
揀	扌木四
艙	舟人户口
織	絲立日戈
驅	馬匚口口
轟	車車車
攔	扌門木四
摟	扌數女
竄	穴臼巛
墜	阝丷豕土
皺	勹凵凵皮
擇	扌四土半
鹼	卜因人人
窯	穴羊灬
叢	业羊耳又
錶	金丰𧘇
屢	尸數女
攬	扌臣四見
澀	氵刀止止
踹	足山而
瑜	王人月刂
豈	山一口䒑
瀉	氵宀勹灬
遼	之大日小
豎	臣又口䒑
麟	鹿米夕㐄
祿	礻彑水
翟	习习隹
醜	酉鬼
厲	厂艹冂厶
憲	宀丰四心
喚	口⺈八大
際	阝夗示
狄	犭火
誌	言士心
獅	犭丿一巾
氫	气一巛工
竇	穴士四貝
墳	土十艹貝
虞	虎口一大
築	⺮工凡木
剝	彑水刂
籃	⺮臣⺮皿
睿	卜冖人目
咦	口大弓
詹	⺈厂八言
侃	亻口川
纖	絲人非一
楞	木四方
兌	八口儿
撫	扌矢廿灬
媛	女爪大又
繪	絲人四日
黴	行山灬攵
憐	忄米夕㐄
祕	礻心丿
煥	火⺈八大
淵	氵片爿
燦	火卜又米
構	木甘冂土
慾	八人欠心
鑄	金士口寸
亨	亠口了
氟	气弓川
奕	亠川八大
恥	耳心
曦	日羊了戈
黛	亻弋二灬
妾	立女
綱	絲冂䒑山
祁	礻阝
蠟	虫巛乂巛
孰	亠口子丸
綺	絲大丁口
桿	木日一十
喪	十口口展
盪	氵日彡皿
閔	門文
鎂	金羊大
復	行矢日夂
濫	氵臣⺮皿
況	氵口儿
陀	阝宀匕
莖	艹一巛工
簾	⺮广刂八
噓	口虎业
瞞	目廿人人
娛	女口乚大
梓	木辛
濺	氵貝戈戈
敘	人禾攵
鑑	金臣⺮皿
彌	弓丁乂乂
獵	犭巛乂巛
滄	氵人户口
舜	爪冖夕㐄
炳	火一冂人
頤	臣頁
廚	广士䒑寸
萱	艹宀二日
岡	冂䒑山
睜	目爪彐
撓	扌土土尤
遜	之子丿絲
甄	西土㇆丶
敖	丰力攵
覽	臣⺮四見
鬆	長彡八厶
厭	厂日大丶
峽	山大人人
彷	行方
寢	宀爿冖又
僑	亻丿冂口
徹	行亠月攵
廈	广一自夂
茗	艹夕口
擾	扌一心夂
襯	衤立木見
伽	亻力口
痣	疒士心
譽	臼一八言
跡	足亠川八
廂	广木目
汀	氵丁
蘊	艹絲人皿
勻	勹二
棲	木一彐女
瑛	王艹冂大
迦	之力口
矯	矢丿冂口
竅	穴白方攵
緯	絲韋口㐄
繆	絲习人彡
菁	艹丰月
鎳	金自木
嘔	口匚口口
岑	山人丶㇕
斐	非文
閤	門人一口
釀	酉亠甘𧘇
彙	彑冖日木
蘸	艹酉隹灬
呸	口不一
胤	儿幺月
蹤	足行人止
婁	數女
桓	木二日
壘	田田田土
覃	西日十
嗆	口人户口
眾	四亻人人
菴	艹大日乚
饞	食⺈儿丶
滯	氵廿冖巾
臻	至春禾
眺	目氵儿
醣	酉广彐口
晏	日宀女
蘿	艹四絲隹
誅	言牛小
錠	金宀一止
蘆	艹虎田皿
貿	氏刀貝
療	疒大日小
滲	氵厶人彡
瀝	氵厂禾止
筍	⺮勹日
朔	䒑凵月
淇	氵其
膚	虎田月
陝	阝大人人
鞏	工凡革
雍	亠乡隹
麵	木人卜丨
盞	戈戈皿
嫣	女一乚灬
篩	⺮丿一巾
匡	匚王
樺	木艹艹工
牟	厶牛
霆	雨廴丿士
蠶	七儿虫虫
嘰	口幺戈人
慮	虎田心
眸	目厶牛
惱	忄巛鬼乂
裘	寸氵亠𧘇
儘	亻彐灬皿
擲	扌丷大阝
蔔	艹勹口田
迥	之冂口
巖	山口耳攵
鉻	金夂口
祺	礻其
窺	穴夫見
奮	大隹田
剎	乂木丶刂
濁	氵四勹虫
濾	氵虎田心
簫	⺮彐片爿
佰	亻一白
姦	女女女
梵	木木凡
襪	衤艹戊丶
嫖	女西示
綸	絲人冂艹
礙	石匕㇕止
闢	門尸口辛
蟬	虫口日十
違	之韋口㐄
廿	廿
裔	亠𧘇八口
湛	氵其乚
償	亻小口貝
殤	一夕勹彡
蕩	艹氵勹彡
闌	門木四
慼	戊上小心
蟻	虫羊手戈
葦	艹韋口㐄
瞥	水冂攵目
崑	山日匕匕
輓	車⺈口儿
懼	忄目目隹
嘟	口者阝
瀟	氵艹片爿
疇	田士口寸
劃	彐二一刂
札	木乚
聳	行人止耳
燭	火四勹虫
襖	衤自米大
臘	月巛乂巛
羨	羊氵欠
韶	立日刀口
阜	丿㠯十
峪	山八人口
煜	火日立
竊	穴釆冂厶
臧	爿戈臣
喀	口宀夂口
弩	女又弓
瞿	目目隹
卞	亠卜
襄	亠口甘𧘇
肅	彐片爿
鑿	业半殳金
膿	月日刂辰
懿	士冖欠心
蔭	艹阝二厶
翎	人之习习
瀚	氵十习习
僱	亻户隹
泓	氵弓厶
棧	木戈戈
摺	扌习习白
剁	几木刂
彆	水冂攵弓
鏟	金立丿生
驛	馬四土半
稜	禾土八夂
鶯	火火冖鳥
緻	絲至攵
圭	土土
塚	土冖豕
燜	火門心
搽	扌艹人木
勵	厂艹厶力
毓	矢母厶川
黏	禾人卜口
縷	絲數女
甭	不用
瞟	目西示
錚	金⺈彐
阪	阝斤又
轎	車丿冂口
繭	艹冂丨虫
鬱	牛山匕彡
曠	日广由八
禿	禾儿
諦	言亠冖巾
釉	釆由
斂	人一人攵
遁	之斤十目
晝	彐二日一
殲	一夕非一
樸	木业羊
奚	爪幺大
褚	衤者
涓	氵口月
嗟	口羊工
蠱	虫虫虫皿
儉	亻人人人
鉑	金白
絃	絲亠幺
侶	亻口鬼
詔	言刀口
嗣	口冂一口
嵩	山亠冂口
驕	馬丿冂口
蠅	虫黽
穫	禾艹隹又
丞	㇕水一
瘡	疒人户口
槓	木工貝
唷	口亠厶月
廬	广虎田皿
粽	米宀示
韌	韋口刀丶
囉	口四絲隹
鸞	言絲絲鳥
鈾	金由
釵	金又丶
剷	立丿生刂
箏	⺮爪彐
窪	穴氵土土
毋	母大
岐	山十又
挾	扌大人人
嶼	山臼丨八
糸	絲
斃	水冂夕匕
鷗	匚口口鳥
癖	疒尸口辛
岱	亻弋山
麓	木木鹿
爻	乂乂
鏢	金西示
涇	氵一巛工
凋	冫冂土口
蕙	艹車心
噗	口业羊
筠	⺮土勹冫
癲	疒十八頁
嚕	口魚日
釗	金刂
晤	日工㇕口
宸	宀辰
諫	言木四
綾	絲土八夂
漬	氵丰貝
戟	十日十戈
韜	韋口爪臼
胥	㇕止月
仄	厂人
噯	口爪心夂
嬸	女宀釆田
塢	土烏
壙	土广由八
蠍	虫日乚欠
垣	土二日
呱	口瓜
篤	⺮馬
鳩	九鳥
噬	口⺮人人
鎢	金烏
孚	爪子
穀	士冖禾殳
蓓	艹亻立口
蛆	虫且
癱	疒廿夫隹
鞘	革小月
瀨	氵木⺈貝
娣	女丷弓亻
莞	艹宀二儿
曆	厂禾禾日
謠	言夕牛山
璽	丁八王丶
醃	酉大日乚
懵	忄艹冖目
雋	隹冂一冂
禧	礻士䒑口
鷺	足夂口鳥
脅	力力力月
侖	人一冂艹
荼	艹人禾
淪	氵人冂艹
睏	日因木
軼	車牛人
蘋	艹止小頁
貯	貝宀丁
僕	亻业羊
禎	礻卜貝
隴	阝龍
頰	大人人頁
砷	石申
炯	火冂口
莘	艹辛
仟	亻千
渦	氵咼
鬢	長彡小貝
嗷	口丰力攵
籲	⺮人艹頁
藩	艹氵釆田
楨	木卜貝
贖	貝士四貝
瘀	疒方人冫
臍	月亠氏川
抿	扌巳七
孓	了丶
滌	氵亻夂木
兀	一儿
嶽	山犭大丶
痔	疒土寸
渭	氵田月
麒	鹿其
艮	艮
禦	行牛冂示
荀	艹勹日
逍	之小月
鐸	金四土半
邸	氏丶阝
柵	木冂艹
炙	夕火
倭	亻禾女
熾	火立日戈
笠	⺮立
羌	羊儿
璋	王立日十
毆	匚口口殳
咚	口夂冫
槳	爿夕寸木
恪	忄夂口
噹	口小口田
軀	身匚口口
鈷	金十口
汐	氵夕
績	忄丰貝
驥	馬丬廿八
梟	鳥木
泗	氵四
邇	之丁乂乂
啟	户口攵
渚	氵者
纜	絲臣四見
枴	木口刀
鑼	金四絲隹
廁	广貝刂
雛	勹凵凵隹
痞	疒不口
樽	木丷酉寸
崢	山爪彐
颳	風舌
咀	口且
箋	⺮戈戈
寮	宀大日小
繃	絲山月月
蒿	艹亠冂口
嬋	女口日十
硼	石月月
浚	氵厶八夂
霽	雨亠氏川
嘮	口火冖力
剌	木口刂
樵	木隹灬
糜	广木木米
漪	氵犭丁口
迴	之因口
瑕	王㇕㇕又
鐳	金雨田
噎	口士口䒑
狹	犭大人人
霓	雨臼儿
厥	厂䒑凵欠
凜	冫亠口禾
萃	艹亠人十
埔	土甫
竺	⺮二
霏	雨非
蛟	虫亠八乂
虜	虎田力
吋	口寸
夥	日木夕夕
譁	言艹艹工
瀛	氵亡女凡
瓏	王龍
苓	艹人之
丕	不一
姍	女冂艹
眩	目亠幺
弈	亠川八艹
拈	扌卜口
艱	廿口夫艮
貂	豸刀口
彝	彑米絲艹
綰	絲宀㠯
磯	石絲戈人
旌	方矢生
孜	子攵
踐	足戈戈
廝	广其斤
寐	宀爿二小
荻	艹犭火
漕	氵艹日日
磐	舟殳石
櫥	木广䒑寸
諱	言韋口㐄
馭	馬又
掄	扌人冂艹
釜	八乂王丷
騫	宀甘八馬
釐	二小甲二
隸	木示彐氵
膳	月羊䒑口
濡	氵雨而
蕪	艹矢廿灬
淞	氵木八厶
頹	禾儿頁
矇	目艹一豕
縈	火火冖絲
嬪	女宀小貝
匝	匚巾
羈	四革馬
甦	一日乂生
熹	士口䒑灬
鑰	金人冂艹
焙	火立口
訥	言冂人
襠	衤小口田
毗	田匕匕
慫	行人止心
懲	行山攵心
曖	日爪心夂
柚	木由
顱	虎田皿頁
噤	口木木示
弒	乂木弋工
諭	言人月刂
甕	亠乡㇆丶
鬚	長彡彡頁
蟒	虫艹丶艹
攆	扌夫夫車
燮	言火火又
汲	氵㇆人
姣	女亠八乂
檸	木宀皿丁
硃	石牛小
敝	水冂攵
諮	言冫欠口
樞	木匚口口
杵	木矢十
棣	木彐氵
蝨	乙十虫虫
綏	絲爪女
薔	艹土因口
蹙	戊上小足
氖	气㇆丿
帛	白巾
甬	又用
榭	木身寸
鐺	金小口田
爍	火白幺木
沅	氵二儿
濠	氵亠冖豕
嬉	女士䒑口
珀	王白
咎	夂卜口
莓	艹矢母
嘈	口艹日日
馥	禾日日夂
祗	礻氏丶
穢	禾止一小
娼	女日日
鳶	弋鳥
叟	臼丨又
墾	豸艮土
弼	弓一白弓
翡	非习习
曳	日乚丿
偕	亻匕匕白
羲	羊禾了戈
汾	氵八刀
藺	艹門隹
軾	車弋工
蛹	虫又用
儷	亻一丶鹿
啖	口火火
籬	⺮亠厶隹
熨	尸示寸火
摯	土半丸手
褶	衤习习白
髻	長彡士口
昀	日勹冫
卹	丿皿冂
疝	疒山
孑	了一
槌	木之丿㠯
榻	木日习习
漣	氵之車
妤	女又㇕丨
燬	火臼工殳
巒	言絲絲山
囑	口尸勹虫
騁	馬由了
嗑	口土厶皿
稟	亠因口禾
漳	氵立日十
沱	氵宀匕
卅	一川
颱	風厶口
燴	火人四日
擄	扌虎田力
簪	⺮七儿日
恙	羊心
嬴	亡口女凡
祚	礻矢卜
巽	巳巳廿八
觴	⺈用勹彡
汕	氵山
纓	絲貝貝女
磺	石廿由八
啜	口又又又
螢	火火冖虫
壑	卜冖又土
濂	氵广刂八
驪	馬一丶鹿
嘖	口丰貝
謁	言日人乚
讒	言⺈儿丶
溥	氵甫寸
緇	絲巛田
捨	扌人舌
罔	冂䒑亡
懇	豸艮心
厝	厂廿日
桀	夕㐄木
宥	宀大月
聿	彐二
頡	士口頁
骸	骨亠乡人
彿	行弓川
澱	氵尸八殳
檻	木臣⺮皿
餉	食自口
狙	犭且
輒	車耳乚
顰	止小鬼十
煦	日勹口灬
戍	戊丶
鱷	魚王口口
戮	习习彡戈
揖	扌口耳
攙	扌⺈儿丶
呷	口甲
詣	言匕日
烽	火夂丰
峙	山土寸
詰	言士口
淒	氵一彐女
畦	田土土
庾	广臼人
掖	扌亠夂丶
犢	牛士四貝
逵	之土八土
颯	立風
蕃	艹釆田
塹	車斤土
杞	木己
餿	食臼丨又
扉	户非
蓆	艹广廿巾
謨	言艹日大
垠	土艮
嗤	口凵一虫
篆	⺮彑豕
傭	亻广彐用
扈	户口巴
嫡	女亠十口
磬	士尸殳石
鍥	金丰刀大
踝	足日木
叱	口匕
婢	女鬼十
氾	氵巳
鼬	臼巛由
罈	牛山日十
偃	亻匚日女
濛	氵艹一豕
蝸	虫咼
銻	金丷弓亻
氐	氏丶
幔	巾日四又
渥	氵尸至
籮	⺮四絲隹
幟	巾立日戈
蛻	虫八口儿
掣	牛巾刂手
娑	氵小丿女
俑	亻又用
癒	疒人刂心
憊	亻廿用心
舫	舟方
瀏	氵氏金刂
羿	习习艹
為	丷㇕㇆灬
璜	王廿由八
渙	氵⺈八大
穹	穴弓
岫	山由
筵	⺮廴丿止
裊	鳥亠𧘇
矜	又㇕丶㇕
掬	扌勹米
纂	⺮目大絲
鰓	魚田心
鬍	長彡口月
蜃	辰虫
銓	金人王
鏽	金彐片爿
鑾	言絲絲金
蹺	足土土尤
饑	食幺戈人
榛	木春禾
簍	⺮數女
奐	⺈冂八大
癩	疒木⺈貝
淅	氵木斤
澹	氵⺈八言
禱	礻士口寸
欖	木臣四見
譏	言幺戈人
莢	艹大人人
靄	雨言人乚
顎	口口了頁
濯	氵习习隹
萼	艹口一了
楔	木丰刀大
軻	車丁口
圳	土川
煉	火木四
甌	匚口㇆丶
猥	犭田展
惺	忄日生
嘩	口艹艹工
罄	士尸牛山
髯	長彡冂土
魘	厂日丶鬼
齲	齒丿冂厶
雉	矢隹
膈	月一丷丁
櫓	木魚日
壕	土亠冖豕
涎	氵廴丿止
闋	門癶一大
菅	艹宀㠯
詮	言人王
疵	疒止匕
遐	之㇕㇕又
袂	衤㇕大
霾	雨豸甲二
虔	虎文
鉸	金亠八乂
燎	火大日小
闔	門土厶皿
銼	金人人土
舛	夕㐄
檜	木人四日
稈	禾日一十
鵠	牛口鳥
衢	行目目隹
礬	乂乂大石
岷	山巳七
狩	犭宀寸
蠡	彑豕虫虫
殆	一夕厶口
鬃	長彡宀示
飭	食矢力
琍	王禾刂
鑣	金鹿灬
靛	丰月一止
礪	石厂冂厶
氦	气亠乡人
佯	亻羊
瀆	氵士四貝
繽	絲宀小貝
鑒	臣⺮四金
贓	貝爿戈臣
耆	者匕日
捫	扌門
拚	扌厶艹
籤	⺮人非一
夙	几一夕
腑	月广亻寸
噙	口人冂厶
訖	言矢乙
潼	氵立甲二
翌	习习立
夔	䒑自八夂
刈	乂刂
舷	舟亠幺
鱔	魚羊䒑口
誑	言犭王
豢	半豕
閭	門口口
蠹	一中虫虫
庖	广勹巳
琥	王虎
賁	十艹貝
俟	亻厶矢
懾	忄耳耳耳
汙	氵一寸
缶	牛山
鏤	金數女
忝	一大忄
躡	足耳耳耳
喱	口厂甲二
諍	言⺈彐
怵	忄木丶
湍	氵山而
輟	車又又又
鏃	金方矢矢
鶉	亠口子鳥
羯	羊日人乚
俸	亻春工
翱	白大习习
肱	月大厶
瘧	疒虎匚
邕	巛口巴
茱	艹牛小
梔	木斤一巴
楹	木㇆又皿
僥	亻土土尤
倖	亻土半
慍	忄因人皿
玟	王文
礎	石木㇕止
矽	石夕
蛭	虫至
骰	骨殳
鏜	金小口土
飧	夕食
訕	言山
剋	十口儿刂
皰	皮勹巳
苒	艹冂土
箔	⺮氵白
輦	夫夫車
氳	气因人皿
牒	片廿乚木
漩	氵方㇕止
玳	王亻弋
礫	石白幺木
悵	忄長
涸	氵因十口
攘	扌亠甘𧘇
歟	臼一八欠
鐲	金四勹虫
剜	宀夗刂
苣	艹匚㇕
芍	艹勹丶
蠔	虫亠冖豕
哂	口西
仞	亻刀丶
冽	冫一夕刂
鏗	金臣又土
戾	户大丶
亟	了口又一
顓	山而頁
鎔	金穴人口
憬	忄日口小
愀	忄禾火
湮	氵西土
闡	門口日十
亙	二⺈冫
撻	扌之土羊
蒞	艹氵亻立
脩	亻丨夂月
寤	宀爿㇕口
盎	冂大皿
灤	氵言絲木
繕	絲羊䒑口
歿	一夕力又
逕	之一巛工
誥	言牛口
蹶	足厂凵欠
俚	亻甲二
魷	魚尤
鰻	魚日四又
恣	冫欠心
紂	絲寸
胄	由月
矚	目尸勹虫
笆	⺮巴
悸	忄禾子
煬	火日勹彡
睨	目臼儿
倌	亻宀㠯
孺	子雨而
殮	一夕人人
儼	亻口耳攵
皎	白亠八乂
瘓	疒⺈八大
癆	疒火冖力
蜇	扌斤虫
莒	艹口口
橇	木毛毛毛
翳	匚矢习习
賑	貝辰
篁	⺮白王
偌	亻艹大口
釧	金川
靨	厂日卜丨
冑	由冂二
澧	氵日口䒑
屜	尸行廿乚
姒	女厶人
枋	木方
懺	忄人非一
婊	女丰𧘇
斡	十日冫十
韃	革之土羊
轅	車土口𧘇
栩	木习习
睞	目木人人
僖	亻士䒑口
倏	亻丨大丶
蕨	艹厂凵欠
茴	艹因口
蛔	虫因口
醞	酉因人皿
叵	匚口
齦	齒艮
惚	忄勹彡心
棹	木卜日十
蜥	虫木斤
螟	虫冖亠八
黍	禾人水
緘	絲戊一口
攣	言絲絲手
轂	士冖車殳
佇	亻宀丁
鈐	金人丶㇕
貉	豸夂口
妊	女丿士
櫛	木⺮艮冂
斫	石斤
咻	口亻木
箴	⺮戊一口
飴	食厶口
淙	氵宀示
嫦	女小口巾
弁	厶艹
賒	貝人示
摑	扌因口一
砥	石氏丶
咫	尸丶口八
搪	扌广彐口
噫	口立日心
瞰	目㇕耳攵
僮	亻立甲二
佗	亻宀匕
塾	亠口丸土
旎	方矢尸匕
壅	亠乡隹土
繹	絲四土半
爰	爪一大又
鏘	金爿夕寸
詼	言大火
騖	又㇕攵馬
盂	一寸皿
髦	長彡毛
萸	艹臼人
卮	斤一巳
詬	言斤一口
癥	疒行王攵
綵	絲爪木
娓	女尸毛
蘚	艹魚羊
籟	⺮木⺈貝
榫	木隹十
蹊	足爪幺大
諂	言⺈臼
痿	疒禾女
祉	礻止
擻	扌數女攵
睪	四土半
釁	臼冂八刀
啻	亠丷巾口
旖	方矢丁口
姘	女䒑艹
稔	禾人㇕心
詫	言宀丿七
瀋	氵宀釆田
啾	口禾火
崙	山人冂艹
腱	月廴彐二
鱸	魚虎田皿
瘁	疒亠人十
闆	門口口口
菰	艹子瓜
洌	氵一夕刂
袒	衤日一
櫚	木門口口
囁	口耳耳耳
唳	口户大丶
篙	⺮亠冂口
嬤	女广木幺
牘	片士四貝
膺	广亻隹月
洱	氵耳
邏	之四絲隹
琶	王王巴
稷	禾田八夂
簣	⺮中一貝
痙	疒一巛工
讖	言人非一
燻	火千二灬
轡	車絲絲口
鞅	革冂大
骯	骨亠几
酋	丷酉
檳	木宀小貝
匱	匚中一貝
踵	足千日二
罹	四忄隹
臏	月宀小貝
瀰	氵弓乂乂
遽	之虎豕
陛	阝匕匕土
薜	艹尸口辛
囈	口艹二厶
崆	山穴工
銖	金牛小
獺	犭木⺈貝
芻	勹凵勹凵
惻	忄貝刂
闈	門韋口㐄
嫵	女矢廿灬
舂	春臼
璦	王爪心夂
橢	木阝工月
豕	豕
呎	口尸丶
蓀	艹子丿絲
鮫	魚亠八乂
瘴	疒立日十
憚	忄口日十
媼	女因人皿
絀	絲凵山
酊	酉丁
笞	⺮厶口
胱	月小尤
肓	亡月
麴	木人勹米
鑠	金白幺木
乩	卜口乚
呶	口女又
疽	疒且
淄	氵巛田
逅	之斤一口
菽	艹上小又
苧	艹宀丁
齪	齒足
鼾	自田一十
猷	丷酉大丶
葩	艹白巴
舐	舌氏
倨	亻尸十口
赭	土川八者
桅	木⺈厂巳
嚀	口宀皿丁
庠	广羊
慟	忄千二力
砧	石卜口
惘	忄冂䒑亡
潦	氵大日小
窠	穴日木
裨	衤鬼十
贗	厂亻鳥貝
褻	亠土丸𧘇
袞	亠八口𧘇
懍	忄亠口禾
蚩	凵一虫
殯	一夕小貝
耒	三小
榷	木冖隹
奄	大日乚
窈	穴幺力
豉	一口十又
劾	亠乡人力
憧	忄立甲二
孿	言絲絲子
荏	艹亻丿士
燧	火之丷豕
遑	之白王
嗇	土人因口
駢	馬䒑艹
藪	艹數女攵
噥	口日刂辰
嗥	口白大十
颼	風臼丨又
駟	馬四
砭	石丿之
蟑	虫立日十
憩	舌自心
臚	月虎田皿
鞣	革又亻木
饜	厂日丶食
嘗	小冖匕日
牯	牛十口
囪	鬼彡丶
儈	亻人四日
鷂	爪牛山鳥
麝	鹿身寸
沌	氵七凵
婀	女阝丁口
瑁	王日目
齷	齒尸至
喋	口廿乚木
悽	忄一彐女
悚	忄木口
驀	艹日大馬
囀	口車車寸
骷	骨十口
爨	臼冂大火
羸	亡口羊凡
攫	扌目隹又
齜	齒止匕
秣	禾一木
僭	亻七儿日
樅	木行人止
儔	亻士口寸
羶	羊亠日一
汨	氵日
閡	門亠乡人
摒	扌尸䒑艹
齬	齒工㇕口
瞑	目冖亠八
穡	禾土因口
穌	魚禾
阡	阝千
璩	王虎豕
獐	犭立日十
琺	王氵土厶
芟	艹殳
俎	人人且
肫	月七凵
彗	丰丰彐
鞦	革禾火
躉	艹日厶足
泱	氵冂大
鴆	冖儿鳥
檄	木白方攵
竽	⺮一寸
逖	之犭火
羋	丨卜卜工
靼	革日一
簞	⺮口日十
佞	亻二女
諉	言禾女
瘍	疒日勹彡
闐	門十且八
縊	絲䒑八皿
戛	一自戈
璣	王幺戈人
吒	口丿七
倥	亻穴工
猓	犭日木
孀	女雨木目
嚶	口貝貝女
跚	足冂冂一
牖	片户甫
徨	行白王
阱	阝二川
皴	厶八夕皮
黜	四二凵山
兗	亠八口儿
磋	石羊工
烊	火羊
鄹	耳又豕阝
彫	冂土口彡
紜	絲二厶
鏍	金田絲
滓	氵宀辛
娌	女甲二
槨	木亠子阝
踴	足又用力
驃	馬西示
恫	忄冂一口
皚	白山口䒑
揆	扌癶一大
碉	石冂土口
譎	言又八口
奘	爿士大
痱	疒非
湔	氵䒑月刂
潺	氵尸子子
覲	廿口丰見
劬	勹口力
恿	又用心
坍	土冂亠
蚶	虫甘
曷	日勹人乚
鰍	魚禾火
忖	忄寸
惆	忄冂土口
閂	門一
邐	之一丶鹿
齟	齒且
蚵	虫丁口
蛄	虫十口
蠣	虫厂冂厶
俳	亻非
屐	尸行十又
瞽	士口又目
氤	气因大
臆	月立日心
徇	行勹日
腆	月冂廿八
遨	之丰力攵
駑	女又馬
匏	大一勹巳
尷	尤臣⺮皿
飩	食七凵
胛	月甲
獰	犭宀皿丁
詁	言十口
訃	言卜
疳	疒甘
惴	忄山而
窕	穴氵儿
鼙	士口鬼十
鴣	十口鳥
蕈	艹西日十
楫	木口耳
骼	骨夂口
餛	食日匕匕
狎	犭甲
麾	广木木毛
瑚	王十口月
琿	王冖車
鈸	金大又丶
鰱	魚之車
粳	米一日乂
麩	木人夕夫
歙	人一习欠
媲	女鬼匕匕
繅	絲巛日木
盍	土厶皿
萵	艹咼
傀	亻鬼
飪	食丿士
胭	月因大
謄	月半言
悻	忄土半
圯	土巳
朮	十儿丶
堊	一业土
琵	王王匕匕
頊	王頁
拮	扌士口
頷	人丶口頁
悌	忄丷弓亻
妣	女匕匕
赳	走凵
柞	木矢卜
跆	足厶口
牝	牛匕
鏑	金亠十口
滂	氵亠冖方
嫘	女田絲
倀	亻長
皈	白斤又
槁	木亠冂口
奩	大匚口口
獗	犭厂凵欠
愴	忄人户口
抉	扌㇕大
柩	木匚⺈丶
螳	虫小口土
咆	口勹巳
翕	人一习习
夤	夕宀由八
冢	冖豕
醺	酉千二灬
喟	口田月
篾	⺮四戊丶
裟	氵小亠𧘇
弭	弓耳
媾	女甘冂土
跎	足宀匕
嶝	山癶口䒑
霑	雨氵卜口
犧	牛羊了戈
蚱	虫矢卜
罟	四十口
髏	骨數女
磴	石癶口䒑
臃	月亠乡隹
愎	忄矢日夂
軛	車厂巳
苜	艹目
蜿	虫宀夗
泅	氵因人
靂	雨厂禾止
兕	冂一冂尤
鄱	釆田阝
墀	土尸水牛
挈	丰刀手
蟯	虫土土尤
仃	亻丁
狷	犭口月
麋	鹿米
縲	絲田絲
瓠	大一了瓜
蹼	足业羊
儐	亻宀小貝
鈽	金大巾
詆	言氏丶
鬲	一口丷丁
螫	土川攵虫
酩	酉夕口
戢	口耳戈
躂	足之土羊
刎	勹彡刂
簑	⺮亠日𧘇
颺	風日勹彡
膾	月人四日
褸	衤數女
擘	尸口辛手
綞	絲千艹二
縑	絲䒑刂八
餞	食戈戈
剽	西示刂
枇	木匕匕
砝	石土厶
蟈	虫因口一
愜	忄匚人人
枸	木勹口
詛	言且
疥	疒人川
畚	厶大田
梃	木廴丿士
櫝	艹士四貝
嶇	山匚口口
幗	巾因口一
鴒	人之鳥
愾	忄气米
紇	絲矢乙
坼	土斤丶
嫗	女匚口口
鬨	刂王廿八
莠	艹禾㇆丿
螂	虫丶艮阝
暹	之日隹
佾	亻八月
瘠	疒氵人月
杷	木巴
颶	風且八
鷥	絲絲鳥
慄	忄西木
黠	四二士口
麂	鹿几
毽	毛廴彐二
孱	尸子子子
瞠	目小口土
覬	山一䒑見
侏	亻牛小
坩	土甘
蓿	艹宀一白
戡	其乚戈
鍰	金爪大又
戕	爿戈
洶	氵勹乂凵
疋	㇕止
隍	阝白王
噱	口虎豕
黝	四二幺力
缽	牛山木一
蹉	足羊工
鰥	魚四水
漯	氵田絲
貲	止匕貝
鐃	金土土尤
鷓	广廿灬鳥
糢	米艹日大
萋	艹一彐女
鯧	魚日日
邂	之⺈刀牛
岌	山㇆人
舨	舟斤又
赧	土川冂又
幛	巾立日十
剴	山一䒑刂
嚅	口雨而
箝	⺮扌甘
佝	亻勹口
傯	亻鬼夂心
髭	長彡止匕
傖	亻人户口
匐	勹一口田
陲	阝千艹二
嚏	口十㇕止
佻	亻氵儿
盥	臼水皿
仳	亻匕匕
袈	力口亠𧘇
耜	三小㠯
胴	月冂一口
壢	土厂禾止
鵪	大日乚鳥
訐	言一十
犖	火火冖牛
猙	犭爪彐
遴	之米夕㐄
紼	絲弓川
駙	馬亻寸
鏝	金日四又
嗾	口方矢矢
妁	女勹丶
捩	扌户大丶
躊	足士口寸
帑	女又巾
瞌	目土厶皿
濘	氵宀皿丁
懣	氵廿人心
抨	扌丁䒑
矓	目龍
臾	臼人
伉	亻亠几
貊	豸一白
賅	貝亠乡人
睽	目癶一大
匍	勹甫
犒	牛亠冂口
癘	疒艹冂厶
娩	女⺈口儿
睥	目鬼十
臬	自木
祆	礻一大
獷	犭广由八
鱖	魚厂凵欠
陴	阝鬼十
犛	二小厂牛
軔	車刀丶
靦	石因丨見
埤	土鬼十
琊	王牙阝
躇	足艹者
儡	亻田田田
圬	土一了
螻	虫數女
覦	人一刂見
潸	氵木木月
霪	雨氵丿士
玀	犭四絲隹
遘	之甘冂土
慝	匚艹口心
紕	絲匕匕
躅	足四勹虫
肄	匕矢彐二
娠	女辰
蜴	虫日勹彡
鰾	魚西示
褫	衤斤虎
籐	⺮月半水
襤	衤臣⺮皿
怏	忄冂大
蜢	虫子皿
褓	衤亻口木
鏖	鹿金
崁	山土欠
孳	䒑幺幺子
鮪	魚大月
黷	四二四貝
妯	女由
燐	火米夕㐄
簷	⺮⺈八言
鼴	臼巛日女
蹣	足廿人人
輊	車至
躑	足丷大阝
啕	口勹牛山
輜	車巛田
韁	革三田田
轔	車米夕㐄
舢	舟山
溘	氵土厶皿
甽	田川
撚	扌夕丶灬
踟	足矢口
訌	言工
嫻	女門木
荸	艹十冖子
嚥	口廿匕灬
谿	爪幺人口
塭	土日皿
跼	足尸㇆口
犄	牛大丁口
勗	日且力
篛	⺮弓弓冫
聱	丰力攵耳
鉋	金勹巳
迆	之也
綑	絲因木
瞇	目之米
祐	礻大口
迺	之西
痺	疒鬼十
姪	女至
踫	足䒑业
珮	王几一巾
痲	疒十十儿
虱	乙丿虫
倣	亻方攵
韆	革之大巳
瑯	王丶艮阝
瘉	疒人月刂
徬	行亠冖方
伕	亻夫
鼇	丰力攵黽
餽	食鬼
櫂	木习习隹
偽	亻丷㇆灬
搾	扌穴矢卜
偺	亻夂卜日
濬	氵卜八目
浬	氵甲二
嚮	乡丶自口
蘗	艹尸辛木
啣	口牛止冂
貍	豸甲二
勦	巛日木力
梱	木因木
燄	⺈臼火火
鼕	士口夂冫
玨	王王
囌	口艹魚禾
慇	斤彐殳心
嬝	女鳥亠𧘇
