人	人入
口貝	员呗員唄
巳	已巳
口力	另叻
日冖車	晕晖暈暉
木口	束杏
弓丨	引弔
日亠口小	景晾
尹口羊	群羣
口巴	吧邑
口	口〇
木冂木冂	棘棗
口八	只叭
日𠂊口儿	晚冕
二川	井亓
山手戈	峨峩
木日	東杳
士口䒑口	喜囍
氵人冂艹	瀹淪
口土川八	哧嚇
口冂一口	嗣哃
丶艮阝	郎郞
女臣	姬姫
行	行彳
土日勹彡	埸場
山夂丰	峰峯
九日	旭旮
之	之辶
止戊一小	歲歳
人一人刂	劍剣
一川	卅丌
气川	氚氘
日干	旱旰
阝爪彐心	隱隠
艹日日	曹菖
禾爪彐心	穩穏
艹千二灬	薰薫
口口甲一	單嘽
行山王攵	徵徴
田匕匕	毗毘
人一冂艹	龠侖
金日勹彡	锡錫鍚
山厂土土	崖崕
山鳥	嶋嶌
匚	匚匸
阝大人人	陝陜
习习立	翌翋
臣巳灬	熙煕
日小兀	晃晄
日文	旻旼
王丶	玉玊
亻刀丶	仞仭
一中甘𧘇	囊嚢
土土土兀	堯墝
山㇆人	岌岋
𠂊口儿丶	兔毚
虫日勹彡	蜴蝪
月厶八夂	脧朘
王王心丿	瑟璱
月屮凵	朏胐
手戈鳥	鹅鵝鵞
忄日勹彡	惕愓
禾尤山	嵇嵆
足日勹彡	踢踼
木四	柬柶
口口口木	噪喿
人一刀丶	劒剱劔
宀臣	宦宧
山𠂉卜	岝岞
山人丶㇕	岑岒
金乂八夂	鍐鑁
革刀丶	靭靱
一夕勹彡	歾殤
几木	朵凩
石水	泵砅
艹千艹二	棰菙
日勹彡	易昒
山𠂊厂卩	峗峞
土爪寸	埒埓
口耳	咡咠
艹人冂艹	菕蘥
長彡四日	鬙鬠
木工	杠杢
木人冂厶	檎麶
艹亠厶儿	茺萒
亠丷非一	齏韲
月勹口	朐胊
艹士四貝	櫝藚
山亠丁口	嵜﨑
木且	柤査
山人月刂	崳嵛
口口口山	嵒喦
絲白水	缐線
彡頁女	媭嬃
⺮人口刂	箚劄
广匕頁	庼廎
士冖几殳	殼殻
木又亻木	楺楙
王見	现現
言丷口儿	说説
工頁	项項
長	长長
木示	标柰
木廿由八	横橫
龍	龙龍
頁	页頁
車	车車
車斤日	暂暫
車九	轨軌
車欠	软軟
齒	齿齒歯
口力刂	别別
口馬	吗嗎
貝攵	败敗
冂人	内內
貝斤又	贩販
見	见見
貝立口	赔賠
川頁	顺順
亻門	们們
人之頁	领領
金十且八	镇鎮
彡頁	须須
金戈	钱銭
金卜口	钻鉆
金牛人	铁鉄
金夂口	铬鉻
月長	胀脹
月弋二貝	腻膩
魚	鱼魚
鳥	鸟鳥
言周土口	调調
文川	齐斉
言斤丶	诉訴
言殳	设設
言亠乡人	该該
門耳	闻聞
門寸丿	闭閉
門口	问問
門日	间間
門	门門
氵貝刂	测測
宀艹見	宽寛
冖車	军軍
馬	马馬
皮頁	颇頗
馬户冂艹	骗騙
弓長	张張
弓川貝	费費
絲工	红紅
絲一屮	纯純
絲田	细細
絲且	组組
絲亠厶儿	统統
絲户冂艹	编編
干頁	顸頇
丁頁	顶頂
一弋止鳥	鹉鵡
一夕口貝	殒殞
士口頁	颉頡
走牛儿貝	趱趲
夫夫車	辇輦
夫見	规規
一兀頁	顽頑
二火頁	颊頬
王龍	珑瓏
王頁	顼頊
王之車	琏璉
王貝貝女	璎瓔
丰貝	责責
丰月見	靓靚
王馬	玛瑪
扌龍	拢攏
扌口貝	损損
扌牛儿貝	攒攢
扌門	扪捫
扌門夂口	搁擱
扌⺍冖見	搅撹
扌冖車	挥揮
艹長	苌萇
艹龍	茏蘢
十戈車	载載
艹之車	莲蓮
艹口隹頁	颧顴
艹日大馬	蓦驀
廿乚貝	贳貰
十且八頁	颠顛
艹見	苋莧
艹鳥	茑蔦
艹言人乚	蔼藹
艹門隹	蔺藺
艹冖車	荤葷
艹絲勹丶	药葯
西示風	飘飄
木長	枨棖
雨而頁	颥顬
木龍	栊櫳
木戈	栈桟𣏾
木之車	梿槤
西貝	贾賈
木見	枧梘
木風	枫楓
木魚日	橹櫓
木口𠂊貝	赖賴
木門口口	榈櫚
石頁	硕碩
石車	砗硨
厂貝刂	厕厠
石見	砚硯
龍土	垄壟
龍石	砻礱
龍言	詟讋
厂亻隹貝	赝贋
犬犬犬風	飙飆
龍衣	袭襲
石馬	码碼
車干	轩軒
車土口𧘇	辕轅
弋二貝	贰貳
車耳乚	辄輒
之車	连連
車乚	轧軋
車甫	辅輔
臣頁	颐頤
車至	轾輊
車口耳	辑輯
匚中一貝	匮匱
車口八	轵軹
車由	轴軸
車日匕匕	辊輥
車冂䒑亡	辋輞
車人月刂	输輸
車人王	辁輇
車斤土	堑塹
車斤金	錾鏨
牙鳥	鸦鴉
車亠八乂	较較
車亠月攵	辙轍
車鹿	辘轆
車米夕㐄	辚轔
車宀丰口	辖轄
車尸廿𧘇	辗輾
車刀口	轺軺
車刀丶	轫軔
一屮頁	顿頓
車巛田	辎輜
齒工㇕口	龉齬
齒止匕	龇齜
卜圍乂	卤鹵
止小頁	频頻
卜貝	贞貞
虫見	蚬蜆
齒人之	龄齡齢
止匕貝	赀貲
齒尸至	龌齷
虫馬	蚂螞
中一貝	贵貴
口丰貝	啧嘖
足艹門隹	躏躪
口龍	咙嚨
口齒	啮嚙噛
口口丂頁	颚顎
圍口貝	圆圓
口貝阝	郧鄖
足牛儿貝	躜躦
口月鳥	鹃鵑
口魚日	噜嚕
口鳥	鸣鳴
口絲勹丶	哟喲
日一止頁	题題
田木頁	颗顆
日龍	昽曨
小兀冖車	辉輝
非車	辈輩
甲鳥	鸭鴨
日見	𬀪晛
日爪大又	暖暧㬊
小冖口貝	赏賞
貝一弋止	赋賦
貝一水丶	赇賕
巾長	帐帳
貝長	账賬
巾丰貝	帻幘
貝寸丿	财財
山十八頁	巅巔
貝甫寸	赙賻
山而頁	颛顓
目龍	眬矓
貝大月	贿賄
冂大鳥	鸯鴦
貝戈大	贼賊
山車斤	崭嶄
貝卜口	贴貼
巾卜貝	帧幀
貝口儿	贶貺
貝日勹彡	赐賜
目見	𪾢睍
貝貝女	婴嬰
貝	贝貝
貝者	赌賭
貝刂	则則
貝夂口	赂賂
四言刂	罚罰
貝广土	赃賍
貝丷四日	赠贈
貝䒑刂八	赚賺
山己	岂屺
⺮龍	笼籠
牛口鳥	鹄鵠
⺮見	笕筧
禾几頁	颓頽
牛儿儿貝	赞贊
⺮門日	简簡
⺮馬	笃篤
亻長	伥倀
亻丰貝	债債
亻十艹貝	偾僨
亻木鳥	鸺鵂
亻弋貝	贷貸
臼車八	舆輿
亻卜貝	侦偵
亻貝刂	侧側
亻見	伣俔
亻丿士貝	赁賃
亻匕頁	倾傾
亻匕貝	货貨
亻言者	储儲
隹灬鳥	鹪鷦
人一口龍	龛龕
食耳	饵餌
食艹日大	馍饃
食十冖子	饽餑
乂木弋工	弑弒
食一屮	饨飩
行金	衔銜
食中一貝	馈饋
食日匕匕	馄餛
食丿士	饪飪
食丿大	饫飫
食手戈	饿餓
食𠂉巾	饰飾
食𠂉力	饬飭
食自口	饷餉
食臼丨又	馊餿
食斤又	饭飯
食爪女	馁餒
食几	饥飢
食𠂊臼	馅餡
食欠	饮飲
食氏刀田	馏餾
食勹巳	饱飽
人丶口頁	颔頷
人丶㇕貝	贪貪
食䒑艹	饼餅
食羊彐丨	馐饈
食宀㠯	馆館
食虫	蚀蝕
食㇆一口	饲飼
八刀頁	颁頒
八刀貝	贫貧
八厶頁	颂頌
食厶口	饴飴
金一艹	钘鈃
金丁	钉釘
金者丂	铐銬
金者	锗鍺
金者匕	铑銠
金丰寸	铸鋳
金耳	铒鉺
金丰月	锖錆
金王丶	钰鈺
金甘	钳鉗
金十	针針
金十口	钴鈷
金廿日	错錯
金艹隹又	镬鑊
金木一	钵鉢
金甫	铺鋪
金雨田	镭鐳
金木丶	𬬸鉥
金大十艹	锛錛
金大月	铕銪
金大丶	钛鈦
金大日小	镣鐐
金犬㇕	钹鈸
金至	铚銍
金弋	𬬩釴
金戊㇆	铖鋮
金弋心	铽鋱
金之車	链鏈
金匚㇕	钜鉅
金戈乚	钺鉞
金卜	钋釙
金圍大	铟銦
金圍十口	锢錮
金口月	𫓶鋗
金日一	钽鉭
金田土	锂鋰
金刂	钊釗
金田木	锞錁
金田	钿鈿
金小貝	锁鎖
金小丿	钞鈔
金小月	销銷
金业羊	镤鏷
金小口土	镗鏜
金冂一口	铜銅
金冂人	钠鈉
金貝	钡鋇
金目	钼鉬
金且力	锄鋤
金牛口	锆鋯
金千日二	锺鍾
金千臼	锸鍤
金牛儿	铣銑
金禾火	锹鍬
金禾㇆丿	锈銹
金亻三殳	锻鍛
金白王	锽鍠
金川	钏釧
金自木	镍鎳
金隹	锥錐
金白	铂鉑
金白巾	锦錦
金人王	铨銓
金斤	𬬱釿
金人人土	锉銼
金人丶㇕	钤鈐
金人之	铃鈴
金爪大又	锾鍰
金彡	钐釤
金斤又	钣鈑
金凡	钒釩
金几口	铅鉛
金夂丰	锋鋒
金夕口	铭銘
金氏丿卩	铆鉚
金欠	钦欽
金勹丶	钓釣
金勹冫	钧鈞
金勹厶	钩鈎
金辛	锌鋅
金立日儿	镜鏡
金亠巾	铈鈰
金衣	铱銥
金亠冖方	镑鎊
金丶艮	锒鋃
金方	钫鈁
金广廿又	镀鍍
金門木四	镧鑭
金門	钔鍆
金广刂八	镰鐮
金羊大	镁鎂
金丷口儿	锐鋭
金䒑业日	镨鐠
金火	钬鈥
金火火	锬錟
金丷弓亻	锑銻
金儿氵	铫銚
金宀一止	锭錠
金心丿	铋鉍
金尸十口	锯鋸
金皮	铍鈹
金艮	银銀
金尸匕	铌鈮
金又丶	钗釵
金刀口	𬬿鉊
金子皿	锰錳
金弓川貝	镄鐨
金了	钌釕
金廴尹二	键鍵
金女口	铷銣
金巛田	锱錙
金女	钕釹
金母	𬭁鉧
月龍	胧朧
犭貝	狈狽
風且八	飓颶
風臼丨又	飕颼
風勹巳	飑颮
月月鳥	鹏鵬
九鳥	鸠鳩
犭言犬	狱獄
月半魚	䲢鰧
月半馬	腾騰
魚一日乂	鲠鯁
魚一丷十	鲆鮃
魚土土	鲑鮭
魚士口	鲒鮚
魚土八夂	鲮鯪
魚者匕日	鳍鰭
魚春	䲠鰆
魚丰月	鲭鯖
魚耳又	鲰鯫
魚十艹貝	鲼鱝
魚廿乚木	鲽鰈
匕十鳥	鸨鴇
魚革力	鳓鰳
魚雨彐	鳕鱈
魚而	鲕鮞
匕頁	顷頃
魚大月	鲔鮪
魚尤	鱿魷
魚厂屮欠	鳜鱖
魚之車	鲢鰱
魚卜口	鲇鮎
魚圍十口	鲴鯝
魚田土	鲤鯉
魚非	鲱鯡
魚日日	鲳鯧
魚日四又	鳗鰻
魚日匕匕	鲲鯤
魚日	鲁魯
魚田心	鳃鰓
魚日习习	鳎鰨
魚周土口	鲷鯛
魚冂一口	鲖鮦
魚四水	鳏鰥
鳥山	岛島
𠂊貝	负負
𠂊用甲一	觶觯
魚禾	稣穌
匕禾頁	颖穎
魚禾火	鳅鰍
魚丿絲	鲧鯀
魚白王	鳇鰉
魚亻寸	鲋鮒
魚臼儿	鲵鯢
魚爪十凵	鳐鰩
鳥几	凫鳧
魚勹巳	鲍鮑
魚方	鲂魴
魚羊	鲜鮮
魚丷酉寸	鳟鱒
魚米夕㐄	鳞鱗
魚羊䒑口	鳝鱔
魚宀一兀	鲩鯇
鳥宀匕	鸵鴕
魚艮卩	鲫鯽
魚刀	鱽魛
夗鳥	鸳鴛
烏	乌烏
鳥木	枭梟
魚厶口	鲐鮐
言一寸	𬣙訏
言丁	订訂
言丁口	诃訶
言一丷十	评評
言土土	诖詿
言土寸	诗詩
言工	讧訌
言士口	诘詰
言者	诸諸
言工人人	诬誣
言工㇕口	语語
言丰木	诔誄
言丰月	请請
言耳又	诹諏
言寸	讨討
言十	计計
言甘木	谋謀
言廿乚木	谍諜
言艹大口	诺諾
言十口	诂詁
言艹亡川	谎謊
言其乚	谌諶
言西土	𬤇諲
言西日十	谭譚
言木四	谏諫
言豕	诼諑
言大火	诙詼
言弋工	试試
言匚王	诓誆
言戈艹	诫誡
言牙	讶訝
言七儿日	谮譖
言戊㇆	诚誠
言匚㇕	讵詎
言卜	讣訃
言虎匚	谑謔
言口一大	误誤
亠圍一頁	颤顫
亡口貝凡	赢贏
言非	诽誹
言田木	课課
言日四又	谩謾
言田八夂	谡謖
言小月	诮誚
言田月	谓謂
言且	诅詛
言冂口	诇詗
言冂一口	𫍣詷
言山	讪訕
言冂人	讷訥
言𠂉十	许許
言舌	话話
言牛口	诰誥
言𠂉木	诛誅
立丿彡頁	颜顔
言禾㇆丿	诱誘
言𠂉母	诲誨
言川	训訓
言隹	谁誰
文川刂	剂剤
言隹灬	谯譙
言人月刂	谕諭
言人王	诠詮
言人非一	谶讖
言人彡	诊診
言斤一口	诟詬
言斤	䜣訢
言爪十凵	谣謡
言犭王	诳誑
亠几頁	颃頏
言風	讽諷
言𠂊厂卩	诡詭
言勹日	询詢
言匕日	诣詣
言𠂊臼	谄諂
言匕匕白	谐諧
言氏丶	诋詆
言𠂊尹	诤諍
言亠口小	谅諒
言立日	谙諳
言立丿彡	谚諺
辛言辛	辩辯
言亠冖巾	谛諦
言亠冖方	谤謗
言方	访訪
文門木四	斓斕
言羊	详詳
言䒑八皿	谥謚
言火火	谈談
言之米	谜謎
言䒑刂八	谦謙
言冖車	诨諢
言之一㠯	谴譴
言宀且	谊誼
言宀丿七	诧詫
言㇕大	诀訣
言皮	诐詖
言又用	诵誦
言㇆一口	词詞
言乙十	讯訊
言刀口	诏詔
言廴丿止	诞誕
言刀丶	讱訒
言己	记記
言厶口	诒詒
亠乡人頁	颏頦
辛絲辛	辫辮
門土土	闺閨
門三	闫閆
冫馬	冯馮
疒木𠂊貝	癞癩
門木四	阑闌
广車	库庫
門大申	阉閹
广龍	庞龐
門戈口一	阈閾
門圍木	阃閫
門甲	闸閘
門日日	阊閶
門一	闩閂
門王	闰閏
門木	闲閑
門虫	闽閩
門言	訚誾
門馬	闯闖
門亻戈	阀閥
門人	闪閃
門爪冖又	阌閿
疒風	疯瘋
冫欠貝	资資
門𠂊臼	阎閻
疒魚羊	癣癬
門亠几	闶閌
門亠乡人	阂閡
門丷口儿	阅閲
門氵舌	阔闊
門心	闷悶
門癶一大	阕闋
門㇕耳攵	阚闞
疒阝彐心	瘾癮
忄長	怅悵
羊魚	鲝鯗
忄十艹貝	愤憤
忄木𠂊貝	懒懶
米女	娄籹
火頁	烦煩
忄車斤	惭慚
忄門文	悯憫
火門心	焖燜
忄冖車	恽惲
丷弓亻鳥	鹈鵜
忄母貝	惯慣
氵工鳥	鸿鴻
氵丰貝	渍漬
氵龍	泷瀧
氵車斤	渐漸
氵之車	涟漣
氵卜貝	浈湞
氵貝	𬇙浿
氵魚	渔漁
氵門王	润潤
氵門木四	澜瀾
氵門日	涧澗
氵冖車	浑渾
⺍冖見	觉覚
氵弓長	涨漲
氵絲隹	潍濰
宀甘八貝	赛賽
宀甘八馬	骞騫
宀龍	宠寵
示卜貝	祯禎
之中一貝	遗遺
示見	视視
冖隹鳥	鹤鶴
宀夂口頁	额額
示馬	祃禡
衤广車	裤褲
馬丰石	𬴃騞
馬耳又乑	骤驟
馬其	骐騏
馬大丁口	骑騎
馬大	驮馱
馬匚乂	驱駆
馬圍大	骃駰
馬口乂	驶駛
馬非	𬴂騑
馬田木	骒騍
馬田絲	骡騾
馬且	驵駔
馬冂口	𬳶駉
馬四	驷駟
馬川	驯馴
馬隹	骓騅
馬鬼夂心	骢驄
馬乂乂	驳駁
馬勹口	驹駒
馬夂口	骆駱
馬氏刀田	骝騮
馬丶王	驻駐
馬辛	骍騂
馬衣口甘	骧驤
馬亠乡人	骇駭
馬丬廿八	骥驥
馬䒑艹	骈駢
馬宀匕	驼駝
馬户习习	骟騸
又㇕丨頁	预預
馬又	驭馭
馬馬馬	骉驫
馬尸子子	骣驏
馬也	驰馳
馬厶口	骀駘
馬厶八夂	骏駿
阝龍	陇隴
阝車	阵陣
力口貝	贺賀
力口馬	驾駕
絲一寸	纡紆
絲士口	结結
絲者	绪緒
絲土八夂	绫綾
絲二厶	纭紜
絲丰月	𬘬綪
絲丰阝	绑綁
絲寸	纣紂
絲甘	绀紺
絲革	缂緙
絲廿乚	绁紲
絲甫寸	缚縛
絲木木	𬘭綝
絲木目	缃緗
絲辰寸	缛縟
絲㇕圍目	缅緬
絲戊一口	缄緘
絲至	绖絰
絲卜日十	绰綽
絲口耳	缉緝
絲圍大	𬘡絪
絲口月	绢絹
絲非	绯緋
絲日四又	缦縵
絲小丿	纱紗
絲小月	绡綃
絲日一止	缇緹
絲田絲	缧縲
絲周土口	绸綢
絲冂口	䌹絅
絲貝貝女	缨纓
絲冂人	纳納
絲丿士	纴紝
絲牛儿貝	缵纘
女馬	妈媽
絲禾㇆丿	绣綉
絲亻三殳	缎緞
絲川	𬘓紃
絲隹	维維
絲白巾	绵綿
絲白方攵	缴繳
絲人一口	给給
絲人二厶	绘絵
絲行	绗絎
絲八刀	纷紛
絲爪大又	缓緩
絲爪女	绥綏
絲丸	纨紈
絲氏	纸紙
絲夂卜口	绺綹
絲夂口	络絡
絲勹日	绚絢
絲勹丶	约約
絲夂冫	终終
絲𠂊巴	绝絶
絲文	纹紋
絲方	纺紡
女門木	娴嫻
絲半	绊絆
絲丷四日	缯繒
絲羊䒑口	缮繕
絲米乚	继継
絲宀示	综綜
絲宀一止	绽綻
絲宀一白	缩縮
絲之夂丰	缝縫
絲宀㠯	绾綰
絲彐丨	纽紐
絲彐水	绿緑
絲又㇕丨	纾紓
絲弓丨	纼紖
絲刀口	绍紹
母貝	贯貫
絲㇆人	级級
絲弓川	绋紼
絲刀丶	纫紉
絲己	纪紀
絲彑豕	缘緣
絲凵	纠糾
絲厶口	绐紿
絲巛田木	缫繅
一口丁鳥	鹝鷊
一夕甲一	殚殫
一夕刂鳥	䴕鴷
工貝	贡貢
工人人見	觋覡
工人人鳥	鹀鵐
土口貝	埙塤
土川卜貝	赪赬
土烏	坞塢
士冖車殳	毂轂
耳中一貝	聩聵
丰貝力	𪟝勣
丰力攵貝	赘贅
丰力攵魚	鳌鰲
丰力攵馬	骜驁
丰月鳥	䴖鶄
王小貝	琐瑣
王牛儿貝	瓒瓚
王爪大又	瑗瑷
王冖車	珲琿
扌士口頁	撷擷
扌貝貝女	撄攖
扌金欠	揿撳
扌鳥山	捣搗
扌母貝	掼摜
廿口丰見	觐覲
艹一艹刂	荆荊
廿日鳥	鹊鵲
廿乚貝力	勚勩
甘冂土見	觏覯
十艹貝	贲賁
十口鳥	鸪鴣
十口月鳥	鹕鶘
十又頁	𫠆頍
十冖子鳥	鹁鵓
艹戊貝	蒇蕆
艹止小頁	𬞟蘋
艹中一貝	蒉蕢
艹口隹鳥	鹳鸛
艹魚刂	蓟薊
艹魚羊	藓蘚
艹又丨頁	蓣蕷
艹絲工	荭葒
甫鳥	𬷕鵏
木西貝	槚檟
木卜貝	桢楨
木貝貝女	樱櫻
木人人	枞來
木言者	槠櫧
雨言人乚	霭靄
木絲彑豕	橼櫞
石丰貝	碛磧
大丷小鳥	鹩鷯
大申鳥	鹌鵪
而鳥	鸸鴯
龍耳	聋聾
龍廿八	龚龔
豕十艹貝	豮豶
臣丰貝	赜賾
車春一大	辏輳
車丁口	轲軻
車大	轪軑
車兀	𫐄軏
車厂卩	轭軛
車亠口小	辌輬
車一口田	辐輻
車又亻木	𫐓輮
車牛人	轶軼
車臼儿	𫐐輗
車人彡	轸軫
車斤	斩斬
車斤木	椠槧
車舟	辀輈
車氏	𬨂軝
車夂口	辂輅
車丷酉	𬨎輶
車又又又	辍輟
匚車九	匦匭
匚日女鳥	𬸘鶠
戈	戈戋
戈刂	划刬
匚乂鳥	鸥鴎
弋鳥	鸢鳶
卜口見	觇覘
卜圍羊工	鹾鹺
虎业見	觑覷
止小鬼十	颦顰
止匕魚	𫚖鮆
齒大丁口	𬺈齮
齒丿冂厶	龋齲
齒足	龊齪
齒且	龃齟
齒𠂉乙	龁齕
齒臼儿	𫠜齯
齒人川	𬹼齘
齒斤	龂齗
齒匕	龀齔
齒艮	龈齦
齒刀口	龆齠
口丂鳥	鸮鴞
口工貝	唝嗊
足夂口鳥	鹭鷺
口口頁口	嚣囂
口口丂鳥	鹗鶚
口小貝	唢嗩
口貝貝女	嘤嚶
口冂人	呐吶
口貝力	勋勛
口烏	呜嗚
日冂厶頁	颙顒
日勹乚鳥	鹖鶡
日亠小頁	颢顥
水冂攵魚	鳖鱉
目犬鳥	䴗鶪
四革馬	羁羈
山大車	𪨶輋
山見	岘峴
山金欠	嵚嶔
貝周土口	赒賙
貝貝十凵	罂罌
貝辰	赈賑
貝日目	赗賵
貝貝貝	赑贔
貝丿之	贬貶
貝人示	赊賒
貝𠂊八言	赡贍
貝厶口	贻貽
貝亠乡人	赅賅
貝貝女鳥	鹦鸚
骨鳥	鹘鶻
牛儿貝阝	酂酇
廴丿士頁	颋頲
⺮丰貝	箦簀
⺮木𠂊貝	籁籟
禾火鳥	鹙鶖
舌鳥	鸹鴰
⺮中一貝	篑簣
⺮口貝	筼篔
隹言隹	雠讎
鬼十鳥	鹎鵯
鬼一人人	魉魎
人一口頁	颌頜
人一口鳥	鸽鴿
人一刂見	觎覦
人之鳥	鸰鴒
行鳥	鸻鵆
八人口鳥	鹆鵒
食巳廿八	馔饌
食木口	𫗧餗
食廿口丰	馑饉
食亠日一	𫗴饘
食日四又	馒饅
食亠八乂	饺餃
食土厶皿	馌饁
八厶习鳥	鹟鶲
金一艹刂	铏鉶
金一止	钲鉦
金一卜乚	钙鈣
金一丷丁	镉鎘
金工㇕口	铻鋙
金丰丰彐	𬭬鏏
金丰刀大	锲鍥
斤頁	颀頎
斤虎鳥	䴘鷉
金一水丶	𨱇銶
金艹一口	𨱏鎝
金艹日大	镆鏌
金艹田	锚錨
金艹冂大	锳鍈
金西示	镖鏢
金甫寸	镈鎛
金西日十	镡鐔
釆田鳥	𬸪鷭
金大丁口	锜錡
金一屮	钝鈍
金口一丂	锷鍔
金由	铀鈾
金甲	钾鉀
金日四又	镘鏝
金日匕匕	锟錕
金田心	锶鍶
金四口𧘇	镮鐶
金貝刂	铡鍘
金四勹虫	镯鐲
金廴丿士	铤鋌
金千艹二	锤錘
金𠂉木	铢銖
金亻㇕矢	𬭤鍭
金臼丨又	锼鎪
金人一口	铪鉿
金爪寸	锊鋝
金釆田	𫔍鐇
金匕匕白	锴鍇
金𠂊儿丶	镵鑱
金𠂊巴	铯銫
金氏刀田	镏鎦
金烏	钨鎢
金衣口甘	镶鑲
金亠冂口	镐鎬
金亠口子	𬭚錞
金立日心	镱鐿
金方𠂉矢	镞鏃
金亠八乂	铰鉸
金亠十口	镝鏑
金亠子攵	镦鐓
金亠厶儿	铳銃
金亠幺	铉鉉
金鹿灬	镳鑣
金广尹用	镛鏞
金丷酉寸	𨱔鐏
金䒑八皿	镒鎰
金米夕㐄	𬭸鏻
金半卩	锩錈
金䒑幺幺	镃鎡
爪見	觅覓
金宀豕	镓鎵
金宀大厶	𬭎鋐
金穴人口	镕鎔
金宀匕	铊鉈
金宀女	铵銨
金彐丨	钮鈕
金癶口䒑	镫鐙
金又八口	𫔎鐍
金彐冖又	锓鋟
金阝丁口	锕錒
金乙	钇釔
金巴	钯鈀
金弓口虫	镪鏹
金习人彡	镠鏐
舟鳥	鸼鵃
金巛乂巛	镴鑞
風卜口	飐颭
風田心	飔颸
犭王鳥	𫛭鵟
犭木𠂊貝	獭獺
月牛儿貝	臜臢
犭言犬鳥	𬸚鸑
魚士䒑口	𬶮鱚
魚西示	鳔鰾
魚木四	𬶠鰊
𠂊厂卩頁	𬱟頠
氏丶田鳥	鹠鶹
氏丶鳥	鸱鴟
魚一屮	鲀魨
魚口一丂	鳄鰐
魚日一止	鳀鯷
魚日口䒑	鳢鱧
魚𠂉卜	鲊鮓
魚夗示	𬶭鰶
魚𠂊厂卩	𬶏鮠
魚𠂊口儿	𩾃鮸
匕水頁	颍潁
匕火頁	颎熲
魚亠口小	鲸鯨
魚亠日一	鳣鱣
魚亠八乂	鲛鮫
魚广尹氵	𩾌鱇
魚䒑刂八	鳒鰜
魚儿氵	𬶐鮡
魚宀匕	𬶍鮀
魚宀女	𩽾鮟
魚又用	鲬鯒
勹口鳥	鸲鴝
魚习习白	鳛鰼
烏阝	邬鄔
魚厶大彡	鲹鯵
魚巛田	鲻鯔
魚巛乂巛	𫚭鱲
鳥衣	袅裊
言干	讦訐
言一止	证証
言廿口丰	谨謹
言艹日大	谟謨
言車心	𬤝譓
言戊一口	𫍯諴
亠圍一鳥	鹯鸇
言口一丂	谔諤
亠口尤鳥	鹫鷲
亠口甲一	亸嚲
亠口子鳥	鹑鶉
言日一止	𬤊諟
言日人乚	谒謁
言𠂉卜	诈詐
言牛儿	诜詵
言𠂉乙	讫訖
言禾女	诿諉
言身寸	谢謝
言臼人	谀諛
言亻匕	讹訛
言臼丨又	𫍲謏
文一止貝	赟贇
亠八乂鳥	䴔鵁
言人㇕心	谂諗
言八厶	讼訟
言爪大又	谖諼
言𠂊八言	谵譫
言亠口子	谆諄
言亠人十	谇誶
言亠十口	谪謫
言門木四	谰讕
立日工貝	赣贛贑
言䒑业日	谱譜
立日貝心	戆戇
言户冂艹	谝諞
言心丿皿	谧謐
言㇕止月	谞諝
言又八口	谲譎
方𠂉矢鳥	𬸦鷟
言习人彡	谬謬
言习习	诩詡
言屮凵	诎詘
疒十八頁	癫癲
广彐人貝	赓賡
广彐人鳥	鹒鶊
广金欠	𫷷廞
广廿灬鳥	鹧鷓
門者	阇闍
門西土	𬮱闉
門目犬	阒闃
門大厶	闳閎
門口口	闾閭
門十且八	阗闐
疒貝貝女	瘿癭
門自木	𫔶闑
門方人冫	阏閼
門夂口	阁閣
門氏日	阍閽
門文	闵閔
門丶艮	阆閬
門日习习	阘闒
門土厶皿	阖闔
門䒑屮欠	阙闕
䒑八皿鳥	鹢鷁
䒑彐八鳥	鹣鶼
䒑幺幺鳥	鹚鶿
忄中一貝	愦憒
忄貝刂	恻惻
氵十艹貝	𣸣濆
氵木𠂊貝	濑瀨
氵止小頁	濒瀕
氵中一貝	溃潰
氵日小頁	灏灝
氵小丿魚	鲨鯊
氵人月鳥	鹡鶺
儿氵頁	𫖯頫
氵言𠂉十	浒滸
氵文川	济済
氵又丨頁	滪澦
土冖豕	塚塚
宀甘八鳥	𬸣鶱
穴鳥	窎窵
衤門木四	襕襴
衤之車	裢褳
衤冖車	裈褌
冖車皮	皲皸
冖車阝	郓鄆
冖儿鳥	鸩鴆
門木鳥	鹇鷴
馬西示	骠驃
馬雨木目	骦驦
馬不一	𬳵駓
馬厂白小	𫘪騵
馬日一止	𫘨騠
馬日	驲馹
尹口頁	𫖳頵
尸貝	屃屓
馬牛儿	𬳽駪
尸鳥	鸤鳲
尸口辛鳥	䴙鸊鷿
馬亻寸	驸駙
馬人禾	𬳿駼
艮七儿魚	𬶨鱀
馬爪幺大	𫘬騱
馬勹十凵	𫘦騊
又又木頁	颡顙
又㇕口鳥	鹬鷸
又㇕攵鳥	鹜鶩
又㇕攵馬	骛騖
馬米夕㐄	𬴊驎
馬癶一大	骙騤
馬㇕大	𫘝駃
馬彐水	𫘧騄
馬又丶虫	骚騷
馬彐冖又	骎駸
阝大月土	堕墮
阝止小馬	骘騭
阝中一貝	𬯎隤
阝口貝	陨隕
习习彡鳥	鹨鷚
习习冖車	翚翬
絲亞日	缙縉
絲一日乂	绠綆
絲士口頁	缬纈
絲十且八	缜縝
絲西示	缥縹
絲雨而	𦈡繻
絲大丁口	绮綺
絲大日小	缭繚
絲犬㇕	绂紱
絲大厶	纮紘
絲戈大	绒絨
車絲絲口	辔轡
絲口口木	缲繰
絲之一㠯	缱繾
絲申	绅紳
絲日匕匕	绲緄
絲田心	缌緦
絲四口𧘇	缳繯
絲目小丿	缈緲
絲四灬土	𬙊纆
絲千二灬	𫄸纁
女爪大又	媛嫒
絲廴丿止	𫄧綖
女又馬	驽駑
絲𠂉乙	纥紇
絲之丿㠯	缒縋
絲亻㇕矢	缑緱
絲乂大巾	𫄨絺
絲八人口	绤綌
絲爪冖又	绶綬
絲勹十凵	绹綯
絲夂㐄	绛絳
絲匕匕	纰紕
絲衣口甘	𬙋纕
絲亠冂口	缟縞
絲亠口子	𬘯綧
絲衣日	缞縗
絲立日心	𫄷繶
絲亠冂厶	缡縭
絲亠八乂	绞絞
絲亠冖巾	缔締
絲䒑八皿	缢縊
絲䒑刂八	缣縑
絲半卩	绻綣
絲丷弓亻	绨綈
絲宀由八	𬙂縯
絲冖儿	𬘘紞
絲又又又	缀綴
絲巳七日	缗緡
絲廴丿士	𬘩綎
絲习人彡	缪繆
絲巛田	缁緇
絲屮凵	绌絀
木刂⺮見	榄𬄦
絲口八	织𥿗
木馬	杩榪
口弓丨	吲𠰀
雨氵丿士	霪䨙
魚人二厶	鲙𩷆
口口一戈	戰𡃹
艹廿冖巾	蔕𦷾
艹魚禾大	𡚡𫰅
亻大一丂	侉𪝄
魚由	鲉鮋
絲三田田	缰繮
牛口	告吿
金尸目	镅鎇
艹丨米女	𡳶𬟗𬞰
日者	暑暏
氵宀皿丁	濘𬈿
厂車	厍厙
土川八見	𧹦䚂
日一寸	旴㝵
絲米女	缕𫃵
八刀又貝	𪬼𫎤
小冂口	尚尙
巴土八夂	𱜞𪩮
木門一艹	𬂻𣛣
扌宀皿丁	擰𢴕
氵廿冖巾	滯𣻉
羊大乚木	𫅠𬙾
匕匕	比𫧇
月門寸丿	𫆝𦟼
扌丸	执𢩾
山鬼	嵬㟴
口巾	吊𫩒
艮七儿木	槩㮣
𠂊小田土	𨤰𫒂
𠂉小田土	𨤰𫒂
口口一丂	咢㗁
鳥艹隹又	鹱鸌
金月穴工	𨭒𨭏
土尹口羊	𡑳𡑱
口艹夂口	𠺴𡀩
土厶衤甫	𠬖𠬕
木小口儿	𣘽𣗋
子瓜鳥	𪂮𪂲
扌魚日	撸擼
口門木四	𪢌㘓
艹四冖又	蘉𦴋
矢一䒑艮	𥐇𬑶
氵艹冖巾	滞𤀐
亻户小丿	𪝹𫣪
扌日	抇𢪏
木豕	椓㭬
四土丶㇕	黔𪑑
厶人一卜	𠀳𫠪
口禾彐心	𡅯𪢖
习习立申	𫅮𫅲
金口王	锃鋥
絲亠口小	𫟅綡
車卜尸	轳𨋤
人一一卜	𠁄𣍋
扌宀小貝	擯𢺔
小門寸丿	𡭬𡮣𡮥
車田夂口	𨎟𫏾
王艹心	𢚸𪫵
羊大日一	𦏄𫅝
艹人口刂	剳𦼃
木木工㇕	𬃂𬂽
王亠冖巾	𤧛𪼀
人水	汆氽
几二月刂	𩙌𬲂
山𠂉乙	屹𪨣
口耳戈	戢𠺵
扌日甘𧘇	𢺖𱠻
長彡丘八	鬓鬂
艹宀皿丁	薴𬞊
户廿八	𢩉𫼌
艹木口	莕𫇿
士冖殳心	慤愨
扌匕匕	批𢪲
王艹十又	𪔠𲎚
田木𠂊貝	𣡙𣡚
田木刀貝	𣡙𣡚
日卜尸	𣆐𬀭
口艹木四	𪢠囒
日豕者	𣌁𣌂
門月	𫔮閒
山兀	屼𡵉
日一丂	𣅙𣅘
金廿由八	𨱑鐄
扌业羊寸	𣝉𢷮
口艹口䒑	𠻼𡃻
𠂉木冂艹	𣘈𣜱𪳔
人一口貝	𡃋𫭕
食戈	饯𩚧
爪	爪𫜵
几二之艮	𫗂𫗁
四厶匕匕	罷𠤩
火日甘𧘇	𪹷𬋟
口一夕刂	咧𡂲
一木圍目	𬰠𩈘
亦鳥	鸾鵉𪁂
日广卜口	𣈔𣈘
山日冂厶	嵎𡺥
艹虎一丂	𧃷𬞲
一夕丿皿	殈𬠼
禾厶卜貝	𥢅𥢆
長彡人人	鬗𩯮
月日甘𧘇	𣎦𦣙
土巳	圯𡉏
貝刂寸	𫴯𡬷
亠乂一八	𫥪𫥮
金廿八	𫟹鉷
氵魚日	澛瀂
䒑彐䒑业	𫡁𫡂
門小	𡭜𡮉𨳒
几二刂心	𫗄𫗃
門文工	𫔳𫔤
户氏	𬇋𣱆
足艹人人	蹒𨅼
尸毛田凵	𡳒𤳰
尸毛由凵	𡳒𤳰
𠂊用八夂	𧤁𧤸
尸丶者阝	𡳤𡳢
女厶四貝	𡤓𪦲
厶口亻弋	𠳙𫢼
亻木一見	𧡊𫌠
片心	𬌔𬌓
扌丿尸丶	𡱩𢭑
火火冖力	勞𤏪
人王冂艹	𠓹𠓻𫤍
魚卜尸	鲈𫙔
夕卜人土	𡎥𫮋
山亠口小	𡹞𡹡
口王	呈㕵
扌人人人	撿𪭮
亻八之艮	𠑉𫤈
火門亠巾	𬊢𤐛
門寸丿小	𡮤𫴼
一止冂口	𣦎𬆈
艹門木四	𬞕蘭
几言十	𧦔𪞴
人人夕卜	𡎢𡎦
口土卩又	𠼶𠾷
口口耳攵	嚴㘙
風之艮	𩘬𩘩
門一艹	𫔭開
土川者見	𬦄𧺃
金魚日	镥鑥
金尸㇆口	锔鋦
户习㇕大	𦑗𬚇
矢一口䒑	短𥐍
丿皿丿卩	𧖰𧖱
木艹木四	𬅉欗
日行人禾	𣉹𬁊
日犭者	𬁑𪱂
口皿	𠰘𠱄
木口欠	欶𣒱
小門心	𡮮𡮬
匚㇕𠂊貝	𢀲𱜝
匚㇕刀貝	𢀲𱜝
卜口刀	𠛤𪟂
刀鳥	鳭𠟀
犭宀皿丁	獰𤡛
田土火火	𨤮𨤵
木艹⺮皿	𣞎𣠩
日十十月	𣋂𣊿
氵口貝	涢溳
人一几二	𫖾𬲇
一巾	巿帀
日牛巾刂	𪰮㫼
木十日一	𬃱𬄮
氵風	沨渢
風	风風
山風	岚嵐
立風	飒颯
月儿氵	朓脁
車一人人	辆輛
亻一人人	俩倆
日	日曰
户	户戶戸
士冖亞	壸壺壼
穴夫見	窥窺
扌夫夫車	撵攆
金夫	𫓧鈇
亞	亚亞亜
亞心	恶惡悪
口亞	哑啞唖
艹咼	莴萵
虫咼	蜗蝸
金咼	锅鍋
氵咼	涡渦
示咼	祸禍
女咼	娲媧
土咼	埚堝
咼	呙咼
穴咼	窝窩
申	电申
⺮衣日	簑簔
衣亻口木	褒襃
金口口	铝鋁
口口口	品𠴊
口口巴	唈𫶷
亞土	垩堊
女亞	娅婭
示一口田	福福
示申	神神
示羊	祥祥
木亞	桠椏
口亞心	𫫇噁
气亞	氩氬
一夕非一	殲殱
亻㇕圍目	偭𫖄
爲	为爲為
艹爲	𫇭蔿蒍
亻爲	伪僞偽
氵爲	沩潙溈
女爲	妫媯
扌爲	㧑撝
舟皿八夂	𥃑𪾝
