的	白斜折丶
了	了
我	手戈
是	日横竖止
在	大竖横土
你	亻斜折小
和	禾口
有	大月
不	不
就	亠竖尤竖
都	者阝
也	也
要	西女
吧	口巴
好	女子
他	亻也
去	土厶
到	至刂
上	上
那	刀竖竖阝
人	人
看	手目
中	中
呢	口折横匕
她	女也
等	⺮横竖寸
用	用
把	扌巴
下	一卜
恩	因横斜心
能	厶斜匕斜
很	行艮
多	夕夕
做	亻横攵竖
想	木竖折心
被	衤皮
地	土也
而	而
一	一
又	又
再	一竖折土
但	亻竖折一
打	扌丁
大	大
年	矢㐄
啦	口横竖立
以	厶人
嗯	口竖心横
着	羊目
小	小
得	行竖寸横
先	牛儿
啊	口折口横
或	戈竖折一
呀	口牙
找	扌戈
新	立横竖斤
及	㇆人
跟	足艮
太	大丶
嘛	口斜木横
日	日
才	寸丿
可	丁口
比	匕匕
玩	王竖竖儿
最	日横竖又
月	月
真	十竖折八
吃	口斜横乙
它	宀匕
其	其
叫	口凵
出	凵山
哈	口斜口横
向	自口
家	宀豕
之	之
更	一竖折乂
走	走
快	忄折横大
前	䒑斜折刂
由	由
高	亠竖口竖
您	亻斜心横
加	力口
所	斤折横斤
天	一大
已	己
里	甲二
啥	口斜斜舌
老	者匕
搞	扌斜口横
行	行
事	寸竖折彐
拿	人横手竖
如	女口
死	一斜折匕
像	亻斜豕横
使	亻横丶竖
成	戊㇆
只	口八
哪	口折阝横
回	因口
少	小丿
元	二儿
卡	上卜
靠	牛竖折非
算	⺮竖折艹
者	者
忙	忄亡
起	走己
各	夂口
分	八刀
咯	口斜折口
水	水
改	己攵
唉	口折斜矢
三	三
放	方攵
全	人王
按	扌斜斜女
早	日十
拉	扌立
弄	王艹
本	木一
偶	亻竖厶竖
性	忄生
第	⺮折横亻
完	宀竖竖儿
同	冂横竖口
花	艹斜横匕
怕	忄白
女	女
些	止斜折二
住	亻斜横王
名	夕口
跑	足斜折巳
次	冫欠
睡	目斜二横
哦	口斜横戈
挺	扌折士斜
王	王
掉	扌竖十竖
路	足斜折口
正	一止
外	夕卜
二	二
生	生
心	心
因	因大
子	子
作	亻斜横卜
送	之斜斜大
每	矢母
法	氵横竖厶
乖	千斜斜匕
拍	扌白
市	亠巾
撒	扌横攵斜
至	至
接	扌斜横女
美	羊大
表	丰𧘇
未	二小
非	非
即	艮冂
哎	口横竖乂
此	止匕
差	羊工
版	片斜斜又
副	一竖刂竖
系	丿絲
收	凵攵
男	田力
俺	亻横乚竖
字	宀子
股	月殳
便	亻横乂竖
考	者了
手	手
道	之斜斜自
米	米
座	广斜土斜
聊	耳斜折冂
取	耳又
低	亻斜折丶
哇	口横竖土
受	爪斜折又
包	勹巳
阿	阝横竖口
喝	口竖乚斜
白	白
金	金
四	四
近	之斤
管	⺮斜斜㠯
定	宀横竖止
交	亠斜斜乂
李	木子
笑	⺮斜横大
自	自
型	一横土竖
黑	四竖竖灬
慢	忄竖又竖
刷	尸竖折刂
穿	穴牙
越	走横折乚
位	亻立
部	立竖折阝
站	立竖横口
牛	牛
怪	忄折斜土
省	小斜横目
倒	亻横折刂
曾	丷竖折日
累	田絲
汗	氵横竖十
查	木竖折一
象	⺈竖折豕
半	半
格	木斜折口
五	工㇕
方	方
某	甘木
唔	口横口折
海	氵斜横母
相	木目
光	小尤
咋	口斜横卜
且	且
林	木木
化	亻匕
班	王竖竖王
滴	氵斜口横
店	广竖横口
安	宀女
坐	人斜斜土
度	广横竖又
俄	亻斜横戈
歌	丁竖欠竖
信	亻言
若	艹横斜口
原	厂斜横小
文	文
晚	日斜儿横
量	日横二竖
村	木寸
式	弋工
空	穴工
山	山
毛	毛
重	千竖折二
主	丶王
另	口力
入	人
伐	亻戈
血	丿皿
爽	大斜乂斜
往	行斜横王
片	片
狗	犭斜折口
共	廿八
西	西
周	冂横竖口
超	走折斜口
明	日月
均	土斜折冫
期	其月
照	日折灬竖
切	七刀
留	氏斜田折
特	牛横竖寸
神	礻申
教	者折横攵
哥	丁竖口横
甘	甘
值	亻横竖且
么	丿厶
陪	阝斜横口
既	艮横折儿
哭	口竖丶横
力	力
建	廴折横二
洗	氵斜横儿
懂	忄横二竖
口	口
指	扌斜折日
球	王横丶斜
仍	亻折横丿
活	氵舌
跌	足斜横人
清	氵竖竖月
提	扌竖止横
除	阝斜斜禾
通	之折斜用
酒	氵酉
票	西示
六	亠八
病	疒
假	亻折又折
久	⺈丶
段	亻竖竖殳
平	丁䒑
抓	扌爪
套	大長
急	⺈折横心
城	土横斜㇆
任	亻斜横士
草	艹竖折十
理	王竖折二
令	人之
雨	雨
唱	口竖折日
左	大工
常	小斜巾横
色	⺈巴
菜	艹斜斜木
集	隹木
感	戊横心竖
房	户方
混	氵竖匕斜
敢	㇕横竖攵
火	火
操	扌竖木竖
南	十竖折半
退	之艮
件	亻牛
破	石皮
德	行竖心竖
雪	雨彐
局	尸折横口
噢	口斜大斜
整	木竖止横
傻	亻斜夂斜
克	十竖折儿
呃	口横斜巳
喊	口竖口竖
跳	足斜斜儿
沈	氵斜折儿
反	斤又
篇	⺮斜艹横
待	行横竖寸
砸	石横折巾
深	氵斜木斜
根	木艮
求	寸斜斜丶
投	扌殳
款	士竖竖欠
知	矢口
八	八
配	酉己
器	口竖口竖
何	亻横竖口
率	亠折十斜
鬼	鬼
修	亻竖彡斜
面	石竖丨竖
北	丬匕
木	木
份	亻斜斜刀
情	忄竖竖月
肉	冂斜斜人
需	雨而
七	七
流	氵斜川折
招	扌折斜口
痛	疒折斜用
列	一斜折刂
石	石
香	禾日
封	土横竖寸
眼	目艮
易	日斜折彡
冷	冫斜斜之
借	亻横竖日
派	氵斜斜氏
付	亻寸
十	十
油	氵由
胡	十竖折月
排	扌非
停	亻斜丁斜
合	人横竖口
身	身
章	立竖折十
科	禾斜斜十
星	日生
牌	片斜横十
翻	釆竖习折
帖	巾竖横口
商	亠斜口斜
物	牛斜折彡
泡	氵斜折巳
玉	王丶
追	之斜横㠯
背	丬斜折月
解	⺈斜牛折
室	宀至
底	广斜折丶
代	亻弋
朱	牛小
亦	亠斜横八
乾	十竖乙斜
工	工
咱	口自
刀	刀
喔	口折横至
波	氵皮
推	扌隹
落	艹斜口斜
春	春
笨	⺮横竖一
九	九
江	氵工
短	矢横䒑竖
含	人斜口折
千	千
炒	火竖斜丿
藉	艹竖日竖
丫	丷丨
徐	行斜斜禾
秒	禾竖斜丿
青	丰月
耍	而女
夜	亠斜丶斜
吹	口欠
板	木斜斜又
土	土
姐	女且
直	十且
公	八厶
苦	艹横竖口
秀	禾折横丿
博	十横竖寸
皮	皮
朝	十竖月横
君	尹口
利	禾刂
素	丰絲
立	立
存	大竖横子
吾	一折竖口
民	巳七
命	人横冂竖
忘	亡心
茶	艹斜斜木
冰	冫水
供	亻横竖八
案	宀折斜木
田	田
初	衤刀
品	口竖折口
抽	扌由
造	之斜横口
抱	扌斜折巳
野	甲横丨折
胖	月半
故	十竖折攵
服	月竖折又
百	一白
兵	丘八
英	艹竖折大
般	舟殳
演	氵斜八横
嘴	口竖用斜
填	土横八竖
果	日木
保	亻竖折木
唐	广折横口
夏	一斜横夂
莫	艹竖折大
硬	石横乂竖
寒	宀横冫斜
挖	扌斜斜乙
凡	凡
言	言
防	阝方
街	行横竖土
距	足横折㇕
挑	扌斜斜儿
欲	八斜欠横
竟	立竖折儿
源	氵横小斜
官	宀㠯
寄	宀竖口竖
古	十口
首	䒑自
思	田心
郭	亠竖阝折
亮	亠竖几斜
干	一十
粉	米斜斜刀
爆	火竖水斜
戴	土竖戈斜
然	夕横灬斜
疼	疒斜折冫
雷	雨田
港	氵横巳斜
租	禾且
狼	犭斜横艮
狂	犭王
布	大巾
引	弓丨
捏	扌竖折土
佛	亻折横川
食	食
船	舟斜折口
今	人斜横㇕
恨	忄艮
宋	宀木
猛	犭折横皿
客	宀斜折口
友	大又
句	勹口
斯	其斤
沙	氵竖斜丿
哼	口斜了横
望	亡斜折王
腿	月斜折艮
丁	丁
祝	礻竖折儿
界	田斜斜川
抗	扌斜横几
步	止小
河	氵横竖口
缺	牛竖大折
尚	小竖折口
似	亻折斜人
羊	羊
福	礻横田竖
必	心丿
遭	之横日竖
否	不口
端	立竖折而
猜	犭竖竖月
伊	亻尹
秦	春禾
秋	禾火
毒	丰母
架	力竖折木
熊	厶斜灬斜
持	扌横竖寸
插	扌斜横臼
折	扌斤
意	立竖折心
呆	口木
基	其土
困	因木
圈	因斜斜巳
迷	之米
踢	足竖彡斜
史	口乂
甲	甲
呵	口横竖口
搬	扌斜斜殳
乃	㇆丿
右	大口
塔	土竖口竖
拖	扌斜横也
摸	扌横大竖
院	阝斜儿横
散	廿斜折攵
松	木斜斜厶
爸	八斜斜巴
喜	士竖口斜
洋	氵羊
呈	口王
治	氵折斜口
降	阝斜折㐄
富	宀横田竖
姓	女生
料	米斜斜十
嘎	口横戈斜
咬	口斜乂斜
梅	木斜横母
批	扌斜折匕
足	足
爬	爪巴
醒	酉竖折生
狠	犭艮
逛	之斜折王
精	米竖竖月
瘦	疒斜又横
踩	足釆
偷	亻斜刂斜
支	十又
杜	木土
鞋	革横竖土
展	尸横竖展
咧	口横刂斜
依	亻斜横𧘇
倍	亻斜横口
康	广折横氵
堂	小斜土横
救	寸斜攵斜
音	立日
世	廿乚
著	艹者
仲	亻中
舞	矢横㐄斜
守	宀寸
露	雨竖口斜
冒	日目
弱	弓斜冫折
影	日斜彡横
州	⺍川
替	夫竖竖日
逼	之横田竖
曲	日刂
牙	牙
箱	⺮横竖目
遍	之斜艹横
巴	巴
武	一横折止
湖	氵横月竖
程	禾竖折王
柳	木斜冂斜
偏	亻斜艹横
印	氏横竖冂
味	口竖竖小
零	雨斜斜之
角	⺈用
紫	止斜折絲
勒	革力
耶	耳阝
熟	亠竖灬斜
孔	子乚
寸	寸
厚	厂竖折子
答	⺮斜口横
社	礻土
兼	䒑折八竖
娘	女斜横艮
登	癶横䒑竖
微	行竖攵斜
佳	亻横竖土
瞭	目斜小横
雅	牙隹
魔	广竖鬼竖
司	㇆横竖口
志	士心
奇	大横竖口
瓦	一折丶折
居	尸横竖口
盛	戊折横皿
奶	女折横丿
虎	虎
后	斤横竖口
洞	氵竖口横
台	厶口
形	一横竖彡
川	川
充	亠折斜儿
害	宀竖竖口
喂	口竖折展
免	⺈竖折儿
景	日斜小横
曹	艹竖折日
煮	者灬
良	丶艮
蛋	㇕竖横虫
吐	口土
肥	月巴
仙	亻山
碰	石斜斜业
酸	酉折夂斜
侯	亻折横矢
塞	宀横土斜
欠	欠
擦	扌斜示斜
藏	艹横臣折
皆	匕斜折白
屁	尸斜折匕
永	丶水
夫	夫
琴	王横㇕斜
宏	宀横斜厶
例	亻横刂斜
砍	石欠
兄	口儿
善	羊斜斜口
增	土斜日横
施	方斜横也
暗	日斜横日
忍	刀斜横心
肯	止月
母	母
艾	艹乂
致	至攵
宗	宀示
麻	广横竖木
怒	女折斜心
扔	扌折横丿
游	氵斜子斜
腰	月横竖女
嫩	女横攵竖
肖	小月
罪	四非
仔	亻子
丑	㇕十
敏	矢折折攵
棒	木竖竖工
臭	自横斜丶
拆	扌斜斜丶
蔡	艹斜折示
校	木斜乂斜
氏	氏
糖	米斜口折
吉	士口
押	扌甲
吵	口竖斜丿
谷	八斜斜口
衣	亠𧘇
宇	宀横竖寸
末	一木
潘	氵斜斜田
告	牛口
旁	亠斜方斜
耐	而寸
董	艹斜二横
榜	木斜方斜
醉	酉斜十斜
妹	女竖竖小
宜	宀且
尼	尸匕
灰	大火
屋	尸至
楚	木横止折
丹	冂亠
乘	丿横匕斜
刻	亠折刂斜
俊	亻折夂斜
芳	艹方
抄	扌竖斜丿
酷	酉斜横口
京	亠竖折小
返	之斜斜又
瑞	王竖折而
仁	亻二
添	氵竖忄竖
催	亻竖折隹
具	且八
威	戊横竖女
核	木斜人折
瓶	䒑横丶折
犯	犭巳
族	方斜横矢
季	禾子
骨	骨
嘿	口竖灬横
黎	禾斜水斜
密	宀斜山斜
士	士
炸	火斜横卜
祇	礻氏
洪	氵横竖八
容	穴斜斜口
射	身寸
智	矢竖折日
索	十斜折絲
聚	耳折斜豕
拼	扌斜斜艹
燕	廿竖灬斜
撞	扌斜二横
膜	月横大竖
普	䒑竖竖日
竹	⺮
魏	禾折斜鬼
范	艹斜斜巳
搭	扌竖口竖
袁	土竖折𧘇
扯	扌止
彭	士竖彡斜
薄	艹斜寸横
曰	因一
胃	田月
堆	土隹
赴	走卜
躲	身斜折木
孟	子皿
抵	扌斜折丶
甜	舌甘
彩	爪横竖彡
甚	其乚
厄	厂巳
粗	米且
申	申
念	人斜心折
惹	艹横心竖
盒	人横皿竖
逃	之斜斜儿
嘉	士竖口折
升	丿艹
姚	女斜斜儿
休	亻木
症	疒横竖止
斤	斤
功	工力
喇	口横刂竖
浪	氵斜横艮
扣	扌口
泰	春水
忠	中心
梁	氵折木斜
吸	口折横人
跨	足竖了竖
森	木横竖木
瞎	目斜口横
卷	半巳
于	一寸
井	二川
蛇	虫斜斜匕
寺	土寸
屏	尸斜斜艹
灌	氵横隹竖
埋	土竖折二
略	田斜折口
目	目
蒙	艹斜豕横
托	扌斜横七
巧	工了
淡	氵斜斜火
拜	手横竖丰
冬	夂冫
娜	女折阝横
池	氵也
敲	亠竖又竖
愁	禾斜斜心
勇	又斜折力
泥	氵折横匕
昏	氏日
遇	之竖厶竖
巨	匚㇕
怎	矢竖横心
磨	广竖石竖
呼	口斜寸斜
液	氵斜夂斜
泉	白水
嫁	女斜斜豕
汪	氵王
稍	禾竖斜月
薛	艹斜辛横
豆	一竖折䒑
旺	日王
攻	工攵
祥	礻羊
委	禾女
佐	亻横斜工
隔	阝横丁斜
崔	山隹
碗	石斜斜夗
吻	口斜折彡
健	亻折二折
速	之横竖口
失	牛人
雄	大折斜隹
胸	月斜凵斜
框	木横折王
暴	日横水斜
娃	女横竖土
唯	口隹
漏	氵折横雨
拔	扌横丶折
洛	氵斜折口
探	扌斜木斜
碟	石横木折
郎	丶折横阝
珠	王斜横小
尿	尸水
透	之斜丿折
惠	車心
府	广斜横寸
菲	艹非
叼	口折横一
父	八乂
耳	耳
窗	穴斜横夂
搜	扌斜又横
希	乂横斜巾
患	口竖折心
尾	尸毛
播	扌斜斜田
岩	山石
逗	之横䒑竖
限	阝艮
帝	亠斜巾斜
昌	日日
模	木横大竖
扁	户竖折艹
舒	人斜丨折
嫌	女斜八横
陶	阝斜山斜
苗	艹田
剪	䒑斜刀横
羽	习习
哩	口竖折二
稿	禾斜口横
邦	丰阝
玲	王斜斜之
坑	土斜横几
袋	亻横𧘇斜
趁	走斜斜彡
妖	女斜横大
甩	月乚
琳	王横竖木
乙	乙
伴	亻半
尊	丷横竖寸
熬	丰折灬斜
吊	口巾
霜	雨横竖目
沿	氵斜折口
伯	亻白
浩	氵斜横口
剩	禾斜刂斜
域	土横一竖
祖	礻且
肺	月横竖巾
附	阝斜横寸
制	牛竖折刂
玄	亠幺
置	四横竖且
豪	亠竖豕斜
助	且力
幽	幺折折山
欣	斤欠
辣	辛横竖口
煤	火横竖木
瓜	瓜
俾	亻斜横十
慧	丰横心折
墨	四横土斜
娶	耳折斜女
犬	大丶
炎	火火
震	雨辰
遂	之斜斜豕
斌	文竖止竖
控	扌斜斜工
覆	西斜夂横
趟	走竖口竖
禁	木横竖示
烤	火横竖了
童	立竖折二
杯	木不
暨	艮横一竖
晴	日竖竖月
魂	二折斜鬼
益	䒑斜斜皿
庭	广折士斜
肝	月横竖十
坊	土方
晨	日辰
振	扌辰
割	宀横刂竖
消	氵竖斜月
兆	氵儿
隆	阝斜生横
撤	扌斜攵斜
粥	弓斜斜弓
馨	士折日斜
滑	氵骨
曼	日竖折又
暖	日斜又横
己	己
止	止
柱	木斜横王
妻	一折横女
盾	斤横竖目
奔	大横竖艹
政	一竖横攵
爹	八斜夕斜
尹	尹
廖	广折彡斜
刺	木竖折刂
冠	冖横寸斜
躺	身竖口竖
舍	人舌
售	隹口
婚	女斜折日
妞	女折横十
邱	丘阝
兔	⺈竖丶斜
敬	艹斜攵横
潮	氵竖月竖
昂	日斜折冂
咳	口斜人折
邪	牙阝
促	亻足
鼠	臼巛
葛	艹竖乚斜
串	口中
桑	又折木折
苑	艹夗
迎	之斜折冂
弓	弓
碎	石斜十斜
余	人禾
承	㇕竖折三
迪	之由
牠	牛也
臣	臣
勤	廿竖力横
摔	扌斜十斜
蒸	艹折灬横
凌	冫横夂斜
辛	辛
旗	方斜横其
妙	女竖斜丿
始	女折斜口
符	⺮斜横寸
亭	亠竖丁斜
吼	口折横乚
云	二厶
研	石横竖艹
咪	口米
俗	亻斜口斜
珍	王斜斜彡
卓	卜竖折十
嗨	口斜母斜
捧	扌竖竖工
舔	舌竖忄竖
喃	口横半竖
愈	人横心竖
溪	氵斜大折
歪	不横竖止
晃	日竖斜尤
斜	人斜十斜
尤	尤
洲	氵斜斜川
乎	丿斜斜寸
湘	氵横竖目
妳	女斜折小
翔	羊折斜习
枝	木横竖又
逸	之斜丶斜
哄	口横竖八
餐	卜斜食折
染	氵斜折木
粘	米竖横口
炮	火斜折巳
桌	卜竖折木
芬	艹斜斜刀
萍	艹斜䒑横
晶	日竖折日
勾	勹厶
戒	戈艹
桂	木横竖土
朗	丶折横月
堵	土者
矣	厶矢
捐	扌竖折月
荷	艹斜口横
棉	木斜横巾
私	禾厶
姜	羊女
鼓	士竖又横
霞	雨折又折
瞧	目斜横灬
皇	白王
企	人止
互	一彑
沉	氵斜折几
箭	⺮斜刂斜
柏	木白
焦	隹灬
憋	水竖心斜
盟	日斜折皿
延	廴斜横止
柔	又折木斜
粒	米立
盆	八折斜皿
眉	尸目
碧	王斜横石
籍	⺮竖日竖
刮	舌刂
勿	勹彡
坤	土申
汁	氵十
浴	氵斜口斜
翼	习折八横
哲	扌斜斜口
涵	氵折凵竖
菌	艹竖折禾
桶	木折斜用
抹	扌横竖木
判	半刂
弟	丷折横亻
傅	亻横竖寸
衰	亠竖折𧘇
柯	木横竖口
叔	上竖斜又
肩	户月
殿	尸横殳斜
番	釆田
怡	忄折斜口
旭	九日
航	舟斜横几
妮	女折横匕
坡	土皮
旅	方斜横氏
赤	土斜横八
技	扌横竖又
摘	扌斜口横
翠	习折十斜
孝	者子
移	禾斜折夕
予	又折横丨
岳	丘山
屎	尸米
融	一竖虫横
棋	木其
扶	扌夫
介	人川
渡	氵斜又横
芯	艹心
采	爪木
乳	爪折横乚
拳	半手
薇	艹斜攵斜
淫	氵斜士斜
拽	扌竖丿折
宅	宀斜横七
掌	小斜手横
培	土斜横口
莉	艹斜横刂
盼	目斜斜刀
握	扌折横至
截	土斜横戈
孤	子瓜
邵	刀竖折阝
什	亻十
宣	宀竖竖日
妍	女横竖艹
尖	小大
醋	酉横竖日
朵	几木
穆	禾斜彡横
姬	女臣
啃	口竖横月
耗	三竖斜毛
息	自心
伍	亻横竖㇕
塘	土斜口折
逢	之斜折丰
桃	木斜斜儿
壁	尸竖土斜
霍	雨隹
漆	氵横水斜
虹	虫工
丸	丸
券	半刀
俱	亻竖折八
菊	艹斜折米
奴	女又
岸	山竖十竖
凝	冫斜止折
芝	艹之
兮	八了
烈	一斜灬横
矮	矢斜横女
婆	氵折竖女
俞	人横刂斜
蝶	虫横木折
枕	木斜折儿
避	之折辛竖
帕	巾白
浮	氵斜斜子
盈	㇆斜皿折
枚	木攵
材	木横竖丿
扎	扌乚
翁	八折习折
幻	幺㇆
衫	衤彡
杆	木横竖十
固	因横竖口
耀	小横隹折
槽	木横日竖
穴	穴
幅	巾横田竖
伸	亻申
悲	非心
殷	斤折殳折
萌	艹竖折月
斑	王斜横王
澡	氵竖木竖
屈	尸折竖山
娟	女竖折月
怨	夗心
恐	工斜折心
柴	止斜折木
逆	之斜斜凵
渣	氵横一竖
熙	臣折横灬
抖	扌斜斜十
忽	勹斜斜心
津	氵折横二
胎	月折斜口
准	冫隹
摩	广竖手竖
漫	氵竖又竖
溜	氵斜田折
扇	户折斜习
婷	女斜丁斜
堡	亻竖土横
淘	氵斜山斜
墓	艹竖土横
鹿	鹿
彬	木横竖彡
蹭	足斜日横
卿	氏斜冂折
琪	王其
函	㇕竖折凵
郡	尹竖折阝
奈	大示
茂	艹戊
肌	月几
薰	艹斜灬横
映	日竖折大
鼻	自竖川横
泵	石水
育	亠折斜月
澳	氵斜大斜
候	亻竖矢折
种	禾中
邀	之斜攵斜
佩	亻斜巾横
策	⺮横竖冂
藤	艹斜水斜
仿	亻方
磊	石横斜石
雁	厂斜横隹
窄	穴斜横卜
昨	日斜横卜
倪	亻斜横儿
雯	雨文
戈	戈
爪	爪
癌	疒竖山竖
效	亠斜攵斜
拷	扌横竖了
猴	犭斜矢折
掏	扌斜山斜
汝	氵女
撮	扌竖又横
幸	土半
揉	扌折木斜
舟	舟
盯	目丁
蜜	宀斜虫斜
漂	氵横竖示
序	广折丨折
巷	廿斜斜巳
梨	禾竖竖木
舌	舌
蒂	艹斜巾斜
腹	月斜夂横
蟹	⺈斜虫斜
陷	阝斜折臼
捉	扌足
疑	匕斜止折
鼎	目折竖片
慌	忄横川斜
瘤	疒斜田折
彼	行皮
辰	辰
忌	己心
踏	足竖折日
捷	扌横止折
罐	牛竖隹竖
伏	亻横斜丶
默	四竖丶竖
赫	土斜八斜
杰	木灬
孩	子斜人折
咖	口折斜口
悟	忄横口折
帽	巾竖折目
幼	幺力
旋	方斜止折
壹	士斜䒑横
霸	雨横竖月
席	广横竖巾
叉	又丶
妃	女己
典	冂横竖八
儒	亻横竖而
裸	衤竖折木
奉	春工
御	行斜冂横
腔	月斜斜工
突	穴横斜丶
刑	一横竖刂
痕	疒艮
午	矢十
蕾	艹横竖田
宰	宀辛
囊	一竖𧘇横
弘	弓厶
境	土斜儿横
拒	扌横折㇕
毅	立横斜殳
煎	䒑斜灬横
弦	弓斜横幺
渝	氵斜刂斜
罩	四竖十竖
蓉	艹斜口斜
卵	氏斜丶横
尺	尸丶
逾	之斜刂斜
垂	千横竖二
惜	忄横竖日
浦	氵甫
警	艹斜言斜
扛	扌工
氧	气羊
揭	扌竖乚斜
逐	之豕
昭	日折斜口
宿	宀斜白横
裂	一斜𧘇斜
僧	亻斜日横
裙	衤折横口
彪	虎彡
淋	氵横竖木
束	木口
牢	宀牛
揍	扌竖大竖
仕	亻士
劫	土折斜力
拓	扌石
扮	扌斜斜刀
喻	口斜刂斜
律	行折横二
株	木斜横小
砂	石竖斜丿
埃	土折斜矢
斗	冫十
坪	土横竖䒑
仇	亻九
吞	一横斜口
亡	亡
沾	氵竖横口
牧	牛攵
霖	雨横竖木
兜	白斜儿折
寨	宀横木斜
掐	扌斜折臼
稀	禾斜巾横
恰	忄斜口横
牴	牛斜折丶
棍	木竖匕斜
朕	月斜斜大
淑	氵竖又竖
慕	艹竖忄横
歇	日斜欠折
疏	㇕竖川折
膏	亠竖月竖
陵	阝横夂斜
姆	女母
碳	石竖火横
廷	廴斜横士
糊	米横月竖
楠	木横半竖
蚊	虫文
祭	夗示
拾	扌斜口横
裴	非斜横𧘇
朋	月月
媚	女折横目
吟	口斜㇕斜
筒	⺮竖口横
丘	丘
趴	足八
繁	矢折絲斜
坦	土竖折一
穗	禾横折心
屯	七凵
虐	虎匚
蹲	足斜寸横
惟	忄隹
幕	艹竖巾横
扒	扌八
搓	扌斜斜工
遮	之斜灬横
庚	广折横人
哉	土竖折戈
涉	氵竖横小
臂	尸竖月斜
敷	甫斜横攵
佬	亻横竖匕
阮	阝竖竖儿
丙	一竖折人
署	四者
示	示
邢	一横竖阝
莎	艹斜丿横
夕	夕
趣	走横竖又
渠	氵横木折
杭	木斜横几
疾	疒矢
崇	山斜斜示
裕	衤斜口斜
挪	扌折阝横
荒	艹斜横川
筋	⺮斜折力
孕	㇆斜横子
撕	扌横竖斤
戳	习折戈斜
帆	巾凡
奎	大横竖土
阻	阝且
享	亠竖折子
棚	木斜折月
傲	亻横攵折
蹦	足竖月斜
焊	火竖十横
召	刀口
徒	行走
脂	月斜折日
几	几
艘	舟斜又横
靖	立竖竖月
奏	春横竖大
咒	口竖折几
盲	亡目
姿	冫斜折女
炫	火斜横幺
坎	土欠
拌	扌半
樊	木斜大横
缸	牛竖折工
弗	弓川
狐	犭瓜
栽	土横竖戈
硅	石横竖土
述	之横竖丶
泛	氵斜横之
甫	甫
佑	亻横斜口
卦	土横竖卜
耿	耳火
咽	口竖折大
倩	亻竖竖月
袖	衤由
糟	米横日竖
激	氵斜攵斜
珊	王竖一竖
潭	氵横十竖
蠢	春竖折虫
植	木横竖且
占	卜口
倚	亻竖口竖
姨	女横斜弓
幢	巾斜二横
焉	一竖灬折
茹	艹折斜口
桐	木竖口横
痰	疒斜斜火
捂	扌横口折
万	一力
蒲	艹斜斜甫
芽	艹牙
碑	石斜横十
嚼	口斜寸折
燃	火斜灬斜
朴	木卜
杖	木横竖乂
磷	石斜㐄斜
脆	月斜巳横
刃	刀丶
姑	女横竖口
衡	行斜大横
措	扌横竖日
眠	目折横七
途	之斜斜禾
鄂	口竖阝折
捅	扌折斜用
禾	禾
磁	石斜幺折
沃	氵斜横大
肚	月土
哀	亠竖折𧘇
浸	氵折又斜
柄	木横人竖
跪	足斜巳横
瓷	冫斜丶折
踹	足竖折而
凸	丨横一折
瑜	王斜刂斜
磅	石斜方斜
宴	宀竖折女
堪	土横竖乚
麟	鹿斜㐄斜
翟	习折斜隹
仗	亻横竖乂
崩	山斜折月
革	革
聘	耳竖折了
刊	一横竖刂
裁	土斜戈斜
郁	大斜折阝
逝	之横竖斤
狄	犭火
塌	土竖习折
崖	山竖土竖
廉	广斜八横
婉	女斜斜夗
攀	木斜手横
喘	口竖折而
氮	气斜斜火
鞍	革斜斜女
巫	工斜斜人
虞	虎竖大横
沁	氵心
瑟	王横丿斜
揪	扌斜横火
棵	木竖折木
拐	扌竖折力
披	扌皮
削	小斜折刂
悠	亻竖心斜
睿	卜斜目斜
凹	冂横一竖
葬	艹横艹斜
咦	口横斜弓
瞪	目折䒑竖
詹	⺈横言斜
侃	亻竖折川
授	扌斜又斜
卸	牛竖横冂
慈	䒑折心折
瞄	目横竖田
鞭	革斜乂横
楞	木竖折方
危	⺈横斜巳
泊	氵白
喉	口斜矢折
溶	氵斜口斜
媛	女斜又横
拎	扌斜斜之
察	宀斜折示
昆	日斜折匕
禹	丿竖厶竖
娥	女斜横戈
醇	酉斜子横
橙	木折䒑竖
辨	辛竖竖辛
暮	艹竖日横
薪	艹斜斤横
巢	巛竖折木
脾	月斜横十
愚	日竖心折
蜀	四斜折虫
裹	亠竖𧘇横
藕	艹横厶竖
劈	尸竖刀斜
堤	土竖止横
拱	扌横竖八
夸	大横竖了
傍	亻斜方斜
燥	火竖木竖
允	厶儿
杏	木口
芒	艹亡
畔	田半
豹	豸斜折丶
澄	氵折䒑竖
冥	冖竖八斜
媒	女横竖木
酥	酉禾
垮	土竖了竖
枯	木横竖口
塑	䒑折土斜
卜	卜
茅	艹折亻折
搏	扌横竖寸
沐	氵木
豫	又折豕竖
蒜	艹竖竖示
雀	小斜横隹
亨	亠竖折了
腐	广斜人斜
皓	白斜横口
央	冂大
氟	气折横川
冤	冖斜丶斜
据	扌折口横
浙	氵横竖斤
栓	木斜斜王
梳	木斜川折
冀	丬斜八横
冉	冂土
彤	冂斜横彡
奕	亠斜大斜
卑	鬼十
誓	扌斜斜言
蜂	虫斜折丰
勺	勹丶
迅	之折横十
虫	虫
匹	匚儿
曦	日斜戈折
仰	亻斜折冂
煞	⺈折灬斜
羞	羊折横十
注	氵斜横王
嫂	女斜又横
瞳	目斜二横
黛	亻竖灬竖
妾	立女
拂	扌折横川
挨	扌折斜矢
泄	氵横竖乚
夷	大弓
慎	忄横八竖
汽	氵气
恭	廿斜斜忄
弊	水竖艹斜
旦	日一
涂	氵斜斜禾
氯	气折横水
祁	礻阝
乍	矢卜
孰	亠竖丸折
耕	三竖川横
稻	禾斜斜臼
屠	尸者
笛	⺮由
捕	扌甫
蕊	艹斜心斜
氨	气斜斜女
愣	忄竖折方
悔	忄斜横母
敦	亠竖攵折
葵	艹折大横
磕	石横皿折
渴	氵竖乚斜
曝	日竖水斜
撇	扌斜攵横
梗	木横乂竖
蔚	艹折寸横
翅	十折习折
估	亻横竖口
瓣	辛斜斜辛
淮	氵隹
陀	阝斜斜匕
惑	戈竖心横
巡	之巛
墩	土斜攵折
徽	行竖攵折
蓄	艹斜田折
梓	木辛
匪	匚非
溢	氵斜皿斜
寇	宀横又竖
蓬	艹斜丰斜
硫	石斜川折
俏	亻竖斜月
迫	之白
貌	豸斜横儿
舜	爪斜㐄斜
炳	火横人竖
茄	艹折斜口
炭	山横斜火
萱	艹斜日横
挂	扌横竖土
掀	扌斜斜欠
翰	十竖习折
掩	扌横乚竖
蹬	足折䒑竖
泳	氵斜横水
玫	王攵
椅	木竖口竖
甄	西横丶折
侍	亻横竖寸
抑	扌斜折冂
敖	丰折斜攵
毫	亠竖毛斜
侵	亻折又斜
妥	爪女
概	木折儿横
援	扌斜又横
昔	廿日
晾	日斜小横
逮	之折横氵
卒	亠斜十斜
捆	扌竖折木
彷	行方
菱	艹横夂斜
梯	木斜亻折
籽	米子
腕	月斜斜夗
挫	扌斜土斜
膝	月横水斜
嗦	口横絲斜
眨	目斜横之
循	行斜目横
臀	尸横月斜
矛	又折横亻
努	女折斜力
黔	四横㇕斜
乏	丿之
魅	鬼竖竖小
凶	乂凵
掘	扌折山折
茗	艹斜折口
雌	止斜折隹
旱	日横竖十
掰	手斜手折
伽	亻折斜口
蛙	虫横竖土
雕	冂横隹竖
痣	疒横竖心
汀	氵丁
隋	阝竖月竖
芙	艹夫
刁	㇆一
瑛	王横大竖
禽	人斜厶横
腺	月斜横水
迦	之折斜口
欺	其欠
杉	木彡
党	小斜儿横
玖	王斜折丶
肆	長折横二
悉	釆心
掂	扌斜口横
菁	艹竖竖月
冶	冫折斜口
遣	之竖㠯横
岑	山斜㇕斜
皖	白斜儿横
糕	米斜斜灬
斐	非文
址	土止
蘸	艹横灬斜
茵	艹竖折大
簿	⺮斜寸横
旬	勹日
丈	一乂
咸	戊横竖口
呸	口横斜一
胤	儿折折月
桓	木竖竖日
碘	石竖八横
瞅	目斜横火
廊	广斜阝折
焰	火斜折臼
淳	氵斜子横
畏	田展
屑	尸竖斜月
覃	西竖折十
嵌	山横竖欠
泣	氵立
袍	衤斜折巳
僵	亻横田竖
沫	氵横竖木
臻	至竖竖禾
眺	目斜斜儿
寂	宀竖又竖
晏	日斜斜女
秤	禾横竖䒑
藻	艹斜木横
螺	虫竖折絲
恤	忄斜横皿
污	氵横竖了
涯	氵竖土竖
滋	氵斜幺折
嗜	口横日斜
陡	阝走
栗	西木
朔	䒑折竖月
淇	氵其
捻	扌斜心折
勃	十斜力折
矩	矢横折㇕
沽	氵横竖口
淤	氵斜冫斜
描	扌横竖田
契	丰折斜大
祠	礻折口横
峻	山折夂斜
稠	禾竖口横
爵	爪竖寸折
秉	禾彐
刨	勹折横刂
雍	亠折折隹
群	尹竖折羊
役	行殳
烙	火斜折口
灾	宀火
强	弓竖折虫
痘	疒横䒑竖
髓	骨斜月横
嫣	女横灬折
募	艹竖力横
苟	艹斜折口
析	木斤
魁	鬼斜斜十
斥	斤丶
棕	木斜斜示
匡	匚王
倦	亻斜斜巳
疆	弓横田竖
蔓	艹竖又竖
牟	厶牛
霆	雨折士斜
靴	革斜横匕
眸	目折斜牛
烟	火竖折大
巾	巾
殊	一斜小斜
叮	口丁
艇	舟折士斜
熔	火斜口斜
裘	寸斜𧘇斜
芹	艹斤
寡	宀横刀斜
迥	之竖折口
瞬	目斜㐄斜
邑	口巴
榕	木斜口斜
庸	广折横月
棠	小斜木横
祺	礻其
埠	土斜十横
茬	艹横土竖
嗅	口斜丶横
佰	亻横竖白
滇	氵横八竖
寅	宀横八竖
梵	木横竖凡
蛾	虫斜横戈
慰	尸竖心竖
履	尸斜夂横
宛	宀夗
嫖	女横竖示
涮	氵折刂竖
督	上竖目折
衍	行氵
廿	廿
劣	小斜横力
祈	礻斤
魄	白鬼
斧	八斜斜斤
裔	亠斜口斜
湛	氵横竖乚
淌	氵竖口竖
簇	⺮斜矢斜
沛	氵横竖巾
掠	扌斜小横
崎	山竖口竖
菇	艹折口横
砌	石横折刀
眯	目米
辱	辰寸
匠	匚斤
肘	月寸
淹	氵横乚竖
洽	氵斜口横
究	穴九
矢	矢
澈	氵斜攵斜
瞥	水竖目斜
椰	木横竖阝
梢	木竖斜月
嘟	口横竖阝
障	阝斜十横
霄	雨竖斜月
揣	扌竖折而
槐	木鬼
粟	西米
唆	口折夂斜
札	木乚
拴	扌斜斜王
吏	大竖折丶
堰	土横女竖
棺	木斜斜㠯
腥	月竖折生
胞	月斜折巳
韶	立竖口折
阜	丿竖折十
剖	立竖折刂
羹	羊斜大斜
剃	丷折刂斜
寓	宀竖厶竖
峪	山斜口斜
煜	火竖折立
撩	扌横小竖
扳	扌斜斜又
桔	木横竖口
臧	爿横折臣
喀	口斜口斜
妄	亡女
陌	阝横竖白
弧	弓瓜
弩	女折斜弓
撰	扌折八横
瞿	目竖折隹
卞	亠卜
蛤	虫斜口横
襄	亠竖𧘇横
擒	扌斜厶横
哨	口竖斜月
皂	白七
汞	工水
芭	艹巴
懿	士斜心斜
椒	木竖又竖
戎	戈大
肋	月力
翎	人斜习折
煌	火斜横王
疤	疒巴
瀚	氵横习折
泓	氵折横厶
昧	日竖竖小
柒	氵横折木
旨	匕日
巳	巳
辜	十竖折辛
筐	⺮横折王
膊	月横竖寸
遵	之斜寸横
剁	几横竖刂
愧	忄鬼
拙	扌折竖山
竿	⺮横竖十
圭	土土
甸	勹田
衷	亠竖折𧘇
脊	氵斜斜月
憨	㇕横心斜
搽	扌横木斜
捶	扌斜二横
毓	矢折川折
苔	艹折斜口
奸	女横竖十
黏	禾斜口横
甭	不用
瞟	目横竖示
舅	臼竖折力
阪	阝斜斜又
恕	女竖折心
啼	口斜巾斜
睹	目者
疲	疒皮
褪	衤斜折艮
鞠	革斜折米
釉	釆由
彰	立竖彡横
酬	酉斜斜川
橘	木折口斜
啪	口横竖白
睛	目竖竖月
遁	之斜目横
哆	口斜折夕
窟	穴折山折
垢	土斜口横
愿	厂斜心横
奚	爪折折大
褚	衤者
腮	月竖折心
枉	木王
涓	氵竖折月
嗟	口斜斜工
笙	⺮生
沸	氵折横川
妓	女横竖又
猿	犭横𧘇竖
漠	氵横大竖
撬	扌斜毛斜
巍	山斜鬼折
漾	氵斜水斜
擎	艹斜手斜
靶	革巴
俐	亻斜横刂
胚	月横斜一
楷	木斜白斜
迭	之斜横人
嗣	口竖口横
嵩	山斜口横
蹄	足斜巾斜
褐	衤竖乚斜
丞	㇕竖折一
梭	木折夂斜
唷	口斜月折
畜	亠折折田
粽	米斜斜示
宵	宀竖斜月
榆	木斜刂斜
嚷	口斜𧘇横
絮	女竖折絲
戊	戊
罕	冖斜十横
叩	口冂
俯	亻斜寸斜
瀑	氵竖水斜
肇	户斜二折
毋	母大
暇	日折又折
岐	山横竖又
睬	目斜斜木
郊	亠斜阝斜
璧	尸竖丶横
捎	扌竖斜月
糸	絲
嘀	口斜口横
犁	禾竖竖牛
怔	忄横竖止
焚	木横竖火
癖	疒折辛竖
灼	火斜折丶
孽	艹斜子斜
岱	亻横折山
麓	木横竖鹿
匙	日横匕竖
嚎	口斜豕斜
爻	乂乂
摧	扌竖折隹
械	木横折艹
乞	矢乙
卯	氏斜横冂
凋	冫竖口横
蕙	艹横折心
噗	口竖竖羊
筠	⺮横冫斜
喧	口斜日横
瓢	西竖竖瓜
裳	小斜𧘇斜
晤	日横口折
竭	立竖乚斜
妨	女方
玻	王皮
宸	宀辰
擅	扌斜一横
烹	亠竖灬折
卉	十艹
括	扌舌
檐	木斜言斜
戟	十竖戈横
尸	尸
椎	木隹
恬	忄舌
胥	㇕竖横月
檀	木斜一横
坯	土横斜一
葡	艹斜折甫
仄	厂人
伙	亻火
垣	土竖竖日
拘	扌斜折口
呱	口瓜
躁	足竖木竖
噬	口斜人斜
孚	爪子
蓓	艹斜口斜
蛆	虫且
囚	因人
鞘	革竖斜月
匣	匚甲
凳	癶横几斜
隙	阝竖小竖
娣	女斜亻折
莞	艹斜儿横
伶	亻斜斜之
拭	扌横折工
墅	甲横土竖
懵	忄横目斜
碾	石折展横
禧	礻横口斜
榨	木斜卜斜
黯	四横日斜
荼	艹斜斜禾
苞	艹斜折巳
戚	戊竖横小
倘	亻竖口竖
怯	忄横竖厶
礁	石斜横灬
瞻	目斜言斜
躬	身弓
脖	月横子斜
襟	衤竖示竖
尉	尸竖竖寸
亥	亠折折人
肢	月横竖又
悄	忄竖斜月
厘	厂竖折二
憎	忄斜日横
砷	石申
糙	米斜口斜
炯	火竖折口
莘	艹辛
盔	大斜斜皿
睦	目横土斜
仟	亻千
炕	火斜横几
荔	艹折力折
嗷	口横攵折
藩	艹斜田斜
奢	大者
尬	尤斜斜川
趾	足止
瘀	疒斜冫斜
悼	忄竖十竖
抿	扌折横七
憾	忄横心竖
孓	了丶
兀	一儿
稚	禾隹
褒	亠斜𧘇横
痔	疒横竖寸
烘	火横竖八
渭	氵竖折月
嘻	口横口斜
麒	鹿其
熄	火斜横心
艮	艮
薯	艹竖折者
蕉	艹斜横灬
荀	艹斜折日
逍	之竖斜月
泪	氵目
拗	扌折折力
毯	毛斜斜火
邸	氏斜横阝
炙	夕火
倭	亻斜横女
莽	艹横艹斜
笠	⺮立
勉	⺈竖力斜
亢	亠几
羌	羊儿
璋	王斜十横
咚	口斜折冫
恪	忄斜折口
涌	氵折斜用
妒	女户
暑	日者
疫	疒殳
歉	䒑折欠斜
汐	氵夕
樟	木斜十横
豁	宀横口斜
窖	穴斜横口
脉	月斜横水
启	户口
扭	扌折横十
胰	月横斜弓
泗	氵四
帘	穴巾
隅	阝竖厶竖
岔	八折斜山
弛	弓也
秘	禾斜折丿
渚	氵者
撼	扌横心竖
痞	疒横斜口
瘟	疒竖折皿
樽	木斜寸横
歧	止横竖又
椿	木春
确	石斜折用
咀	口且
价	亻斜斜川
寮	宀横小竖
蒿	艹斜口横
悍	忄竖十横
硼	石斜折月
啤	口斜横十
壬	丿士
叛	半斜斜又
浚	氵折夂斜
捌	扌竖刂折
勘	其折横力
剌	木竖折刂
樵	木斜横灬
啄	口豕
倡	亻竖折日
肛	月工
糜	广竖米竖
漪	氵斜口横
瑕	王折又折
蔽	艹竖攵竖
糯	米横竖而
茫	艹斜斜亡
噎	口横䒑竖
凰	几斜横王
溺	氵折冫折
霓	雨斜横儿
硝	石竖斜月
囤	因横折凵
吭	口斜横几
靡	广竖非竖
厥	厂斜欠折
跺	足斜折木
萃	艹斜十斜
埔	土甫
扼	扌横斜巳
吱	口横竖又
竺	⺮二
霏	雨非
蛟	虫斜乂斜
圃	因甫
瘸	疒折人斜
琢	王豕
酉	酉
棘	木竖冂横
蚌	虫丰
吋	口寸
恍	忄竖斜尤
糠	米斜氵折
渺	氵竖丿竖
瀛	氵斜凡折
祀	礻巳
琅	王斜横艮
苛	艹横竖口
苓	艹斜斜之
丕	不一
唬	口虎
夭	丿大
腌	月横乚竖
橡	木斜豕横
眩	目斜横幺
弈	亠斜艹斜
拈	扌竖横口
茸	艹耳
倔	亻折山折
貂	豸折斜口
丰	丰
耙	三竖斜巴
跋	足横丶折
踱	足斜又横
叭	口八
恢	忄横斜火
彝	彑斜艹折
旌	方斜横生
孜	子攵
舵	舟斜斜匕
寐	宀折小横
璃	王斜厶横
荻	艹斜折火
懈	忄斜牛折
漕	氵横日竖
磐	舟斜折石
宦	宀臣
漱	氵横欠竖
庶	广横竖灬
釜	八斜丷横
挎	扌竖了竖
茉	艹横竖木
匾	匚斜艹横
筑	⺮横竖凡
膳	月斜口斜
濡	氵横竖而
痹	疒竖川横
恃	忄横竖寸
淞	氵横厶斜
舀	爪臼
搔	扌折虫斜
梧	木横口折
匝	匚巾
屹	山斜横乙
灸	⺈斜横火
熹	士竖灬斜
焙	火斜横口
蹈	足斜斜臼
牡	牛土
秧	禾竖折大
狸	犭竖折二
沼	氵折斜口
夯	大力
毗	田斜折匕
炬	火横折㇕
逞	之竖折王
簧	⺮横八竖
窘	穴折横口
赦	土斜攵斜
柚	木由
溯	氵斜月折
宙	宀由
斟	其折十斜
柑	木甘
匿	匚竖口竖
剔	日斜刂斜
眷	半目
癸	癶横竖大
嘲	口竖月竖
噤	口竖示竖
噩	王竖口竖
蟒	虫横艹斜
燮	言斜又斜
汲	氵折横人
筷	⺮斜大折
侄	亻至
滔	氵斜斜臼
姣	女斜乂斜
丐	一竖横乚
戌	戊一
敝	水竖折攵
疹	疒斜斜彡
炊	火欠
涕	氵斜亻折
摹	艹竖手横
杵	木斜横十
棣	木折横氵
羚	羊斜斜之
渤	氵横力折
墟	土竖横业
柿	木斜横巾
蹙	戊竖足竖
噪	口竖木竖
氖	气折横丿
帛	白巾
膨	月横彡斜
甬	又用
琉	王斜川折
抒	扌折丨折
酌	酉斜折丶
榭	木斜横寸
沅	氵竖竖儿
濠	氵斜豕斜
嬉	女横口斜
殖	一斜且横
珀	王白
眶	目横折王
稼	禾斜斜豕
咎	夂竖横口
莓	艹斜横母
嘈	口横日竖
馥	禾竖夂竖
粹	米斜十斜
祗	礻斜折丶
褂	衤竖卜竖
娼	女竖折日
叟	臼竖横又
廓	广斜阝折
弼	弓横弓斜
翡	非折斜习
曳	日折横丿
偕	亻斜白斜
羲	羊斜戈折
汾	氵斜斜刀
蛹	虫折斜用
啖	口斜斜火
豚	月豕
熨	尸竖火竖
犀	尸竖折牛
冕	日斜儿横
褶	衤折白折
垛	土斜折木
髻	長斜口横
擂	扌横竖田
檬	木竖豕竖
咕	口横竖口
嘶	口横竖斤
昀	日斜折冫
疝	疒山
孑	了一
槌	木斜㠯斜
吮	口折斜儿
厂	厂
芋	艹横竖寸
萎	艹斜横女
榻	木竖习折
嗡	口斜习折
妤	女折丨折
吠	口横斜丶
篷	⺮斜丰斜
聆	耳斜斜之
嗑	口横皿折
漳	氵斜十横
沱	氵斜斜匕
卅	一川
碌	石折横水
怠	厶竖折心
杠	木工
砰	石横竖䒑
曙	日竖折者
稽	禾横日斜
簪	⺮横日斜
偎	亻竖折展
恙	羊心
敞	小竖攵竖
徙	行竖横止
嬴	亡竖凡折
祚	礻斜横卜
巽	巳折八横
拇	扌母
兢	十竖儿竖
汕	氵山
磺	石横八竖
啜	口折又折
壑	卜斜土折
峨	山斜横戈
濂	氵斜八横
姊	女斜亻折
愉	忄斜刂斜
溥	氵横竖寸
罔	冂斜斜亡
衙	行横口折
厝	厂横竖日
鄙	口横阝竖
桀	夕横折木
澎	氵横彡斜
宥	宀横斜月
聿	彐二
骸	骨斜人折
煽	火斜习折
狙	犭且
惶	忄斜横王
酣	酉甘
杳	木日
煦	日斜灬横
庇	广斜折匕
芥	艹斜斜川
戍	戊丶
蝗	虫斜横王
床	广木
陋	阝横乚斜
戮	习折戈斜
壤	土斜𧘇横
揖	扌竖折耳
愕	忄竖了横
呷	口甲
唧	口折横冂
烽	火斜折丰
慨	忄折儿横
乒	丘丿
朦	月竖豕竖
粱	氵折米斜
峙	山横竖寸
征	行横竖止
畦	田横竖土
庾	广斜横人
掖	扌斜丶斜
柬	木四
逵	之横土斜
秩	禾斜横人
蕃	艹斜斜田
朽	木了
杞	木己
蛛	虫斜横小
啡	口非
晦	日斜横母
扉	户非
嫉	女斜横矢
广	广
垠	土艮
嗤	口折虫横
幌	巾竖尤竖
篆	⺮折折豕
臼	臼
怖	忄横斜巾
灶	火土
宁	宀丁
扈	户竖折巴
嫡	女斜口横
磬	士折石斜
哺	口甫
踝	足竖折木
叱	口匕
婢	女斜横十
婿	女折月竖
挽	扌斜儿横
歹	一夕
矗	十竖且横
叨	口刀
晰	日横竖斤
鼬	臼折折由
揩	扌斜白斜
偃	亻横女竖
氐	氏丶
酪	酉斜折口
幔	巾竖又竖
渥	氵折横至
瑰	王鬼
蔗	艹斜灬横
嗓	口折木折
膛	月竖土竖
汛	氵折横十
剿	巛竖刂横
掣	牛竖手竖
娑	氵竖女斜
蔬	艹折川折
俑	亻折斜用
腋	月斜丶斜
吆	口幺
舫	舟方
羿	习折斜艹
璜	王横八竖
拄	扌斜横王
吝	文口
穹	穴弓
岫	山由
筵	⺮折止斜
矜	又折㇕斜
掬	扌斜折米
皿	皿
纂	⺮竖絲横
徊	行竖折口
嗽	口横欠竖
悖	忄横子斜
耘	三竖厶横
蜃	辰虫
榴	木斜田折
伺	亻折口横
胜	月生
榛	木竖竖禾
筏	⺮斜横戈
淅	氵横竖斤
澹	氵斜言斜
辟	尸竖折辛
姥	女横竖匕
坷	土横竖口
仆	亻卜
脯	月甫
痢	疒斜横刂
汰	氵横斜丶
濯	氵折隹折
萼	艹竖了横
楔	木横大折
圳	土川
峭	山竖斜月
猥	犭竖折展
惺	忄竖折生
僚	亻横小竖
忿	八折斜心
孵	氏斜子斜
紊	文絲
罄	士折山斜
髯	長斜土横
捺	扌横斜示
帷	巾隹
雉	矢隹
膈	月横丁斜
寞	宀横大竖
畸	田竖口竖
箕	⺮其
匆	勹斜斜丶
壕	土斜豕斜
涎	氵折止斜
渲	氵斜日横
耽	其斜折儿
菅	艹斜斜㠯
猩	犭竖折生
疵	疒竖横匕
遐	之折又折
袂	衤折横大
霾	雨斜二横
虔	虎文
舶	舟白
燎	火横小竖
殃	一斜大横
遏	之竖乚斜
舛	夕㐄
匕	匕
隘	阝斜皿斜
衢	行竖隹竖
泌	氵斜折丿
岷	山折横七
俘	亻斜斜子
狩	犭斜斜寸
蠡	彑横虫竖
殆	一斜口折
鬃	長斜示斜
晌	日斜横口
睫	目横止折
琍	王斜横刂
捍	扌竖十横
蝠	虫横田竖
靛	丰斜止横
氦	气斜人折
佯	亻羊
膀	月斜方斜
姻	女竖折大
耆	者斜折日
拚	扌折斜艹
夙	几横竖夕
腑	月斜寸斜
噙	口斜厶横
潼	氵斜二横
窒	穴至
翌	习折斜立
夔	䒑斜夂斜
熏	千竖灬横
刈	乂刂
舷	舟斜横幺
氓	亡折横七
豢	半豕
忱	忄斜折儿
雇	户隹
媳	女斜横心
蠹	一竖虫竖
荐	艹横子竖
庖	广斜折巳
埂	土横乂竖
琥	王虎
俟	亻折斜矢
缶	牛山
忝	一横斜忄
喱	口横二竖
怵	忄横竖丶
湍	氵竖折而
僻	亻折辛竖
瓤	亠竖瓜斜
羯	羊竖乚斜
拯	扌折一竖
俸	亻竖竖工
翱	白横习折
奠	丷横竖大
肱	月横斜厶
邕	巛竖折巴
茱	艹斜横小
楹	木折皿折
玟	王文
矽	石夕
蛭	虫至
骰	骨殳
飧	夕食
翩	户竖习折
祟	凵竖折示
殉	一斜日斜
苒	艹竖折土
箔	⺮斜斜白
跤	足斜乂斜
牲	牛生
牒	片横木折
漩	氵斜止折
玳	王斜横弋
涸	氵竖口横
攘	扌斜𧘇横
剜	宀斜折刂
苣	艹横折㇕
芍	艹斜折丶
菩	艹斜横口
哂	口西
佣	亻用
仞	亻折斜丶
冽	冫横刂斜
喳	口横一竖
戾	户横斜丶
亟	了竖一折
蘑	艹斜石横
跛	足皮
憬	忄竖小竖
愀	忄斜横火
湮	氵横竖土
盹	目横折凵
寤	宀折口折
盎	冂横斜皿
哮	口横竖子
乓	丘丶
狡	犭斜乂斜
蹶	足横欠折
蹋	足竖习折
篡	⺮竖厶横
俚	亻竖折二
恣	冫斜折心
胄	由月
笆	⺮巴
竣	立折夂斜
悸	忄斜横子
韭	非一
睨	目斜横儿
倌	亻斜斜㠯
肪	月方
孺	子横竖而
秸	禾横竖口
皎	白斜乂斜
蜇	扌斜斜虫
莒	艹竖折口
橇	木斜毛斜
翳	匚斜习折
崛	山折山折
篁	⺮斜横王
偌	亻竖口竖
庵	广横乚竖
隧	阝斜豕斜
蜈	虫竖大横
澧	氵竖䒑竖
姒	女折斜人
枋	木方
惰	忄竖月竖
蚤	又斜横虫
婊	女竖竖𧘇
斡	十竖十斜
栩	木折斜习
僖	亻横口斜
倏	亻竖丶横
苹	艹横竖䒑
蕨	艹横欠折
茴	艹竖折口
藐	艹斜儿斜
酵	酉横竖子
蛔	虫竖折口
匈	勹斜斜凵
叵	匚口
唾	口斜二横
惚	忄斜心斜
瑙	王折乂斜
棹	木竖十竖
蜥	虫横竖斤
蛀	虫斜横王
螟	虫斜八斜
黍	禾斜斜水
貉	豸斜折口
妊	女斜横士
斫	石斤
咻	口斜横木
箴	⺮竖口竖
适	之舌
淙	氵斜斜示
嫦	女竖巾竖
弁	厶艹
慷	忄斜氵折
寥	宀折彡斜
蔑	艹竖丶横
砥	石斜折丶
迄	之斜横乙
臊	月竖木竖
咫	尸斜八横
搪	扌斜口折
噫	口斜心横
瞰	目折攵横
僮	亻斜二横
佗	亻斜斜匕
塾	亠竖土斜
旎	方斜匕折
壅	亠折土斜
懦	忄横竖而
爰	爪竖又竖
羔	羊灬
盂	一横竖皿
髦	長斜斜毛
萸	艹斜横人
卮	斤横竖巳
娓	女折横毛
榫	木斜横十
蹊	足斜大折
肴	乂横斜月
痿	疒斜横女
湃	氵斜丰横
祉	礻止
睪	四横竖半
啻	亠斜口横
旖	方斜口横
姘	女斜斜艹
稔	禾斜心折
疚	疒斜折丶
窿	穴折生横
啾	口斜横火
腱	月折二折
瘁	疒斜十斜
漓	氵斜厶横
迂	之横竖寸
菰	艹折横瓜
洌	氵横刂斜
袒	衤竖折一
唳	口斜丶横
篙	⺮斜口横
氛	气斜斜刀
垃	土立
佃	亻田
腊	月横竖日
膺	广斜月斜
洱	氵耳
琶	王竖竖巴
稷	禾竖夂斜
沮	氵且
鞅	革竖折大
酋	丷酉
并	䒑艹
踵	足斜二横
罹	四斜斜隹
懊	忄斜大斜
遽	之竖横豕
陛	阝斜土斜
萄	艹斜山斜
薜	艹折辛竖
崆	山斜斜工
舂	春臼
达	之大
唇	辰口
豕	豕
呎	口折横丶
况	冫竖折儿
冗	冖几
瘴	疒斜十横
酊	酉丁
笞	⺮折斜口
侮	亻斜横母
胱	月竖斜尤
肓	亡月
悴	忄斜十斜
梆	木竖竖阝
乩	卜竖折乚
呶	口折斜又
疽	疒且
淄	氵折折田
逅	之斜口横
菽	艹竖又竖
蟆	虫横大竖
鼾	自竖十横
猷	丷竖丶竖
葩	艹斜横巴
舐	舌氏
倨	亻折口横
溉	氵折儿横
赭	土斜者斜
桅	木斜巳横
嘹	口横小竖
庠	广羊
砧	石竖横口
蟀	虫斜艹斜
惕	忄竖彡斜
惘	忄竖亡斜
惦	忄斜口横
潦	氵横小竖
窠	穴竖折木
裨	衤斜横十
蜓	虫折士斜
蚩	凵横竖虫
耒	三小
榷	木斜折隹
奄	大竖折乚
窈	穴折折力
豉	一竖又横
劾	亠折力斜
憧	忄斜二横
荏	艹斜士斜
榔	木斜阝折
燧	火斜豕斜
遑	之斜横王
嗥	口斜十横
砭	石斜横之
蟑	虫斜十横
蚓	虫折横丨
憩	舌斜横心
葫	艹横月竖
鞣	革折木斜
牯	牛横竖口
麝	鹿斜横寸
沌	氵横折凵
婀	女折口横
瑁	王竖折目
喋	口横木折
悚	忄横竖口
骷	骨横竖口
爨	臼竖火横
羸	亡竖凡斜
攫	扌竖又斜
秣	禾横竖木
僭	亻横日斜
汨	氵日
譬	尸竖言斜
摒	扌折艹斜
瞑	目斜八斜
阡	阝千
璩	王竖横豕
豺	豸横竖丿
獐	犭斜十横
芟	艹殳
柜	木横折㇕
俎	人斜斜且
肫	月横折凵
彗	丰竖竖彐
泱	氵竖折大
帚	彐斜折巾
茁	艹折竖山
檄	木斜攵斜
竽	⺮横竖寸
咨	冫斜折口
淀	氵斜止横
逖	之斜折火
靼	革竖折一
吩	口斜斜刀
佞	亻竖竖女
戛	一斜横戈
蚪	虫斜斜十
倥	亻斜斜工
猓	犭竖折木
褥	衤横斜寸
孀	女竖目竖
菠	艹斜斜皮
跚	足竖一竖
牖	片斜折甫
徨	行斜横王
阱	阝竖竖川
皴	厶斜皮斜
黜	四横山折
磋	石斜斜工
徘	行非
烊	火羊
鄹	耳折阝横
蓑	艹斜𧘇横
蜒	虫折止斜
蜡	虫横竖日
蚝	虫毛
滓	氵斜斜辛
娌	女竖折二
恫	忄竖口横
憔	忄斜横灬
雹	雨斜折巳
橄	艹折攵横
揆	扌折大横
婪	木横竖女
碉	石竖口横
奘	爿横竖大
痱	疒非
疙	疒斜横乙
湔	氵斜刂斜
潺	氵折子折
劬	勹竖折力
恿	又斜折心
坍	土竖折亠
蚶	虫甘
曷	日斜乚斜
侈	亻斜折夕
忖	忄寸
惆	忄竖口横
蚵	虫横竖口
蛄	虫横竖口
俳	亻非
屐	尸斜又横
瞽	士竖目折
氤	气竖折大
臆	月斜心横
徇	行斜折日
腆	月竖八横
遨	之横攵折
匏	大横巳斜
蝴	虫横月竖
峰	山斜折丰
胛	月甲
疳	疒甘
惴	忄竖折而
窕	穴斜斜儿
鼙	士竖十斜
蕈	艹横十竖
楫	木竖折耳
呻	日申
咄	口折竖山
骼	骨斜折口
狎	犭甲
麾	广竖毛竖
瑚	王横月竖
蜘	虫斜横口
唁	口言
瓮	八折丶折
粳	米横乂竖
歙	人横欠折
媲	女斜匕斜
盍	土折斜皿
棱	木横夂斜
傀	亻鬼
胭	月竖折大
悻	忄横竖半
圯	土巳
琵	王横匕斜
拮	扌横竖口
悌	忄斜亻折
妣	女斜折匕
赳	走凵
圾	土折横人
柞	木斜横卜
跆	足折斜口
牝	牛匕
滂	氵斜方斜
嫘	女竖折絲
皈	白斜斜又
槁	木斜口横
獗	犭横欠折
抉	扌折横大
柩	木横丶斜
螳	虫竖土竖
咆	口斜折巳
翕	人横习折
夤	夕斜八横
冢	冖豕
醺	酉斜灬横
喟	口竖折月
咐	口斜横寸
甥	生竖折力
篾	⺮竖丶横
裟	氵竖𧘇斜
弭	弓耳
媾	女横土竖
霹	雨折辛竖
蚣	虫斜斜厶
跎	足斜斜匕
嶝	山折䒑竖
蚱	虫斜横卜
罟	四横竖口
磴	石折䒑竖
臃	月斜隹折
愎	忄斜夂横
苜	艹目
霎	雨斜横女
蜿	虫斜斜夗
簸	⺮横竖皮
惋	忄斜斜夗
泅	氵竖折人
兕	冂横尤竖
鄱	釆竖折阝
墀	土折牛竖
挈	丰折斜手
仃	亻丁
狷	犭竖折月
麋	鹿米
瓠	大横瓜折
蚯	虫丘
蠕	虫横竖而
蹼	足竖竖羊
鬲	一竖丁斜
螫	土斜虫斜
酩	酉斜折口
戢	口横竖戈
刎	勹斜斜刂
擘	尸竖手斜
剽	西竖竖刂
枇	木斜折匕
砝	石横竖厶
枸	木斜折口
瘩	疒竖口竖
疥	疒斜斜川
迢	之折斜口
畚	厶横斜田
梃	木折士斜
坼	土斜斜丶
莠	艹斜丿折
螂	虫斜阝折
暹	之竖折隹
佾	亻斜斜月
胳	月斜折口
瘠	疒斜月斜
杷	木巴
黠	四竖口竖
麂	鹿几
毽	毛折二折
猖	犭竖折日
孱	尸折子折
瞠	目竖土竖
侏	亻斜横小
坩	土甘
蓿	艹斜白横
戡	其折横戈
蜻	虫竖竖月
猾	犭骨
冲	冫中
戕	爿戈
痊	疒斜斜王
迹	之斜八斜
疋	㇕止
隍	阝斜横王
噱	口竖横豕
黝	四横力折
蹉	足斜斜工
漯	氵竖折絲
糢	米横大竖
萋	艹横女折
邂	之斜牛折
岌	山折横人
舨	舟斜斜又
赧	土斜又横
幛	巾斜十横
儿	儿
玷	王竖横口
栖	木西
嚅	口横竖而
箝	⺮横竖甘
凭	亻斜几横
佝	亻斜折口
韵	立竖冫斜
踊	足折斜用
髭	長斜匕横
匐	勹横田竖
陲	阝斜二横
嚏	口横止折
佻	亻斜斜儿
盥	臼竖折皿
仳	亻斜折匕
袈	力竖𧘇斜
耜	三竖斜㠯
叶	口十
胴	月竖口横
蹂	足折木斜
袱	衤斜丶横
遴	之斜㐄斜
嗾	口斜矢斜
妁	女斜折丶
捩	扌斜丶横
豌	一竖夗斜
帑	女折斜巾
瞌	目横皿折
抨	扌横竖䒑
蝌	虫斜十斜
臾	臼人
淆	氵斜月横
酗	酉斜斜凵
伉	亻斜横几
貊	豸横竖白
睽	目折大横
匍	勹甫
吁	口横竖寸
犒	牛斜口横
娩	女斜儿横
睥	目斜横十
臬	自木
祆	礻横竖大
螃	虫斜方斜
蟋	虫斜斜心
陴	阝斜横十
埤	土斜横十
琊	王横折阝
躇	足横竖者
儡	亻竖田竖
圬	土横竖了
亏	一了
潸	氵竖月竖
霪	雨斜士斜
遘	之横土竖
慝	匚横心竖
划	戈刂
躅	足竖虫斜
肄	匕斜二折
娠	女辰
蜴	虫竖彡斜
蝙	虫斜艹横
褫	衤斜斜虎
籐	⺮斜水斜
怏	忄竖折大
蜢	虫折横皿
褓	衤斜木横
鏖	鹿金
崁	山横竖欠
孳	䒑折子折
妯	女由
燐	火斜㐄斜
膻	月斜一横
簷	⺮斜言斜
啕	口斜山斜
舢	舟山
溘	氵横皿折
甽	田川
莅	艹斜横立
坏	土不
够	勹竖夕斜
圣	又土
撚	扌斜灬斜
踟	足斜横口
荸	艹横子斜
谿	爪折口斜
塭	土竖折皿
跼	足折口折
犄	牛竖口竖
勗	日竖折力
牦	牛毛
篛	⺮折冫折
聱	丰折耳斜
弃	亠折斜艹
极	木折横人
迆	之也
葱	艹斜心斜
猫	犭横竖田
猪	犭者
册	冂竖折一
机	木几
隶	彐氵
垒	厶折土折
号	口了
扑	扌卜
赶	走横竖十
瞇	目斜折米
祐	礻横斜口
窑	穴斜横山
听	口斤
柠	木斜斜丁
猬	犭竖折月
猎	犭横竖日
凄	冫横女折
疱	疒斜折巳
椁	木斜子横
迺	之西
痺	疒斜横十
晋	一竖竖日
亘	二日
姪	女至
踫	足斜斜业
痴	疒斜横口
珮	王斜巾横
叙	人斜横又
离	亠斜厶横
痲	疒竖儿竖
虱	乙斜横虫
滚	氵斜𧘇折
屉	尸横竖乚
倣	亻斜横攵
无	一尤
与	一折横一
样	木羊
国	因竖竖丶
吨	口横折凵
户	户
巩	工凡
却	土折斜冂
担	扌竖折一
撑	扌竖手竖
携	扌斜丿折
抬	扌折斜口
栀	扌斜巳横
构	木斜折厶
医	匚矢
蝎	虫竖乚斜
咏	口斜横水
踪	足斜斜示
叹	口又
网	冂斜斜乂
冈	冂乂
岭	山斜斜之
复	矢竖折夂
笋	⺮尹
偬	亻斜心斜
众	人斜斜人
脚	月横冂折
胆	月竖折一
庄	广土
凉	冫斜小横
决	冫折横大
恒	忄竖竖日
潜	氵竖日竖
汹	氵斜斜凵
袜	衤横竖木
宫	宀竖折口
异	巳艹
栅	木竖一竖
吕	口口
咤	口斜七斜
秆	禾横竖十
鼹	臼折女斜
隽	隹折横丿
删	冂竖刂横
胶	月斜乂斜
泞	氵斜斜丁
姗	女竖一竖
扰	扌尤
芜	艹横竖尤
芦	艹户
碱	石竖口竖
奋	大田
邮	由阝
毁	臼横竖殳
体	亻横竖一
优	亻尤
犹	犭尤
肮	月斜横几
凑	冫竖大竖
痒	疒羊
烛	火虫
怜	忄斜斜之
惊	忄斜小横
羡	羊斜斜欠
洁	氵横竖口
垦	艮土
篱	⺮斜厶横
灯	火丁
橱	木横寸斜
减	冫竖口竖
耻	耳止
忾	忄气
厨	厂横寸斜
凛	冫斜示横
厦	厂横夂斜
厮	厂横竖斤
亲	立木
届	尸由
瑯	王斜阝折
瘉	疒斜刂斜
珐	王横竖厶
徬	行斜方斜
厢	厂横竖目
忧	忄尤
伕	亻夫
禀	亠竖示竖
鼇	丰折黽斜
餽	食鬼
叠	又折且斜
开	一艹
录	彐水
献	十竖丶横
园	因竖竖儿
杀	乂木
寻	彐寸
邓	又阝
吓	口横竖卜
触	⺈斜折虫
櫂	木折隹折
搾	扌斜卜斜
权	木又
杂	九木
丽	一竖丶竖
币	丿巾
仅	亻又
沟	氵斜折厶
灵	彐火
偺	亻斜日横
茧	艹虫
怀	忄不
濬	氵竖目斜
积	禾竖折八
敌	舌攵
浬	氵竖折二
块	土折横大
备	夂田
关	䒑大
忏	忄千
队	阝人
蘗	艹折木斜
啣	口斜冂横
貍	豸竖折二
宪	宀斜横儿
勦	巛竖力横
现	王見
个	人丨
说	言斜儿横
为	丷折横丶
没	氵殳
这	之文
对	又寸
发	乚斜丶折
两	一竖人斜
项	工頁
专	二折横丶
来	二水
动	二折斜力
长	長
联	耳斜斜大
帮	丰折竖巾
热	扌斜折灬
拨	扌折丶折
带	艹斜折巾
节	艹冂
标	木示
横	木横八竖
龙	龍
页	頁
顾	厂折横頁
车	車
区	匚乂
暂	車斜斜日
轨	車九
软	車欠
点	卜竖折灬
旧	丨日
齿	齒
别	口折斜刂
员	口貝
吗	口馬
时	日寸
业	业
当	小彐
电	日乚
贱	貝戈
败	貝攵
内	冂人
贩	貝斜斜又
见	見
赔	貝斜横口
县	且厶
税	禾斜儿横
气	气
传	亻横丶折
顺	川頁
们	亻門
伪	亻斜丶折
会	人竖竖厶
领	人斜折頁
从	人人
镇	金横八竖
须	彡頁
钱	金戈
钻	金竖横口
钢	金竖折乂
铁	金斜横人
铬	金斜折口
胀	月長
腻	月竖貝竖
独	犭虫
肿	月中
风	几乂
脱	月斜儿横
鱼	魚
条	夂木
乐	氏小
争	⺈彐
鸟	鳥
讲	言竖竖川
让	言上
调	言竖口横
齐	文川
诉	言斜斜丶
设	言殳
该	言斜人折
变	亠竖又斜
装	丬横𧘇斜
闻	門耳
闭	門横竖丿
问	門口
间	門日
门	門
将	丬斜折寸
应	广斜斜一
疗	疒了
废	广折丶折
类	米大
炼	火横八折
总	丷竖折心
单	丷竖折十
粮	米斜横艮
数	米折斜攵
洒	氵西
滤	氵竖横心
测	氵竖折刂
学	⺍斜折子
汉	氵又
泼	氵折丶折
宽	宀横竖見
军	冖車
补	衤卜
审	宀申
实	宀斜斜大
马	馬
层	尸竖竖厶
颇	皮頁
观	又見
难	又隹
验	馬斜⺍横
买	㇕斜斜大
骗	馬斜艹横
张	弓長
阳	阝日
费	弓斜横貝
办	力八
阴	阝月
习	习
弹	弓斜十横
随	阝斜月横
红	絲工
续	絲横大斜
纯	絲横折凵
细	絲田
组	絲且
统	絲斜儿折
断	米折横斤
编	絲斜艹横
经	絲折工斜
蚕	一横斜虫
顶	丁頁
鹉	一横鳥竖
垩	一竖竖土
严	一竖竖丿
亚	一业
恶	一竖竖心
画	一竖折凵
残	一斜折戈
歼	一斜折千
殓	夕斜⺍横
殁	一斜折殳
殡	一斜八斜
灭	一火
迈	之横竖力
坛	土竖竖厶
墙	土横口竖
盐	土竖横皿
韦	工㇆
颉	士竖折頁
坝	土貝
进	之竖竖川
辇	夫竖竖車
规	夫見
赵	走乂
顽	二斜折頁
远	之竖竖儿
趋	走斜折彐
坟	土文
圹	土广
颊	二斜斜頁
夹	二火
壶	士斜折业
壳	士斜折几
声	士尸
场	土折横彡
韬	工折臼斜
运	之竖竖厶
寿	丰寸
环	王不
珑	王龍
顼	王頁
职	耳竖折八
责	丰貝
瑶	王斜山斜
玑	王几
静	丰斜彐斜
麸	丰斜折夫
艳	丰斜折巴
聪	耳斜心横
鬓	長斜八斜
玛	王馬
聂	耳折斜又
抚	扌横竖尤
挟	扌竖竖火
摄	扌横又折
捞	扌横力斜
拢	扌龍
挞	扌斜折大
拣	扌横八折
抠	扌横折乂
损	扌竖折貝
挡	扌竖斜彐
摆	扌竖厶横
拥	扌用
捡	扌斜⺍横
抡	扌斜斜匕
抢	扌斜斜巳
摇	扌斜山斜
垫	扌斜折土
挚	扌斜折手
执	扌丸
抛	扌斜折力
换	扌斜大横
搀	扌斜冫斜
挣	扌斜折彐
挤	扌斜横川
过	之寸
扩	扌广
扪	扌門
搁	扌斜口斜
掷	扌斜阝横
搂	扌斜斜女
搅	扌斜見斜
拧	扌斜斜丁
挥	扌斜折車
护	扌户
扫	扌彐
摊	扌折斜隹
扬	扌折横彡
报	扌竖折又
掺	扌折彡横
拟	扌折斜人
荚	艹竖竖火
苇	艹横竖㇆
协	十折斜八
蔷	艹横口竖
载	土横折戈
莲	艹斜折車
莴	艹竖人竖
蓝	艹竖皿斜
黄	廿竖折八
蓦	艹竖馬横
颠	十竖頁斜
获	艹斜丶横
蔼	艹斜乚斜
蔺	艹斜横隹
蒋	艹斜寸斜
丧	十斜斜展
啬	十斜口横
荡	艹斜彡折
苎	艹斜斜一
莹	艹斜丶横
荣	艹斜折木
荤	艹斜折車
萤	艹斜折虫
营	艹斜口横
荧	艹斜折火
劳	艹斜折力
萦	艹斜折絲
茎	艹折工斜
萧	艹折八斜
卖	十折大斜
艺	艹乙
荪	艹折横小
苏	艹折斜八
荫	艹折竖月
萨	艹折丿斜
蕴	艹折皿竖
药	艹折丶斜
飘	西竖竖風
栉	木横竖冂
梦	木横竖夕
雳	雨横斜力
栋	木横折小
栈	木戈
枢	木横折乂
梱	木竖折木
档	木竖斜彐
贾	西貝
枣	木竖折冫
桥	木斜川横
霉	雨斜横母
检	木斜⺍横
枪	木斜斜巳
枫	木風
橹	木斜折日
赖	木竖貝斜
霁	雨斜横川
术	木丶
酿	酉斜横艮
桩	木斜横土
榈	木斜口横
楼	木斜斜女
槟	木斜八斜
树	木折斜寸
椭	木折月横
杨	木折横彡
厅	厂丁
厉	厂横竖力
压	厂横竖丶
砖	石横丶折
夺	大寸
硕	石頁
厌	厂横斜丶
奁	大横折乂
还	之不
碍	石竖寸横
厕	厂竖折刂
砚	石見
垄	龍土
赝	厂斜貝斜
矶	石几
袭	龍斜横𧘇
态	大斜横心
矿	石广
牵	大斜折牛
码	石馬
历	厂力
础	石折竖山
轩	車横竖十
辆	車横人斜
辕	車横𧘇竖
贰	弋竖竖貝
转	車横丶折
辄	車横竖乚
连	之車
轰	車折斜又
轧	車乚
辅	車甫
颐	臣頁
尧	戈尤
翘	戈横习折
轾	車至
卧	臣卜
辑	車竖折耳
匮	匚竖貝横
轴	車由
东	七小
盏	戈皿
轿	車斜川横
输	車斜刂斜
殴	匚斜斜殳
轮	車斜斜匕
堑	車斜斜土
鸦	牙鳥
较	車斜乂斜
辙	車斜攵斜
辚	車斜㐄斜
辖	車斜口横
轻	車折工斜
辗	車折展横
轫	車折斜丶
顿	七折竖頁
辎	車折折田
龉	齒横口折
蛲	虫横折尤
龇	齒竖横匕
战	卜竖折戈
蝇	虫竖乚竖
蜗	虫竖人竖
卤	卜竖折乂
频	止竖斜頁
虚	虎业
蛊	虫皿
贞	卜貝
龄	齒斜斜之
赀	止斜折貝
蜕	虫斜儿横
蝉	虫斜十横
虑	虎心
颅	卜折横頁
龌	齒折横至
卢	卜尸
蚂	虫馬
虏	虎力
吴	口横竖大
哑	口横竖业
贵	中横竖貝
围	因横竖㇆
踌	足竖竖寸
啧	口竖竖貝
蹑	足横又折
团	因横竖丿
蹒	足横人斜
喷	口竖貝竖
躏	足横隹斜
呓	口横竖乙
咙	口龍
跷	足横折尤
践	足戈
呕	口横折乂
嘘	口竖横业
虽	口虫
颚	口竖頁折
圆	因竖折貝
骂	口竖折馬
啰	口竖折夕
跃	足斜横大
响	口斜横口
哗	口斜十斜
呛	口斜斜匕
嗳	口斜又横
叽	口几
鹃	口斜折鳥
噜	口斜折日
唤	口斜大横
图	因斜折冫
鸣	口鳥
踯	足斜阝横
喽	口斜斜女
咛	口斜斜丁
嘱	口折厶竖
啸	口折八斜
哟	口折丶斜
题	日横頁竖
师	刂横竖巾
畴	田竖竖寸
颗	日横竖頁
晒	日西
辉	小横車斜
辈	非車
晓	日横折尤
鸭	甲鳥
显	日业
帅	刂巾
临	刂斜横日
监	刂斜横皿
览	刂斜横見
鉴	刂斜横金
尘	小土
暧	日斜又横
旷	日广
凿	业斜斜凵
尝	小斜厶横
晕	日斜折車
赏	小斜貝横
归	刂彐
贤	刂折斜貝
肾	刂折斜月
竖	刂折斜立
紧	刂折斜絲
畅	申折横彡
赋	貝竖止竖
屿	山横一折
峡	山竖竖火
罢	四横竖厶
帐	巾長
账	貝長
财	貝横竖丿
瞒	目横人斜
巅	山横頁斜
赎	貝横大斜
颛	山横斜頁
眬	目龍
贿	貝横斜月
鸯	冂横斜鳥
贼	貝横折大
岖	山横折乂
崭	山横折斤
贴	貝竖横口
帧	巾竖横貝
帜	巾竖折八
刚	冂斜斜刂
赐	貝竖彡斜
婴	貝竖折女
贝	貝
赌	貝者
则	貝刂
赂	貝斜折口
岚	山斜折乂
岁	山夕
睁	目斜折彐
购	貝斜折厶
罚	四斜横刂
赃	貝斜横土
赠	貝斜日横
赚	貝斜八横
髅	骨斜斜女
贮	貝斜斜一
瞩	目折厶竖
剀	山折横刂
觊	山折横見
凯	山折横几
岂	山己
悬	且折斜心
丢	丿横竖厶
筹	⺮竖竖寸
穑	禾横口竖
迁	之千
犊	牛横大斜
笼	⺮龍
乔	丿横斜川
笺	⺮戈
毡	毛竖横口
乱	舌乚
鹄	牛竖折鳥
篮	⺮竖皿斜
笔	⺮毛
签	⺮斜⺍横
秃	禾几
颓	禾斜折頁
称	禾斜折小
赞	牛斜貝斜
选	之斜横儿
稳	禾斜心折
鹅	手横折鳥
辞	舌辛
简	⺮斜横日
篓	⺮斜斜女
氢	气折工斜
箫	⺮折八斜
笃	⺮馬
俩	亻横人斜
粤	鬼斜斜了
侠	亻竖竖火
伟	亻横竖㇆
伥	亻長
债	亻竖竖貝
牍	片横大斜
侥	亻横折尤
贷	亻横折貝
舆	臼横折八
躯	身横折乂
侦	亻竖横貝
侣	亻竖折口
侧	亻竖折刂
皑	白竖折己
侨	亻斜川横
赁	亻斜貝横
伤	亻斜横力
俭	亻斜⺍横
伦	亻斜斜匕
华	亻斜折十
倾	亻斜折頁
货	亻斜折貝
储	亻斜横者
奥	自斜斜大
伫	亻斜斜一
傧	亻斜八斜
侬	亻斜折𧘇
亿	亻乙
剑	人横刂斜
敛	人横攵斜
饵	食耳
仓	人巳
馍	食横大竖
弑	乂竖工竖
刹	乂横竖刂
饶	食横折尤
饯	食戈
彻	行横折刀
饨	食横折凵
衔	行金
馈	食竖貝横
馄	食竖匕斜
饪	食斜横士
饿	食斜横戈
饰	食斜横巾
饬	食斜横力
饷	食斜横口
馊	食斜又横
丛	人斜斜一
耸	人斜斜耳
怂	人斜斜心
爷	八斜斜冂
饭	食斜斜又
馁	食斜斜女
饥	食几
馋	食斜冫斜
馅	食斜折臼
饮	食欠
仑	人匕
馏	食斜田折
饱	食斜折巳
颔	人斜頁横
贪	人斜貝折
伞	人斜斜丨
饼	食斜斜艹
邻	人斜折阝
馆	食斜斜㠯
蚀	食虫
饲	食折口横
颁	八折斜頁
创	人折横刂
贫	八折斜貝
颂	八折斜頁
饴	食折斜口
钉	金丁
铐	金横竖了
铸	金竖竖寸
钳	金甘
针	金十
钴	金横竖口
错	金横竖日
质	斤横竖貝
钵	金横竖一
铺	金甫
镭	金横竖田
钹	金横丶折
铙	金横折尤
链	金斜折車
钟	金中
铝	金竖折口
锅	金竖人竖
钊	金刂
锁	金竖斜貝
钞	金竖斜丿
销	金竖斜月
锡	金竖彡斜
镗	金竖土竖
铛	金竖斜彐
铜	金竖口横
盘	舟皿
钠	金竖折人
舰	舟見
锄	金竖折力
锹	金斜横火
锈	金斜丿折
锻	金斜殳横
钏	金川
镍	金斜横木
锥	金隹
铂	金白
锦	金斜横巾
铨	金斜斜王
锉	金斜土斜
钤	金斜㇕斜
铃	金斜斜之
舱	舟斜斜巳
锾	金斜又横
铅	金斜折口
钥	金月
锋	金斜折丰
铭	金斜折口
钦	金欠
钓	金斜折丶
钧	金斜折冫
铮	金斜折彐
钩	金斜折厶
锌	金辛
镜	金斜儿横
铲	金斜横丿
镑	金斜方斜
镀	金斜又横
锵	金斜寸斜
镰	金斜八横
镁	金斜斜大
锐	金斜儿横
锑	金斜亻折
镂	金斜斜女
锭	金斜止横
爱	爪斜又横
释	釆折斜工
锯	金折口横
银	金艮
钗	金折斜丶
锰	金折横皿
键	金折二折
肤	月竖竖人
狭	犭竖竖火
胧	月龍
胪	月竖横尸
狈	犭貝
猡	犭竖折夕
脸	月斜⺍横
飓	風竖折八
飕	風斜又横
鹏	月斜折鳥
狰	犭斜折彐
鸠	九鳥
狱	犭斜丶横
脐	月斜横川
脑	月斜凵斜
脏	月斜横土
犷	犭广
腾	月斜斜馬
狞	犭斜斜丁
膑	月斜八斜
脓	月斜折𧘇
胁	月折斜八
鳍	魚横日斜
顷	匕頁
鲔	魚横斜月
鱿	魚尤
鳜	魚横欠折
鲢	魚斜折車
处	夂卜
鲈	魚竖横尸
鲤	魚竖折二
鲳	魚竖折日
鳗	魚竖又竖
尔	⺈小
鲁	魚日
迩	之斜折小
鳃	魚竖折心
龟	⺈竖折乚
奂	⺈竖折大
鳏	魚竖折水
岛	鳥山
负	⺈貝
稣	魚禾
颖	匕斜横頁
鳅	魚斜横火
燄	⺈斜火斜
毕	匕斜折十
鲍	魚斜折巳
贸	氏斜貝折
鲜	魚羊
鳞	魚斜㐄斜
鳝	魚斜口斜
鸵	鳥斜斜匕
刍	⺈彐
雏	⺈折横隹
皱	⺈折横皮
邹	⺈折横阝
鲫	魚折横冂
务	夂力
鸳	夗鳥
匀	勹冫
乌	烏
枭	鳥木
订	言丁
评	言横竖䒑
诗	言横竖寸
讧	言工
诘	言横竖口
诸	言者
诬	言横人斜
语	言横口折
讳	言横竖㇆
请	言竖竖月
亵	亠横𧘇斜
讨	言寸
计	言十
谋	言横竖木
谍	言横木折
诺	言竖口竖
诂	言横竖口
谎	言横川斜
读	言横大斜
谭	言横十竖
谏	言横竖四
斋	文而
诙	言横斜火
试	言横折工
诫	言横折艹
讶	言牙
诚	言横斜㇆
讣	言卜
误	言竖大横
颤	亠竖頁横
识	言竖折八
赢	亡竖凡竖
诽	言非
刘	文刂
课	言竖折木
亩	亠田
蛮	亠竖虫斜
銮	亠竖金斜
谓	言竖折月
弯	亠竖弓斜
诅	言且
讪	言山
讷	言竖折人
挛	亠竖手斜
许	言斜横十
话	言舌
诰	言斜横口
诛	言斜横小
颜	立斜頁斜
诱	言斜丿折
诲	言斜横母
训	言川
谁	言隹
剂	文斜横刂
谕	言斜刂斜
诠	言斜斜王
认	言人
谶	言斜一横
诊	言斜斜彡
论	言斜斜匕
义	丶乂
诟	言斜口横
谣	言斜山斜
诳	言斜折王
讥	言几
讽	言風
诡	言斜巳横
谗	言斜冫斜
询	言斜折日
诣	言斜折日
谄	言斜折臼
谐	言斜白斜
诋	言斜折丶
鸾	亠竖鳥斜
谅	言斜小横
谚	言斜彡斜
议	言斜横乂
辩	辛斜横辛
谛	言斜巾斜
谤	言斜方斜
访	言方
详	言羊
产	立丿
谈	言斜斜火
谜	言斜折米
谦	言斜八横
谴	言斜㠯横
谊	言斜斜且
诧	言斜七斜
译	言折斜工
诀	言折横大
诵	言折斜用
词	言折口横
讯	言折横十
诏	言折斜口
诞	言折止斜
记	言己
辫	辛折折辛
疠	疒横竖力
闺	門横竖土
冯	冫馬
痨	疒横力斜
癞	疒横貝斜
阑	門横竖四
头	冫大
庆	广大
库	广車
庞	广龍
状	丬横斜丶
冻	冫横折小
壮	丬士
闸	門甲
闩	門一
闰	門王
闲	門木
闽	門虫
闯	門馬
阀	門斜横戈
鹰	疒斜鳥斜
瘪	疒斜匕斜
闪	門人
疮	疒斜斜巳
疯	疒風
桨	丬斜折木
奖	丬斜折大
浆	丬斜折水
资	冫斜折貝
阎	門斜折臼
癣	疒斜折羊
净	冫斜折彐
闹	門斜横巾
阂	門斜人折
阅	門斜儿横
阐	門斜十横
阔	門斜斜舌
庐	广户
闷	門心
阕	門折大横
瘫	疒折斜隹
疡	疒折横彡
瘾	疒折心折
妆	丬女
兰	䒑二
誊	半言
怅	忄長
慑	忄横又折
愤	忄竖貝竖
懒	忄横貝斜
娄	米女
烦	火頁
郑	䒑横斜阝
烧	火横折尤
惭	忄横折斤
兑	丷竖折儿
兽	丷竖口横
灿	火山
惧	忄竖折八
养	羊川
烁	火斜折小
焕	火斜大横
恼	忄斜凵斜
悯	忄斜横文
焖	火斜横心
悦	忄斜儿横
惮	忄斜十横
忆	忄乙
炀	火折横彡
递	之斜亻折
惨	忄折彡横
惯	忄折折貝
兹	䒑折折幺
举	⺍横工斜
兴	⺍横竖八
誉	⺍横言斜
洼	氵横竖土
鸿	氵横竖鳥
涛	氵竖竖寸
渍	氵竖竖貝
满	氵横人斜
滞	氵横巾斜
潇	氵横八斜
沥	氵横斜力
浇	氵横折尤
浅	氵戈
渐	氵横折斤
汇	氵匚
涟	氵斜折車
浊	氵虫
涡	氵竖人竖
湿	氵竖折业
温	氵竖折皿
溅	氵竖折戈
渊	氵斜横米
沦	氵斜斜匕
涤	氵斜折木
涣	氵斜大横
渔	氵魚
滦	氵斜木斜
润	氵斜横王
澜	氵斜四横
涧	氵斜横日
浑	氵斜折車
觉	⺍斜折見
沪	氵户
滨	氵斜八斜
浓	氵斜折𧘇
泽	氵折斜工
滩	氵折斜隹
涨	氵折横長
汤	氵折横彡
涩	氵折止斜
烫	氵折火斜
渗	氵折彡横
逦	之横丶竖
写	冖横一折
窍	穴横竖了
窥	穴横見斜
违	之横竖㇆
祷	礻竖竖寸
宝	宀竖竖丶
赛	宀横貝斜
骞	宀横馬斜
宠	宀龍
窃	穴横折刀
祯	礻竖横貝
遗	之竖貝横
祸	礻竖人竖
褴	衤竖皿斜
裆	衤竖斜彐
视	礻見
袄	衤斜横大
鹤	冖斜横鳥
穷	穴力
遥	之斜山斜
宾	宀斜横八
额	宀斜頁横
农	冖𧘇
礼	礻乚
裤	衤斜横車
禅	礻斜十横
迳	之折工斜
迟	之折横丶
逊	之折横小
边	之力
辽	之了
骊	馬横丶竖
颈	㇕斜頁横
劲	㇕斜力横
骤	馬横豕折
剧	尸横刂竖
骑	馬竖口竖
驮	馬大
戏	又戈
驱	馬横折乂
驶	馬竖折乂
剥	彐竖折刂
骡	馬竖折絲
驷	馬四
骄	馬斜川横
属	尸斜厶横
驯	馬川
肃	彐斜横八
驳	馬斜斜乂
驹	馬斜折口
骆	馬斜折口
欢	又欠
鸡	又鳥
驻	馬斜横王
昼	尸斜一横
尽	尸斜横冫
骇	馬斜人折
骥	馬斜八横
骈	馬斜斜艹
屡	尸斜斜女
驴	馬户
驼	馬斜斜匕
恳	艮心
驿	馬折斜工
预	又折頁竖
艰	又艮
驭	馬又
驰	馬也
劝	又力
骏	馬折夂斜
卫	冂一
际	阝示
陕	阝竖竖火
陆	阝竖竖山
陇	阝龍
阵	阝車
陈	阝横折小
贺	力竖折貝
驾	力竖折馬
孙	子小
坠	阝斜斜土
阶	阝斜斜川
弥	弓斜折小
隐	阝斜心折
飞	乙冫
导	巳寸
妩	女横竖尤
结	絲横竖口
绪	絲者
绫	絲横夂斜
纬	絲横竖㇆
纭	絲竖竖厶
绩	絲竖竖貝
绑	絲竖竖阝
纣	絲寸
缚	絲横竖寸
叁	厶横斜三
缅	絲横丨竖
参	厶横斜彡
缄	絲竖口竖
绕	絲横折尤
线	絲戈
妪	女横折乂
练	絲横八折
绰	絲竖十竖
娱	女竖大横
缉	絲竖折耳
绳	絲竖乚竖
织	絲竖折八
绢	絲竖折月
纱	絲竖斜丿
缧	絲竖折絲
绸	絲竖口横
纲	絲竖折乂
缨	絲竖女竖
纳	絲竖折人
纤	絲千
妈	女馬
绣	絲斜丿折
缎	絲斜殳横
维	絲隹
绵	絲斜横巾
缴	絲斜攵斜
给	絲斜口横
绘	絲斜厶横
纵	絲斜斜人
纶	絲斜斜匕
纷	絲斜斜刀
缓	絲斜又横
绥	絲斜斜女
绷	絲斜折月
纸	絲氏
络	絲斜折口
绚	絲斜折日
约	絲斜折丶
终	絲斜折冫
绝	絲斜折巴
纹	絲文
纺	絲方
娴	女斜横木
缠	石斜二横
绊	絲半
婵	女斜十横
缮	絲斜口斜
继	絲斜斜乚
综	絲斜斜示
绽	絲斜止横
婶	女斜斜申
缩	絲斜白横
缝	絲斜丰斜
绾	絲斜斜㠯
妇	女彐
纽	絲折横十
绿	絲折横水
绍	絲折斜口
贯	母貝
级	絲折横人
绋	絲折横川
纫	絲折斜丶
纪	絲己
丝	絲折折一
缘	絲折折豕
纠	絲凵
缫	絲折木竖
乡	乡
芈	卜竖横工
殇	一斜彡折
趸	一折斜足
欤	一折欠横
坜	土横斜力
贡	工貝
韧	工折丶折
击	二山
坞	土烏
毂	士斜殳横
玨	王王
赘	丰折貝斜
麦	丰夂
琐	王竖斜貝
瑷	王斜又横
琼	王斜小横
珲	王斜折車
撵	扌横車斜
挠	扌横折尤
掳	扌竖横力
掴	扌竖丶横
揽	扌竖見斜
势	扌斜折力
捣	扌斜折山
拦	扌斜斜二
擞	扌斜攵折
择	扌折斜工
觐	廿竖見横
荆	艹竖刂竖
鹊	廿竖折鳥
莱	艹竖竖水
韩	十竖㇆横
贲	十横竖貝
鸪	十竖折鳥
鞑	革斜折大
萝	艹竖折夕
苍	艹斜斜巳
藓	艹斜折羊
薮	艹斜攵折
荦	艹斜折牛
莺	艹斜折鳥
酝	酉竖竖厶
椟	木横大斜
桢	木竖横貝
榄	木竖見斜
槛	木竖皿斜
樱	木竖女竖
桦	木斜十斜
桧	木斜厶横
枞	木斜斜人
栏	木斜斜二
霭	雨斜乚斜
雾	雨斜折力
鹌	大竖鳥折
砺	石竖力竖
靥	厂横丨竖
魇	厂横鬼斜
餍	厂横食斜
励	厂横力折
聋	龍耳
龚	龍横竖八
矾	石凡
砾	石斜折小
尴	尤竖皿斜
轲	車横竖口
轭	車横斜巳
轼	車横折工
辐	車横田竖
轶	車斜横人
斩	車斤
辍	車折又折
欧	匚斜斜欠
鸥	匚斜斜鳥
瓯	匚斜丶折
鸢	弋鳥
虾	虫横竖卜
蛎	虫竖力竖
颦	止竖十斜
蝈	虫竖丶横
龋	齒斜厶横
龊	齒足
龃	齒且
龈	齒艮
蚁	虫斜横乂
蝼	虫斜斜女
嗫	口横又折
唠	口横力斜
啭	口横丶折
跶	足斜折大
鹭	足斜鳥横
嚣	口竖口竖
嘤	口竖女竖
呐	口竖折人
勋	口竖折力
呜	口烏
哝	口斜折𧘇
坚	刂折斜土
鳖	水竖魚斜
晖	日斜折車
睐	目竖竖水
帼	巾竖丶横
羁	四横竖馬
罗	四夕
逻	之竖折夕
黩	四横大斜
岗	山竖折乂
峥	山斜折彐
赈	貝辰
贬	貝斜横之
赊	貝斜斜示
赡	貝斜言斜
贻	貝折斜口
赅	貝斜人折
鹦	貝竖鳥折
矫	矢斜川横
牺	牛西
秽	禾竖折夕
籁	⺮横貝斜
篑	⺮竖貝横
筛	⺮竖巾横
箩	⺮竖折夕
衅	丿竖折半
筝	⺮斜折彐
箪	⺮斜十横
氲	气竖折皿
俨	亻横丿竖
俪	亻横丶竖
俦	亻竖竖寸
囱	鬼夂
偿	亻竖厶横
侩	亻斜厶横
伧	亻斜斜巳
仪	亻斜横乂
鸽	人横鳥竖
觎	人横見竖
鸰	人斜折鳥
惩	行横心竖
径	行折工斜
馒	食竖又竖
饺	食斜乂斜
钙	金横乚竖
锲	金横大折
慇	斤折心斜
锚	金横竖田
镖	金横竖示
钝	金横折凵
铀	金由
钾	金甲
镘	金竖又竖
铿	金竖土折
镯	金竖虫斜
锣	金竖折夕
锤	金斜二横
铢	金斜横小
铄	金斜折小
钨	金烏
镶	金斜𧘇横
镐	金斜口横
镞	金斜矢斜
铰	金斜乂斜
镝	金斜口横
镳	金斜横灬
觅	爪見
鹞	金斜鳥横
镕	金斜口斜
铎	金折斜工
钮	金折横十
凤	几又
飏	風折横彡
腼	月横丨竖
狮	犭竖巾横
獭	犭横貝斜
脍	月斜厶横
肠	月折横彡
鳔	魚横竖示
鳄	魚竖了横
玺	⺈竖丶横
觞	⺈斜彡折
毙	匕斜匕斜
鲸	魚斜小横
惫	夂竖折心
鲛	魚斜乂斜
袅	鳥斜横𧘇
讦	言横竖十
证	言横竖止
谨	言横丰竖
谟	言横大竖
鹑	亠竖鳥折
峦	亠竖山斜
谒	言竖乚斜
恋	亠竖心斜
孪	亠竖子斜
诈	言斜横卜
讫	言斜横乙
诿	言斜横女
谢	言斜横寸
讹	言斜横匕
兖	亠斜儿折
衮	亠斜𧘇折
讼	言斜斜厶
诤	言斜折彐
谆	言斜子横
赣	立竖貝横
竞	立竖折儿
谱	言斜日横
彦	立斜横彡
飒	立斜折乂
谲	言折口斜
谬	言折彡斜
盗	冫斜折皿
癫	疒横頁斜
庙	广由
鹧	广横鳥斜
疟	疒匚
酱	丬斜折酉
闱	門横竖㇆
闾	門竖折口
阗	門横八竖
阁	門斜折口
闵	門文
阖	門横皿折
痪	疒斜大横
痉	疒折工斜
恸	忄横力折
盖	羊皿
粪	米横竖八
惬	忄竖火竖
愠	忄竖折皿
恻	忄竖折刂
烩	火斜厶横
炖	火横折凵
炽	火竖折八
烂	火斜斜二
炉	火户
怆	忄斜斜巳
懔	忄斜示横
懑	氵横心斜
渎	氵横大斜
涝	氵横力斜
濑	氵横貝斜
濒	氵竖頁竖
溃	氵竖貝横
滥	氵竖皿斜
鲨	氵竖魚斜
沧	氵斜斜巳
浏	氵斜横刂
济	氵斜横川
湾	氵斜弓斜
泻	氵斜一折
泾	氵折工斜
寝	宀斜又斜
窜	穴竖折中
窝	穴竖人竖
窦	穴横大斜
禄	礻折横水
衬	衤寸
褛	衤斜斜女
鸩	冖斜折鳥
骠	馬横竖示
骋	鳥竖折了
驸	馬斜横寸
骛	又折馬斜
双	又又
骚	馬折虫斜
书	㇕折丶竖
堕	阝横土斜
陨	阝竖折貝
险	阝斜⺍横
缰	絲横田竖
绮	絲竖口竖
缭	絲横小竖
绒	絲横折大
辔	車折口折
绅	絲申
缆	絲竖見斜
娇	女斜川横
媪	女竖折皿
嬷	女斜厶斜
嫔	女斜八斜
嬝	女斜𧘇斜
驽	女折斜馬
纥	絲斜横乙
纰	絲斜折匕
绞	絲斜乂斜
缔	絲斜巾斜
缢	絲斜皿斜
缣	絲斜八横
缕	絲斜斜女
缤	絲斜八斜
绎	絲折斜工
缀	絲折又折
缪	絲折彡斜
鸶	絲折鳥横
缁	絲折折田
绌	絲折竖山
