的	川曲儿乙言
了	又乙
我	竹寸七竹
是	曲一一添卜
在	大寸卜添二
你	川添儿添曲
和	竹梄口一
有	大寸月一
不	大卜
就	言一口曲大
都	二竹乙口
也	乙卜
要	梄口巛竹
吧	口一乙曲
好	巛竹乙一
他	川添乙卜
說	言寸人口儿
去	二一巛言
到	七二曲寸
沒	添添儿乙又
還	之一目口儿
上	卜一
對	曲米米三寸
那	乙寸二寸乙
人	人寸
個	川添口十口
看	竹寸目一
中	口口
呢	口一又竹儿
來	梄一人寸人
嗎	口一三米
爲	斤米
會	人寸一目曲
她	巛竹乙卜
與	川二一卜人
給	巛一人一口
等	竹言二一寸
這	之一言寸
用	月二
把	寸添乙曲
下	一添卜寸
恩	口寸大寸之
能	巛言月儿儿
很	人卜又人
多	儿言儿言
做	川添十口竹
想	梄一目一之
點	目曲二卜口
被	之广又卜
地	二一乙卜
而	大目
一	一添
後	人卜巛巛儿
又	又言
從	人卜人人卜
再	一添目寸二
將	巛大儿言寸
時	曲一二一寸
但	川添曲一一
過	之一目口
打	寸添一卜
大	大寸
年	竹一十口
麼	广大梄梄巛
啦	口一寸添言
以	巛言人寸
買	目曲目人
讓	言寸言口十
嗯	口一口大之
着	米三目一
小	曲人
得	人卜曲一寸
先	竹二儿寸
啊	口一乙一口
或	七竹口一一
呀	口一七卜
找	寸添七竹
新	言米梄一斤
及	乙添人寸
跟	口卜又人
於	言乙人寸广
太	大寸言添
嘛	口一广梄梄
號	口一一乙卜
日	曲一
才	寸言竹添
可	一卜口一
比	儿儿儿儿
玩	三一一添一
們	川添又寸
最	曲一三十又
月	月一
真	十寸目三人
吃	口一竹一乙
發	又米乙巛月
並	米一曲米
它	之寸儿儿
其	十三
話	言寸竹卜
請	言寸三卜月
錢	斤一七竹七
叫	口一巛卜
開	又寸一添十
出	巛曲巛卜
誰	言寸川卜
哈	口一人一口
當	曲人之口曲
向	川目口一
家	之寸大月
問	又寸口一
之	之一
更	一添曲一人
該	言寸言巛人
走	二人
快	米卜又添大
別	口一乙竹曲
前	米一月一曲
由	曲二
高	言一口目口
您	川添儿曲之
裏	言儿曲卜二
加	乙竹口一
所	之竹斤寸
天	一添大寸
卻	人一人口乙
已	乙二
里	曲卜二一
內	目寸人寸
寫	之寸川儿米
啥	口一人寸竹
老	二竹儿儿
搞	寸添言目口
行	人卜
事	一添口一又
拿	人寸一口竹
帶	十一儿之目
如	巛竹口一
死	一添儿言儿
賣	二二目曲目
暈	曲一之之梄
像	川添儿口大
使	川添一口人
剛	目寸米目曲
成	七大乙添
無	竹一十十米
換	寸添儿人大
只	口一人一
哪	口一乙二乙
愛	斤添之之儿
回	口寸口一
聽	三十三一之
少	曲人竹添
元	一添一儿
喫	口一三乙大
卡	卜一卜寸
靠	竹二口一曲
幫	二一二川目
算	竹言目一十
者	二竹
忙	米卜言七
起	二人乙乙
各	儿卜口一
學	川二人人乙
分	人一乙寸
咯	口一儿卜口
總	巛一川儿之
則	目人曲寸
水	曲添
張	乙巛三七
改	乙乙竹人
唉	口一巛言竹
三	三寸
見	目儿
連	之一梄曲
車	梄曲
放	言乙竹人
全	人寸三一
按	寸添之寸巛
區	七添口口口
萬	十卜曲目巛
機	梄一巛七人
早	曲一十寸
拉	寸添言米
弄	三一十卜
本	梄一一添
偶	川添曲目巛
頁	大人
進	之一川卜
性	米卜竹三
第	竹言乙巛川
完	之寸一添一
同	目寸一添口
花	十卜川添儿
長	三七
怕	米卜川曲
女	巛竹
講	言寸十目二
殺	人言梄一月
組	巛一目三
錯	斤一十一曲
些	卜卜儿儿二
住	川添言添三
名	儿言口一
跑	口卜儿乙乙
次	广寸儿人
網	巛一目米言
睡	目一竹十二
裝	巛大二二言
哦	口一竹寸七
挺	寸添乙竹二
王	三一
圖	口寸口口口
掉	寸添卜曲十
路	口卜儿卜口
正	一添卜卜
外	儿言卜寸
二	二寸
頭	一添口米大
應	广大川川之
生	竹三
心	之巛
因	口寸大寸
子	乙一
強	乙巛巛言口
類	米梄大言大
作	川添竹一卜
送	之一米一大
書	又大二寸曲
每	竹一巛乙
法	添添二一巛
乖	竹十广卜儿
拍	寸添川曲
市	言一目卜
撒	寸添十月竹
至	七二
接	寸添言米巛
美	米三大寸
表	三卜儿之
未	二寸梄一
辦	言十乙竹言
非	曲三
級	巛一乙添人
即	又人乙目
哎	口一十卜人
此	卜卜儿儿
差	米三二卜
版	川又斤寸又
併	川添米一十
副	一添口曲曲
系	竹添巛一
收	巛卜竹人
男	曲卜乙竹
俺	川添大寸曲
字	之寸乙一
兩	一添目人人
股	月一月又
轉	梄曲梄曲寸
便	川添一曲人
考	二竹一乙
塊	二一川口
線	巛一川曲曲
手	竹寸
黃	十一一曲人
道	之一米一川
米	米梄
座	广大人人二
豬	大月二竹
聊	三十儿竹
取	三十又言
低	川添儿七言
難	十一口二川
哇	口一二一二
兒	川二儿寸
受	斤添之之又
包	儿乙乙二
阿	乙口一卜口
喝	口一曲人巛
白	川曲
金	斤一
四	目曲
近	之一斤寸
管	竹言之寸乙
定	之寸一添卜
傳	川添梄曲寸
門	又寸
樣	梄一米言曲
夠	儿言儿儿口
交	言一人一人
李	梄一乙一
笑	竹言竹添大
自	川目
邊	之一川之言
型	一添十曲二
黑	目曲二一米
慢	米卜曲目又
刷	又竹目卜曲
穿	之人七卜
越	二人七竹巛
位	川添言米
貴	口口一添目
部	言米口一乙
稱	竹梄斤目二
處	卜七儿卜月
選	之一乙十人
站	言米卜寸口
牛	竹二
怪	米卜又言二
省	曲人竹添目
倒	川添七二曲
談	言寸米人米
曾	米寸目曲曲
羣	又大口一米
經	巛一一巛二
數	曲口巛竹竹
據	寸添卜七大
變	言寸巛巛竹
累	曲卜巛一
汗	添添一十
查	梄一曲一一
象	儿添口一大
半	米二
陳	乙口梄一曲
紅	巛一二卜
格	梄一儿卜口
五	二卜又添
幹	十寸曲人一
樓	梄一曲口巛
方	言乙
讀	言寸二目目
頂	一卜大人
某	十二梄一
條	川添卜儿梄
亂	斤添又又巛
唔	口一二又口
馬	三米
遠	之一二口儿
單	口一口曲一
海	添添竹一巛
相	梄一目一
熱	二一人月米
光	曲人一儿
咋	口一竹一卜
風	月卜
且	目三
林	梄一梄一
滿	添添十人人
額	之寸儿口大
化	川添儿儿
班	三一曲寸三
滴	添添言十口
掛	寸添二二卜
關	又寸巛巛巛
漲	添添乙巛三
店	广大卜寸口
安	之寸巛竹
坐	人寸人寸二
約	巛一儿乙言
飛	乙七广乙广
劉	儿竹斤一曲
度	广大十一又
種	竹梄竹曲二
俄	川添竹寸七
歌	一卜口口儿
報	二一米乙又
信	川添言寸
若	十卜大寸口
原	大大川曲曲
文	言人
飯	人又斤寸又
晚	曲一儿口儿
量	曲一一曲二
村	梄一寸言
式	七言二卜
空	之人二卜
山	目目
賺	目人米曲人
毛	竹七
重	竹十曲一二
主	言添三一
另	口一乙竹
間	又寸曲一
裡	之广曲卜二
貼	目人卜寸口
入	人寸
伐	川添七竹
血	竹添目梄
盤	斤乙月又目
爽	大寸人人人
隊	乙口米寸大
楊	梄一曲儿斤
臺	二二口之七
往	人卜言添三
片	川又
國	口寸七口一
狗	月竹儿乙口
歲	卜卜七一曲
費	乙巛川寸目
壞	二一言目曲
龍	言卜
離	言一人巛川
共	十一人一
西	梄口
佔	川添卜寸口
周	月添二一口
超	二人乙寸口
明	曲一月一
媽	巛竹三米
均	二一儿乙广
期	十三月一
達	之一二一米
照	曲一乙口米
切	七寸乙寸
留	儿竹曲卜
動	竹十曲二乙
特	竹二二一寸
氣	竹乙米梄
係	川添竹添巛
神	二曲曲梄
鳥	儿巛
畫	又大二曲一
夢	十卜目之儿
教	二竹乙一竹
哥	一卜口一口
甘	十二
蠻	言寸巛巛口
魚	儿一
值	川添十寸目
鎮	斤一十目人
么	竹添巛言
罵	目曲三米
陪	乙口言米口
既	又人七寸儿
哭	口一口一大
力	乙竹
建	乙言又大二
洗	添添竹二儿
懂	米卜十曲二
雙	川卜川卜又
口	口一
指	寸添儿儿曲
東	梄一曲一
球	三一一曲言
仍	川添乙添竹
活	添添竹卜
跌	口卜竹二人
練	巛一梄一目
億	川添言曲之
清	添添三卜月
提	寸添曲一卜
除	乙口人寸竹
通	之一又言月
酒	添添梄寸
貓	斤月十卜曲
餓	人又竹寸七
票	梄口二曲
六	言一人一
病	广一一目人
咩	口一米三
假	川添又又又
久	儿添言添
段	川添三寸月
平	一添米寸十
抓	寸添斤添
套	大寸三七
課	言寸曲卜梄
急	儿添又二之
藥	十卜川巛梄
城	二一七大乙
任	川添竹添二
草	十卜曲一十
羅	目曲巛一川
理	三一曲卜二
令	人寸之一
雨	梄添
貨	川添儿儿目
唱	口一曲一曲
左	大寸二卜
藍	十卜七竹目
縣	目三曲竹巛
常	曲人之口目
色	儿添乙曲
搶	寸添人之口
菜	十卜斤添梄
喲	口一巛儿言
集	川卜梄一
感	七大一口之
房	之竹言乙
較	梄曲言人人
混	添添曲儿儿
敢	又添三十竹
火	米人
臉	月一人人人
操	寸添口口梄
南	十寸目寸米
退	之一又人
件	川添竹二
吳	口一巛添大
破	大一又卜
聲	二二又月三
德	人卜十一之
雪	梄添又二
局	又竹乙添口
雲	梄添二寸巛
噢	口一川米大
整	梄一口一卜
傻	川添川人儿
華	十卜一十二
克	十寸口一儿
呃	口一大大乙
喊	口一七一口
現	三一目儿
跳	口卜儿寸添
養	米三言添又
補	之广梄二
團	口寸梄曲寸
沈	添添之之儿
反	斤寸又言
樂	川曲巛巛梄
篇	竹言之目十
待	人卜二一寸
砸	大一七添目
深	添添之人梄
煩	米人大人
根	梄一又人
求	一添曲添言
投	寸添月又
電	梄添曲梄
親	言米梄一目
惡	二巛之巛
葉	十卜十巛梄
款	二二二曲儿
知	竹大口一
八	人一
配	梄寸乙乙
器	口一口口口
何	川添一卜口
率	言一巛添十
調	言寸月二口
鬼	川口
修	川添卜儿斤
試	言寸七言二
謝	言寸川三寸
麪	梄一人巛乙
僅	川添十口三
層	又竹米目曲
面	又添口寸目
週	之一月二口
北	广卜儿儿
木	梄一
份	川添人一乙
記	言寸乙乙
趙	二人曲人月
情	米卜三卜月
肉	目寸人寸人
需	梄添大目
七	七寸
論	言寸人目十
流	添添言巛川
噶	口一十人巛
招	寸添乙寸口
痛	广一又言月
列	一添儿言曲
石	大一
香	竹梄曲一
封	二一二一寸
眼	目一又人
易	曲一儿乙斤
冷	广寸人寸之
借	川添十一曲
派	添添斤寸儿
帥	竹添乙又目
付	川添寸言
十	十寸
廠	广大曲口竹
陽	乙口曲儿斤
樹	梄一二米寸
油	添添曲二
胡	十寸口一月
排	寸添曲三
停	川添言之一
合	人寸一添口
軍	之之梄曲
身	川三
奧	川目竹斤大
章	言米曲一十
科	竹梄广寸十
倆	川添一人人
星	曲一竹三
牌	川又川口十
權	梄一十口川
翻	斤梄曲乙乙
隨	乙口之二月
場	二一曲儿斤
帖	目卜卜寸口
商	言一米人口
庫	广大梄曲
價	川添梄口目
物	竹二儿乙斤
泡	添添儿乙乙
寶	之寸三巛目
玉	三一言添
體	目之曲口米
追	之一竹添乙
傷	川添竹儿斤
背	广卜儿儿月
腳	月一人口乙
丟	三一巛言
劍	人寸一人曲
解	儿添月乙竹
室	之寸七二
底	广大儿七言
業	曲米米二梄
代	川添七言
孫	乙一竹添巛
朱	竹一梄一
亦	言曲
須	斤三大人
舊	十卜川卜川
乾	十寸曲竹乙
工	二卜
咱	口一川目
詞	言寸乙一口
刀	乙寸
喔	口一又竹七
波	添添又卜
證	言寸又口米
鐵	斤一十口三
推	寸添川卜
落	十卜添儿口
節	竹言又人乙
春	三人
輕	梄曲一巛二
笨	竹言梄一一
九	月乙
輸	梄曲人月曲
江	添添二卜
短	竹大一口米
含	人寸言又口
千	竹十
炒	米人曲人竹
藉	十卜三十曲
丫	米寸卜添
徐	人卜人寸竹
騙	三米之目十
秒	竹梄曲人竹
青	三卜月一
耍	大目巛竹
夜	言一川儿言
許	言寸竹一十
咁	口一十二
吹	口一儿人
師	竹添乙一目
板	梄一斤寸又
土	二一
贏	言七口目月
姐	巛竹目三
直	十寸目三
公	人一巛言
苦	十卜十寸口
秀	竹梄乙添竹
博	十寸梄二寸
皮	又卜
朝	十寸曲十月
君	又大口一
詩	言寸二一寸
爛	米人又梄目
靜	三卜月斤又
利	竹梄曲寸
素	三卜巛一
立	言米
存	大寸卜添乙
燒	米人二二一
斷	巛巛巛巛斤
吾	二卜又添口
虧	卜七川一一
湯	添添曲儿斤
民	乙二七寸
極	梄一又又一
命	人寸一口乙
睇	目一米乙川
忘	言七之巛
茶	十卜人寸梄
冰	广寸曲添
供	川添十一人
案	之寸巛竹梄
田	曲卜
初	之广乙寸
品	口一口一口
抽	寸添曲二
造	之一竹二口
抱	寸添儿乙乙
野	曲卜二又卜
綠	巛一巛又曲
項	二卜大人
獎	巛大儿寸大
胖	月一米二
緊	七一又言巛
故	十寸口一竹
服	月一乙目又
盡	又大一米目
百	一添川曲
兵	斤二人一
英	十卜目寸大
蘇	十卜儿一竹
般	斤乙月又
演	添添之曲人
嘴	口一卜儿月
簽	竹言人人人
填	二一十目人
果	曲卜梄一
保	川添口一梄
唐	广大又大口
雞	斤添巛大川
夏	一添川目儿
莫	十卜曲一大
硬	大一一曲人
寒	之寸十人广
挖	寸添之人乙
凡	月言
髮	三七斤大又
言	言寸
題	曲一一卜大
防	乙口言乙
街	人卜二一二
距	口卜七添又
挑	寸添儿寸添
純	巛一一添巛
鬧	三三言一目
欲	人一人口儿
竟	言米曲一儿
源	添添大川曲
官	之寸乙又
戲	卜七一米七
寄	之寸大一口
古	十寸口一
首	米一川目
思	曲卜之巛
橋	梄一竹目口
燈	米人又口米
郭	言一口乙乙
亮	言一口之月
干	一十
屬	又竹曲儿口
窮	之人川三乙
粉	米梄人一乙
爆	米人曲人曲
韓	十寸曲口十
刪	目寸十卜曲
戴	十寸七十人
然	儿言大言米
衝	人卜竹曲二
疼	广一儿卜广
雷	梄添曲卜
蓋	十卜二巛目
港	添添十人乙
租	竹梄目三
狼	月竹言添又
蘭	十卜又梄目
狂	月竹三一
布	大寸目卜
引	乙巛卜添
壓	大大曲大二
亞	二巛
捏	寸添曲一二
齊	言一米儿川
隻	川卜又言
賽	之寸十人目
員	口一目人
佛	川添乙巛川
食	人又
船	斤乙月寸口
今	人寸言添又
恨	米卜又人
宋	之寸梄一
銀	斤一又人
猛	月竹乙一目
客	之寸儿卜口
黨	曲人之二米
雖	口一口巛川
碼	大一三米
友	大寸又言
領	人寸之一大
句	儿乙口一
斯	十三斤寸
沙	添添曲人竹
戰	口一口一七
哼	口一言口又
望	言七月一三
腿	月一之一又
沖	添添口口
丁	一卜
園	口寸二口儿
祝	二曲口一儿
鄉	巛人言又乙
牀	巛大梄一
鄭	米寸梄大乙
界	曲卜人一川
抗	寸添言一月
步	卜卜曲人
河	添添一卜口
缺	竹一十又大
賊	目人七竹大
尚	曲人目寸口
似	川添巛言人
羊	米三
福	二曲一口曲
必	之巛竹添
遭	之一一曲曲
煙	米人梄口二
否	大卜口一
端	言米目目大
設	言寸月又
猜	月竹三卜月
伊	川添又大
秦	三人竹梄
秋	竹梄米人
毒	三卜巛乙
架	乙竹口一梄
熊	巛言月儿米
持	寸添二一寸
廣	广大十曲人
插	寸添竹十川
歸	竹添乙之目
折	寸添斤寸
滾	添添言人口
靈	梄添口人人
意	言米曲一之
呆	口一梄一
基	十三二一
困	口寸梄一
圈	口寸米二乙
迷	之一米梄
趕	二人曲一一
踢	口卜曲儿斤
勝	月一米二乙
史	口一人言
甲	曲乙
呵	口一一卜口
搬	寸添斤乙月
獲	月竹十川又
紙	巛一儿七
乃	乙添竹添
覺	川二人人目
右	大寸口一
塔	二一十一口
準	添添川卜十
拖	寸添竹一乙
摸	寸添十曲大
院	乙口之一一
慘	米卜巛人斤
訂	言寸一卜
散	十一月一竹
松	梄一人寸巛
爸	人一人言乙
喜	二二口米口
洋	添添米三
語	言寸二又口
呈	口一三一
治	添添巛言口
降	乙口儿卜十
峯	目目儿卜三
漢	添添十口二
富	之寸一口曲
姓	巛竹竹三
料	米梄广寸十
嘎	口一一川七
結	巛一二二口
閃	又寸人寸
咬	口一言人人
梅	梄一竹一巛
批	寸添儿儿儿
戶	之竹
足	口卜
寧	之寸之目一
爬	斤添乙曲
醒	梄寸曲一竹
狠	月竹又人
逛	之一月竹三
精	米梄三卜月
瘦	广一川卜又
瘋	广一月卜
踩	口卜斤添梄
槍	梄一人之口
誒	言寸巛言竹
軟	梄曲儿人
偷	川添人月曲
支	十寸又言
杜	梄一二一
麗	一添目言广
鞋	十十二一二
展	又竹十一儿
咧	口一一儿曲
興	川二目口人
依	川添言儿
倍	川添言米口
康	广大又大添
堂	曲人之口二
救	一添曲言竹
觀	十卜口川目
鍵	斤一乙又二
製	竹二目曲言
餘	人又人寸竹
冇	大寸目寸
筆	竹言又大二
音	言米曲一
世	十一巛添
著	十卜二竹
仲	川添口口
舞	竹一十儿十
吖	口一米寸卜
守	之寸寸言
露	梄添口儿口
冒	曲一目一
昇	曲一竹添十
唄	口一目人
榮	米人米之梄
弱	乙巛广乙广
影	曲一言曲斤
州	添寸川寸
替	二言二言曲
逼	之一一口曲
陸	乙口二人二
曲	曲曲
願	大大川曲大
牙	七卜
箱	竹言梄一目
嚇	口一二二米
測	添添目人曲
莊	十卜巛大二
寬	之寸十目言
遍	之一之目十
細	巛一曲卜
狀	巛大大言
巴	乙曲
閒	又寸月一
武	一添七言卜
湖	添添十口月
聯	三十巛巛巛
程	竹梄口一三
柳	梄一儿竹
偏	川添之目十
實	之寸巛乙目
印	斤添乙目
味	口一二寸梄
鎖	斤一曲人目
衆	竹添目梄大
零	梄添人寸之
環	三一目口儿
角	儿添月二
紫	卜卜儿儿巛
勒	十十乙竹
島	儿巛目目
耶	三十乙口
熟	言一口月米
孔	乙一巛添
寸	寸言
標	梄一梄口二
歐	七添口口儿
厚	大大曲一乙
答	竹言人一口
社	二曲二一
懶	米卜梄儿目
顧	之竹川卜大
順	川寸大人
滅	添添七一米
運	之一之之梄
輪	梄曲人目十
兼	米一又曲人
溫	添添口人目
娘	巛竹言添又
登	又米一口米
悶	又寸之巛
微	人卜目月竹
佳	川添二一二
瞭	目一人曲曲
雅	七卜川卜
魔	广大梄梄川
司	乙添一添口
拋	寸添大儿乙
志	二二之巛
奇	大寸一卜口
編	巛一之目十
瓦	一巛
居	又竹十寸口
憑	广寸三米之
盛	七大乙添目
奶	巛竹乙添竹
虎	卜七
后	斤寸一添口
洞	添添目一口
台	巛言口一
形	一添十卜斤
佢	川添七添又
負	儿添目人
川	川寸
檔	梄一曲口曲
圓	口寸口一目
牆	巛大二口口
囧	口寸人一目
充	言一巛言儿
害	之寸三卜口
喂	口一曲一儿
免	儿添口一儿
景	曲一言口曲
擬	寸添儿又卜
穩	竹梄斤又之
曹	一添曲曲曲
曉	曲一二二一
煮	二竹米言
良	言添又人
蛋	又添卜卜口
吐	口一二一
肥	月一乙曲
仙	川添目目
宮	之寸口竹口
碰	大一米一曲
酸	梄寸巛人儿
侯	川添又一竹
塞	之寸十人二
嘍	口一曲口巛
脫	月一人口儿
勁	一添巛二乙
欠	儿人
創	人寸之口曲
擦	寸添之又二
爾	一添人人人
藏	十卜七巛七
皆	儿儿儿儿川
屁	又竹儿儿儿
永	言添曲添
夫	二言
掙	寸添斤添又
琴	三一三言又
錄	斤一巛又曲
餵	人又曲一儿
稅	竹梄人口儿
宏	之寸大寸巛
例	川添一儿曲
專	梄曲寸言
砍	大一儿人
視	二曲目儿
繼	巛一巛巛巛
兄	口一儿寸
產	言人大大竹
善	米三米一口
增	二一米目曲
施	言乙竹一乙
淚	添添之竹大
暗	曲一言米曲
忍	乙寸言添之
肯	卜卜月一
母	巛乙
聖	三十口一三
橫	梄一十曲人
遊	之一言竹乙
艾	十卜人言
致	七二竹人
宗	之寸二曲
偉	川添又口十
麻	广大梄一梄
怒	巛竹又言之
扔	寸添乙添竹
爭	斤添又大
游	添添言竹乙
鄧	又米一米乙
腰	月一梄口巛
嫩	巛竹梄口竹
肖	曲人月一
淨	添添斤添又
罪	目曲曲三
仔	川添乙一
彈	乙巛口曲一
丑	又二卜添
減	添添七一口
敏	竹一巛乙竹
義	米三竹寸七
棒	梄一三人二
臭	川目大言
響	巛人言言曲
聞	又寸三十
拆	寸添斤寸言
蔡	十卜儿又二
計	言寸十寸
絲	巛一巛一
校	梄一言人人
氏	儿七
糖	米梄广又口
吉	二二口一
押	寸添曲乙
馮	广寸三米
吵	口一曲人竹
谷	人一人寸口
麥	梄一人人儿
衣	言儿
宇	之寸一添寸
雜	言一人梄川
末	一添梄一
潘	添添斤梄曲
告	竹二口一
旁	言一米之言
耐	大目寸言
董	十卜竹曲二
榜	梄一言之言
醉	梄寸言人十
鍾	斤一竹曲二
妹	巛竹二寸梄
鋼	斤一目米目
蔣	十卜巛大寸
幣	目卜添竹目
宜	之寸目三
尼	又竹儿儿
灰	大寸米人
評	言寸一米十
維	巛一川卜
絕	巛一乙寸乙
屋	又竹七二
幾	巛巛巛七人
楚	梄一梄又卜
屆	又竹二一巛
館	人又之寸乙
丹	月添言一
乘	竹梄广卜儿
認	言寸乙言之
刻	言一巛人曲
俊	川添巛人儿
芳	十卜言乙
抄	寸添曲人竹
夾	大寸人寸人
酷	梄寸竹二口
京	言一口一曲
嚴	口一口三竹
返	之一斤寸又
礦	大一广曲人
廳	广大三一之
魯	儿一曲一
瑞	三一目目大
仁	川添二寸
飄	梄口二曲月
註	言寸言添三
添	添添一大米
催	川添目目川
具	目三人一
威	七大一添巛
劇	卜七大月曲
核	梄一言巛人
農	曲曲大七
瓶	米一十卜一
銅	斤一目一口
犯	月竹乙目
族	言乙竹一竹
季	竹梄乙一
尋	又二二口寸
顯	曲一巛米大
骨	目之
嘿	口一目二米
鏈	斤一之一梄
擺	寸添目儿儿
擠	寸添言儿川
黎	竹梄儿人曲
騎	三米大一口
密	之寸之竹目
士	二二
術	人卜梄一言
炸	米人竹一卜
祇	二曲儿七
洪	添添十一人
訊	言寸乙七十
腦	月一巛川人
禮	二曲曲口米
容	之人人寸口
輝	曲人一之梄
射	川三寸言
智	竹大口一曲
索	十寸之之巛
聚	三十又言大
拼	寸添米一十
燕	十一口儿米
撞	寸添言曲二
膜	月一十曲大
普	米一曲米曲
竹	竹言
魏	竹梄巛竹川
澤	添添目二米
乜	乙添巛添
側	川添目人曲
諾	言寸十大口
呂	口一竹添口
范	十卜添添乙
搭	寸添十一口
鳳	月寸一添儿
袁	二一口一儿
扯	寸添卜卜
鑽	斤一竹儿目
彭	二二口米斤
陰	乙口人二巛
唸	口一人又之
薄	十卜添梄寸
涼	添添言口曲
曰	曲一
胃	曲卜月一
鹽	七一竹人目
賴	梄一口儿目
獨	月竹目儿口
窩	之人目口
堆	二一川卜
赴	二人卜寸
載	十寸七竹梄
躲	川三月寸梄
孟	乙一目梄
抵	寸添儿七言
甜	竹卜十二
舉	川二一人二
彩	斤添梄一斤
甚	十三巛添
厄	大大乙目
粗	米梄目三
傑	川添儿十梄
噸	口一一巛大
慶	广又又之儿
緣	巛一巛又大
駐	三米言添三
申	曲梄
衛	人卜又口十
訓	言寸川寸
念	人寸言又之
蕭	十卜又川巛
惹	十卜大口之
帳	目卜三七
勸	十卜口川乙
讚	言寸竹儿目
盒	人寸一口目
逃	之一儿寸添
嘉	二二口乙口
納	巛一目寸人
升	竹添十卜
倉	人寸之竹口
姚	巛竹儿寸添
休	川添梄一
症	广一一添卜
斤	斤寸
功	二卜乙竹
喇	口一梄口曲
釦	斤一口一
浪	添添言添又
扣	寸添口一
泰	三人曲添
忠	口口之巛
梁	添添乙人梄
吸	口一乙添人
貝	目人
跨	口卜大一一
盧	卜七曲卜目
森	梄一梄一梄
瞎	目一之三口
卷	米二乙目
于	一添寸言
井	二寸川寸
針	斤一十寸
蛇	口巛之寸儿
寺	二一寸言
購	目人十目二
導	之一米川寸
飲	人又儿人
噴	口一十十目
虛	卜七斤二
屏	又竹米一十
優	川添一之儿
灌	添添十口川
埋	二一曲卜二
略	曲卜儿卜口
掃	寸添又之目
吶	口一目寸人
目	目一
蒙	十卜之一大
託	言寸竹添七
托	寸添竹添七
巧	二卜一乙
淡	添添米人米
賤	目人七竹七
拜	竹寸一添三
冬	儿卜广寸
娜	巛竹乙二乙
懷	米卜言目曲
池	添添乙卜
敲	言一口卜又
凱	目目一米月
鐘	斤一言曲二
愁	竹梄米人之
鋪	斤一梄二
薩	十卜乙竹竹
揚	寸添曲儿斤
勇	又言月二乙
財	目人寸言竹
鍊	斤一梄一目
終	巛一儿卜广
質	斤寸斤寸目
泥	添添又竹儿
昏	儿七曲一
遇	之一曲目巛
喬	竹添大目口
欄	梄一又梄目
鍋	斤一目口
巨	七添又一
儀	川添米竹七
遲	之一又曲竹
怎	竹一卜寸之
磨	广大梄梄大
呼	口一竹米寸
賭	目人二竹
液	添添言儿言
泉	川曲曲添
嫁	巛竹之寸大
捲	寸添米二乙
汪	添添三一
稍	竹梄曲人月
薛	十卜竹乙言
賈	梄口目人
豆	一添口一米
頓	一添巛曲大
旺	曲一三一
儂	川添曲曲大
攻	二卜竹人
祥	二曲米三
委	竹梄巛竹
佐	川添大寸二
臨	七一竹口口
隔	乙口一米一
繞	巛一二二一
輛	梄曲一人人
崔	目目川卜
溝	添添十目二
碗	大一之儿乙
賠	目人言米口
吻	口一儿乙斤
健	川添乙又二
速	之一梄一口
失	竹二人寸
雄	大寸巛言川
胸	月一儿人巛
框	梄一七添三
鬥	三三
暴	曲一十人曲
湊	添添三一大
陣	乙口梄曲
識	言寸言曲七
娃	巛竹二一二
唯	口一川卜
漏	添添又竹梄
拔	寸添大言又
洛	添添儿卜口
探	寸添之人梄
碟	大一十巛梄
郎	言添又人乙
珠	三一竹一梄
劑	言一米川曲
尿	又竹曲添
透	之一竹乙竹
惠	梄曲之巛
譚	言寸梄曲十
營	米人米口口
府	广大川添寸
菲	十卜曲三
叼	口一乙添一
父	人一人言
耳	三十
殘	一添儿七七
窗	之人川口儿
搜	寸添川卜又
希	人言大寸目
患	口一口口之
尾	又竹竹七
播	寸添斤梄曲
岩	目目大一
逗	之一一口米
廢	广大又乙月
賢	七一又言目
限	乙口又人
帝	言一米之目
昌	曲一曲一
模	梄一十曲大
磚	大一梄曲寸
扁	之竹目寸十
舒	人寸竹又卜
嫌	巛竹米曲人
陶	乙口儿十巛
苗	十卜曲卜
剪	米一月曲乙
羽	乙广乙广
哩	口一曲卜二
稿	竹梄言目口
棟	梄一梄一曲
邦	三卜乙口
撿	寸添人人人
玲	三一人寸之
驚	十卜儿竹三
坑	二一言一月
備	川添十竹月
撥	寸添又乙月
袋	川添七言言
趁	二人人寸斤
妖	巛竹竹添大
甩	月一巛添
錦	斤一川曲目
溼	添添一巛二
琳	三一梄一梄
乙	乙七
伴	川添米二
淺	添添七竹七
尊	米寸梄寸寸
顏	言人大斤大
匯	七添添添川
熬	三卜乙竹米
吊	口一目卜
霜	梄添梄一目
沿	添添月寸口
伯	川添川曲
盜	添添儿人目
浩	添添竹二口
剩	竹梄广儿曲
域	二一七口一
祖	二曲目三
肺	月一一添目
附	乙口川添寸
制	竹二目卜曲
玄	言一巛巛
置	目曲十寸目
豪	言一口之大
恆	米卜二寸儿
助	目三乙竹
濤	添添二口寸
幽	巛巛巛巛目
欣	斤寸儿人
豐	三卜三口米
辣	言十梄一口
煤	米人十二梄
戀	言寸巛巛之
圍	口寸又口十
瓜	斤言
諸	言寸二竹
俾	川添川口十
慧	三卜三又之
墨	目曲二米二
鮮	儿一米三
鏡	斤一言曲儿
娶	三十又言巛
蝦	口巛又又又
犬	大言
鵬	月一月一儿
誠	言寸七大乙
賀	乙竹口一目
險	乙口人人人
飾	人又竹一目
撐	寸添曲口七
炎	米人米人
震	梄添大七
鋒	斤一儿卜三
遂	之一米寸大
斌	言人一七卜
軒	梄曲一十
控	寸添之人二
殼	二二之月月
擋	寸添曲口曲
覆	梄口人曲儿
趟	二人曲目口
禁	梄一梄一二
烤	米人二竹一
盃	大卜目梄
童	言米曲卜二
蟲	口巛口巛口
徵	人卜目三竹
靚	三卜月一目
杯	梄一大卜
暨	又人七曲一
晴	曲一三卜月
魂	二寸巛言川
益	米一人一目
庭	广大乙竹二
肝	月一一十
濃	添添曲曲大
坊	二一言乙
晨	曲一大七
紀	巛一乙乙
振	寸添大七
塵	广又二一
割	之寸三口曲
敗	目人竹人
消	添添曲人月
兆	儿寸添添
楓	梄一月卜
隆	乙口儿一竹
撤	寸添言月竹
粥	乙巛米梄乙
馨	二二又竹曲
誤	言寸口一大
滑	添添目之
噠	口一之二米
曼	曲一目曲又
暖	曲一斤大又
滬	添添之口乙
己	乙乙
止	卜卜
柱	梄一言添三
塗	添添人竹二
妻	一添又大巛
灣	添添言巛乙
盾	斤寸十寸目
奔	大寸十寸十
潤	添添又寸三
政	一添卜卜竹
爹	人一人儿儿
尹	又大
廖	广大乙人斤
刺	梄一目寸曲
冠	之之一一寸
躺	川三曲目口
舍	人寸竹卜
鑫	斤一斤一斤
蓮	十卜之一梄
售	川卜口一
獸	口一口口大
婚	巛竹儿七曲
攝	寸添三三三
醫	七添竹月梄
閣	又寸儿卜口
妞	巛竹又二卜
邱	斤二乙口
兔	儿添口儿言
敬	十卜儿口竹
潮	添添十十月
昂	曲一川一乙
飽	人又儿乙乙
咳	口一言巛人
邪	七卜乙口
促	川添口卜
鼠	川二巛寸
葛	十卜曲人巛
串	口一口口
桑	又言又又梄
續	巛一二目目
苑	十卜儿言乙
迎	之一川一乙
弓	乙巛
碎	大一言人十
余	人寸竹梄
承	又添曲添三
迪	之一曲二
膠	月一乙人斤
烏	儿川
牠	竹二乙卜
臣	七一
勤	十一口三乙
摔	寸添言添十
撈	寸添米寸乙
蒸	十卜又一米
凌	广寸二人儿
辛	言十
旗	言乙竹一十
妙	巛竹曲人竹
始	巛竹巛言口
符	竹言川添寸
倫	川添人目十
鋁	斤一口一口
亭	言一口之一
吼	口一乙一巛
云	二寸巛言
研	大一一添十
咪	口一米梄
俗	川添人人口
爺	人一人三乙
啓	之竹竹人口
霧	梄添又儿乙
珍	三一人寸斤
卓	卜寸曲一十
韋	又口口一十
歡	十卜口川儿
嗨	口一添竹巛
積	竹梄三卜目
擡	寸添二之七
捧	寸添三人二
鳴	口一儿巛
舔	竹卜一大米
贊	竹二儿儿目
喃	口一十目米
簡	竹言又寸曲
豔	三卜三巛目
愈	人寸一曲之
溪	添添斤巛大
罰	目曲言寸曲
歪	大卜一添卜
晃	曲一曲人一
斜	人寸竹广十
預	又言又卜大
鄒	儿乙巛巛乙
崗	目目目米目
尤	大儿
洲	添添添寸川
乎	竹添米寸寸
湘	添添梄一目
罷	目曲巛儿儿
軸	梄曲曲二
妳	巛竹儿添曲
翔	米三乙广乙
異	曲卜十一人
隱	乙口斤又之
枝	梄一十寸又
逸	之一儿儿言
哄	口一十一人
餐	卜寸儿又人
顆	曲卜梄一大
鴨	曲乙儿巛
染	添添月乙梄
餅	人又米一十
粘	米梄卜寸口
藝	十卜二二巛
炮	米人儿乙乙
桌	卜寸曲一梄
芬	十卜人一乙
鴻	添添二卜儿
攜	寸添目人口
腎	七一又言月
撲	寸添曲米米
萍	十卜添米十
晶	曲一曲一曲
勾	儿乙巛言
戒	七竹十卜
桂	梄一二一二
朗	言添又人月
堵	二一二竹
矣	巛言竹大
捐	寸添口一月
彎	言寸巛巛乙
薑	十卜三曲曲
荷	十卜川一口
畝	言一曲儿言
棉	梄一川曲目
私	竹梄巛言
擊	梄曲巛月竹
姜	米三巛竹
貸	川添七言目
嗲	口一人儿儿
傾	川添儿儿大
鼓	二二口十又
霞	梄添又又又
瞧	目一川卜米
皇	川曲三一
企	人寸卜卜
互	一添巛又
沉	添添之之月
箭	竹言米月曲
柏	梄一川曲
騰	月一米二三
焦	川卜米言
憋	目卜添竹之
潔	添添三乙巛
盟	曲一月一目
延	乙言竹添卜
柔	又言又川梄
資	广寸儿人目
粒	米梄言米
嶺	目目人之大
盆	人一乙寸目
檢	梄一人人人
護	言寸十川又
眉	又竹目一
傘	人寸人人十
碧	三一川曲大
籍	竹言三十曲
燙	添添曲斤米
瑪	三一三米
刮	竹卜曲寸
勿	儿乙斤三
坤	二一曲梄
汁	添添十寸
冊	目寸十卜
銘	斤一儿言口
浴	添添人人口
翼	乙广乙十人
哲	寸添斤寸口
涵	添添又曲巛
鈣	斤一一卜巛
菌	十卜口寸竹
敵	言一米口竹
桶	梄一又言月
抹	寸添一添梄
判	米二曲寸
寵	之寸言卜
紋	巛一言人
弟	米寸乙巛川
傅	川添梄二寸
衰	言儿曲一
譯	言寸目二米
柯	梄一一卜口
叔	卜一曲人又
肩	之竹月一
殿	又竹十人月
番	斤梄曲卜
驢	三米卜曲目
怡	米卜巛言口
旭	月乙曲一
訪	言寸言乙
勢	二一人月乙
蒐	十卜川口
航	斤乙言一月
妮	巛竹又竹儿
萊	十卜梄人人
坡	二一又卜
兇	人言巛卜儿
旅	言乙竹一儿
鷹	广大川川儿
赤	二一米人
技	寸添十寸又
韻	言米曲口目
摘	寸添言十口
翠	乙广乙人十
邁	之一十目巛
孝	二竹乙一
移	竹梄儿言儿
搖	寸添儿十巛
畢	曲乙十卜二
予	又言又添卜
岳	斤二目目
屎	又竹米梄
融	一添口一口
棋	梄一十三
勞	米人米之乙
採	寸添斤添梄
鈕	斤一又二卜
扶	寸添二言
介	人寸川寸
渡	添添广十又
芯	十卜之巛
奪	大寸川卜寸
采	斤添梄一
乳	斤添乙一巛
拳	米二竹寸
浜	添添斤二人
齣	卜人儿乙口
錫	斤一曲儿斤
薇	十卜人月竹
淫	添添斤竹二
拽	寸添曲梄竹
職	三十言曲七
宅	之寸竹添七
掌	曲人之口竹
培	二一言米口
莉	十卜竹梄曲
損	寸添口一目
櫃	梄一七一目
盼	目一人一乙
握	寸添又竹七
謀	言寸十二梄
廟	广大十十月
截	十寸七竹川
酶	梄寸竹一巛
孤	乙一斤言
壯	巛大二二
邵	乙寸口一乙
墊	二一米月二
規	二言目儿
頗	又卜大人
什	川添十寸
宣	之寸二寸曲
妍	巛竹一添十
尖	曲人大寸
討	言寸寸言
醋	梄寸十一曲
朵	月寸梄一
膽	月一儿人言
穆	竹梄川曲斤
姬	巛竹七一
龜	竹添之又
啃	口一卜卜月
漸	添添梄曲斤
耗	三卜梄一竹
息	川目之巛
伍	川添二卜又
塘	二一广又口
壽	二二又口寸
逢	之一儿卜三
闖	又寸三米
晉	二寸巛巛曲
桃	梄一儿寸添
壁	又竹口言二
霍	梄添川卜
爐	米人卜曲目
漆	添添梄人曲
暫	梄曲斤寸曲
虹	口巛二卜
丸	月口
券	米二乙寸
獃	目目一米大
辭	斤添又又言
縫	巛一之儿三
俱	川添目三人
菊	十卜儿乙米
奴	巛竹又言
岸	目目大大一
凝	广寸儿又卜
膩	月一七二目
芝	十卜之一
兮	人一一乙
脈	月一斤寸儿
嚐	口一曲儿曲
烈	一添儿曲米
矮	竹大竹梄巛
貪	人寸言又目
婆	添添又卜巛
俞	人寸一月曲
蝶	口巛十巛梄
誇	言寸大一一
枕	梄一之之儿
毀	川二二一月
避	之一又口言
郝	二一米人乙
帕	目卜川曲
綁	巛一三卜乙
悅	米卜人口儿
浮	添添斤添乙
盈	乙添竹又目
枚	梄一竹人
材	梄一寸言竹
賞	曲人之口目
扎	寸添巛添
翁	人一巛乙乙
幻	巛巛乙添
衫	之广斤三
杆	梄一一十
固	口寸十寸口
耀	曲人一乙川
槽	梄一一曲曲
穴	之人
獻	卜七一一大
幅	目卜一口曲
審	之寸斤梄曲
斬	梄曲斤寸
伸	川添曲梄
悲	曲三之巛
殷	斤寸又乙月
茲	十卜巛巛巛
穎	儿儿竹梄大
萌	十卜曲一月
斑	三一言人三
澡	添添口口梄
牽	言一巛之竹
屈	又竹巛曲巛
娟	巛竹口一月
怨	儿言乙目之
癢	广一米言又
恐	二卜月言之
凍	广寸梄一曲
複	之广竹曲儿
柴	卜卜儿儿梄
逆	之一米一巛
僞	川添斤米
騷	三米又言口
渣	添添梄曲一
熙	七一乙二米
抖	寸添广寸十
忽	儿乙斤三之
津	添添又大二
胎	月一巛言口
糧	米梄曲曲二
濟	添添言儿川
參	巛言巛人斤
譜	言寸米曲曲
准	广寸川卜
褲	之广广大梄
紮	梄一巛添巛
摩	广大梄梄竹
縮	巛一之一川
漫	添添曲目又
溜	添添儿乙曲
彥	言人大大斤
棄	言一巛十梄
扇	之竹乙广乙
婷	巛竹言之一
菸	十卜言人广
脣	大七月一
憂	一添川之儿
堡	川添口梄二
淘	添添儿十巛
墓	十卜曲大二
鹿	广又
攢	寸添竹儿目
嬌	巛竹竹目口
遞	之一斤寸卜
彬	梄一梄一斤
蹭	口卜米目曲
卿	竹添巛又乙
琪	三一十三
鶴	之之川卜儿
函	又添曲添巛
確	大一之之川
郡	又大口一乙
奈	大寸二曲
茂	十卜七大
緩	巛一斤大又
協	十寸乙乙乙
瓊	三一儿目儿
髒	目之十儿十
債	川添三卜目
肌	月一月寸
薰	十卜竹二米
映	曲一目寸大
粵	川口斤梄一
鼻	川目曲一川
泵	大一曲添
銷	斤一曲人月
育	言一巛言月
澳	添添川米大
陞	乙口竹十二
候	川添卜又竹
堅	七一又言二
种	竹梄口口
邀	之一川言竹
閉	又寸寸言竹
妝	巛大巛竹
噻	口一之人二
佩	川添月一目
決	添添又添大
適	之一言十口
策	竹言梄一目
藤	十卜月米曲
仿	川添言乙
磊	大一大一大
雁	大大川添川
俠	川添大人人
腸	月一曲儿斤
窄	之人竹一卜
昨	曲一竹一卜
倪	川添川二儿
務	又言又儿乙
雯	梄添言人
戈	七竹
爪	斤添
癌	广一口口目
效	言一人人竹
拷	寸添二竹一
猴	月竹川又竹
掏	寸添儿十巛
汝	添添巛竹
撮	寸添曲三又
幸	二一米二
揉	寸添又川梄
醬	巛大儿寸梄
舟	斤乙
訴	言寸斤寸言
態	巛言月儿之
盯	目一一卜
繡	巛一又川巛
蜜	之寸之竹口
漂	添添梄口二
序	广大又又卜
巷	十一人一乙
梨	竹梄曲寸梄
舌	竹卜
蒂	十卜言之目
腹	月一竹曲儿
蟹	儿添月竹口
陷	乙口儿添川
捉	寸添口卜
蒼	十卜人之口
鵝	竹寸七竹儿
疑	儿儿竹又卜
鼎	目一巛大川
釣	斤一儿乙言
慌	米卜十言川
蔥	十卜川儿之
瘤	广一儿乙曲
彼	人卜又卜
辰	大七
執	二一米二月
忌	乙乙之巛
踏	口卜曲添曲
龔	言卜十一人
捷	寸添一又卜
罐	竹一十口川
腫	月一竹曲二
縱	巛一人人卜
伏	川添大言
壇	二一言曲一
觸	儿添月儿口
默	目曲二米大
懸	目三曲巛之
赫	二一米二米
瑩	米人米之三
杰	梄一米言
孩	乙一言巛人
咖	口一乙竹口
幀	目卜卜寸目
悟	米卜二又口
頻	卜卜曲人大
灑	添添一言广
燉	米人言乙竹
帽	目卜曲一目
幼	巛巛乙竹
旋	言乙竹又卜
擁	寸添言巛川
聶	三十三十三
猶	月竹米寸梄
壹	二二之口米
霸	梄添十十月
席	广大十一目
叉	又言言添
繫	梄曲巛月巛
妃	巛竹乙乙
擔	寸添儿人言
典	目寸十一人
贈	目人米目曲
儒	川添梄添大
裸	之广曲卜梄
奉	三人二卜
叻	口一乙竹
御	人卜竹卜乙
腔	月一之人二
突	之人大言
刑	一添十卜曲
痕	广一又人
賓	之寸一曲目
纔	巛一儿儿言
午	竹一十寸
攤	寸添十二川
蕾	十卜梄添曲
頸	一添巛二大
臟	月一十七七
宰	之寸言十
囊	一添口十儿
賬	目人三七
弘	乙巛巛言
境	二一言曲儿
拒	寸添七添又
毅	言米大月月
煎	米一月曲米
弦	乙巛言一巛
渝	添添人月曲
罩	目曲卜曲十
蓉	十卜之人口
憶	米卜言曲之
卵	儿竹言添言
遷	之一梄大乙
尺	又竹言添
禍	二曲目口
逾	之一人月曲
垂	竹十十卜二
潛	添添七儿曲
郵	竹十十二乙
惜	米卜十一曲
浦	添添梄二
警	十卜儿竹言
扛	寸添二卜
氧	竹乙米三
揭	寸添曲人巛
逐	之一大月
謂	言寸曲卜月
昭	曲一乙寸口
宿	之寸川一川
統	巛一言巛儿
裂	一添儿曲言
僧	川添米目曲
慣	米卜巛乙目
裙	之广又大口
彪	卜七斤三
淋	添添梄一梄
束	梄一口一
牢	之寸竹二
齋	言一米川曲
揍	寸添三一大
仕	川添二二
鉤	斤一儿乙口
劫	二一巛言乙
拓	寸添大一
扮	寸添人一乙
疊	曲卜曲之目
鋅	斤一言十
喻	口一人月曲
律	人卜又大二
株	梄一竹一梄
砂	大一曲人竹
埃	二一巛言竹
斗	广寸十寸
坪	二一一米十
揮	寸添之之梄
箇	竹言口十口
仇	川添月乙
吞	一添大寸口
亡	言七
沾	添添卜寸口
遙	之一儿十巛
壺	二二之之二
牧	竹二竹人
霖	梄添梄一梄
兜	川曲儿又儿
寨	之寸十人梄
掐	寸添儿添川
監	七一竹言目
稀	竹梄人大目
恰	米卜人一口
牴	竹二儿七言
棍	梄一曲儿儿
啵	口一添添又
朕	月一米一大
淑	添添卜曲又
饒	人又二二一
慕	十卜曲大米
歇	曲一儿巛儿
疏	又添卜巛川
膏	言一口口月
陵	乙口二人儿
壩	二一梄十月
纏	巛一广人二
鹹	卜寸口一口
姆	巛竹巛乙
聰	三十川儿之
捱	寸添大二二
碳	大一目大米
銳	斤一人口儿
驗	三米人人人
齒	卜人
廷	乙言竹添二
糊	米梄十口月
翹	二一二乙乙
儲	川添言寸二
楠	梄一十目米
顛	十寸目人大
蚊	口巛言人
祭	儿言又言二
龐	广大言卜
嘞	口一十十乙
拾	寸添人一口
裴	曲三言儿
朋	月一月一
媚	巛竹又竹目
芸	十卜二寸巛
吟	口一人言又
筒	竹言目一口
丘	斤二
責	三卜目人
趴	口卜人一
堯	二一二二一
繁	竹一巛竹巛
坦	二一曲一一
穗	竹梄梄曲之
紗	巛一曲人竹
屯	一添巛曲
虐	卜七七添一
蹲	口卜米梄寸
紹	巛一乙寸口
惟	米卜川卜
幕	十卜曲大目
澆	添添二二一
扒	寸添人一
搓	寸添米三二
遮	之一广十米
庚	广大又二人
哉	十寸七竹口
涉	添添卜卜曲
忒	七言之巛
賦	目人一七卜
臂	又竹口言月
樁	梄一三人川
敷	梄二言乙竹
禪	二曲口曲一
佬	川添二竹儿
瑤	三一儿十巛
習	乙广乙广川
臥	七一人寸
釘	斤一一卜
阮	乙口一添一
丙	一添目寸人
歷	大大竹竹卜
躍	口卜乙乙川
署	目曲二竹
範	竹言梄曲乙
示	二曲
邢	一添十卜乙
擰	寸添之目一
莎	十卜添曲竹
糞	米梄曲十人
嵐	目目月卜
濱	添添之曲目
夕	儿言
苯	十卜梄一一
議	言寸米竹七
趣	二人三十又
渠	添添七又梄
閱	又寸人口儿
繩	巛一之又
杭	梄一言一月
疾	广一竹大
崇	目目之寸二
擴	寸添广曲人
傢	川添之寸大
婦	巛竹又之目
涅	添添曲一二
裕	之广人人口
嘆	口一十口二
艦	斤乙七竹目
挪	寸添乙二乙
荒	十卜言七川
貞	卜寸目人
筋	竹言月一乙
孕	乙添竹添乙
撕	寸添十三斤
鈴	斤一人寸之
戳	乙广乙川七
帆	目卜月言
籌	竹言二口寸
奎	大寸二一二
駕	乙竹口一三
阻	乙口目三
享	言一口一乙
棚	梄一月一月
傲	川添三乙竹
欽	斤一儿人
蹦	口卜目月月
焊	米人曲一一
召	乙寸口一
徒	人卜二人
脂	月一儿儿曲
几	月寸
趨	二人儿儿巛
艘	斤乙川卜又
喵	口一十卜曲
競	言米口口儿
靖	言米三卜月
奏	三人一添大
咒	口一口一月
釋	斤梄目二米
盲	言七目一
姿	广寸儿人巛
炫	米人言一巛
賜	目人曲儿斤
湧	添添又月乙
潑	添添又乙月
坎	二一儿人
琦	三一大一口
拌	寸添米二
樊	梄一人梄大
缸	竹一十巛二
弗	乙巛川寸
狐	月竹斤言
漿	巛大儿寸曲
栽	十寸七竹梄
閻	又寸儿添川
攪	寸添川人目
硅	大一二一二
述	之一梄一言
籠	竹言言卜
泛	添添竹添之
甫	梄二
佑	川添大寸口
鮑	儿一儿乙乙
閥	又寸川添七
卦	二一二一卜
耿	三十米人
咽	口一口寸大
倩	川添三卜月
袖	之广曲二
貧	人一乙寸目
糟	米梄一曲曲
激	添添川言竹
階	乙口儿儿川
珊	三一月月一
潭	添添梄曲十
蠢	三人口巛口
植	梄一十寸目
占	卜寸口一
嘯	口一又川巛
徑	人卜一巛二
鉛	斤一月寸口
屍	又竹一儿儿
倚	川添大一口
灘	添添十二川
姨	巛竹大寸乙
災	巛寸米人
幢	目卜言曲二
鈉	斤一目寸人
暢	曲梄曲儿斤
詠	言寸言添曲
齡	卜人人寸之
焉	一添卜巛米
茹	十卜巛竹口
桐	梄一目一口
痰	广一米人米
捂	寸添二又口
鄰	米梄儿十乙
癡	广一儿又卜
揀	寸添梄一目
艙	斤乙人之口
謙	言寸米曲人
万	一添乙竹
織	巛一言曲七
蒲	十卜添添梄
芽	十卜七卜
佈	川添大寸目
驅	三米七口口
昊	曲一一添大
轟	梄曲梄曲梄
攔	寸添又梄目
碑	大一川口十
嚼	口一斤又寸
燃	米人儿大米
摟	寸添曲口巛
輔	梄曲梄二
暉	曲一之之梄
朴	梄一卜寸
碩	大一大人
煲	川添口梄米
杖	梄一一添人
謎	言寸之一米
磷	大一米儿十
竄	之人川二巛
脆	月一儿大乙
刃	乙寸言添
墜	乙口米大二
姑	巛竹十寸口
衡	人卜儿曲大
皺	儿乙巛巛又
繳	巛一川言竹
擇	寸添目二米
櫻	梄一目目巛
鹼	卜寸口人人
窯	之人米三米
措	寸添十一曲
眠	目一乙二七
途	之一人寸竹
鄂	口一口一乙
捅	寸添又言月
叢	曲米米三又
禾	竹梄
磁	大一米巛巛
錶	斤一三卜儿
沃	添添竹添大
屢	又竹曲口巛
辯	言十言寸言
肚	月一二一
哀	言儿口一
浸	添添又之又
柄	梄一一目人
跪	口卜儿大乙
攬	寸添七目目
輯	梄曲口一三
瓷	广寸儿人一
澀	添添乙卜卜
踹	口卜目目大
凸	口寸目寸
瑜	三一人月曲
磅	大一言之言
豈	目目一口米
瀉	添添之儿米
遼	之一一曲曲
豎	七一又口米
宴	之寸曲一巛
堪	二一十三巛
擱	寸添又儿口
麟	广又米儿十
祿	二曲巛又曲
翟	乙广乙广川
仗	川添一添人
崩	目目月一月
醜	梄寸川口
厲	大大十目巛
革	十十
莪	十卜竹寸七
憲	之寸三目之
遺	之一口一目
聘	三十曲二一
喚	口一儿人大
閘	又寸曲乙
刊	一十曲寸
裁	十寸七竹言
郁	大寸月一乙
逝	之一寸添斤
際	乙口儿又二
狄	月竹米人
誌	言寸二二之
塌	二一曲乙乙
崖	目目大二二
廉	广大米曲人
婉	巛竹之儿乙
攀	梄一人大竹
獅	月竹竹一目
喘	口一目目大
氫	竹乙一巛二
氮	竹乙米人米
鞍	十十之寸巛
竈	之人二一之
竇	之人二目目
墳	二一十十目
巫	二卜人寸人
虞	卜七口一大
沁	添添之巛
瑟	三一三之竹
揪	寸添竹梄米
棵	梄一曲卜梄
閆	又寸三寸
拐	寸添口一乙
築	竹言二月梄
癮	广一乙又之
剝	巛又曲添曲
披	寸添又卜
削	曲人月一曲
籃	竹言七竹目
悠	川添卜竹之
睿	卜寸之人目
甯	之寸之巛月
凹	口寸巛卜
葬	十卜一儿十
咦	口一大寸乙
瞪	目一又口米
詹	儿添大人言
侃	川添口一川
授	寸添斤之又
卸	竹二卜卜乙
頌	人一巛言大
慈	米一巛巛之
闊	又寸添添竹
纖	巛一人曲一
棗	梄一目梄目
瞄	目一十卜曲
婭	巛竹二巛
駱	三米儿卜口
馳	三米乙卜
鞭	十十川曲人
楞	梄一目曲言
兌	人一口一儿
危	儿添大大乙
襲	言卜言儿
泊	添添川曲
喉	口一川又竹
溶	添添之人口
撫	寸添竹十米
媛	巛竹斤大又
拎	寸添人寸之
察	之寸儿又二
駿	三米巛人儿
繪	巛一人目曲
黴	人卜目米竹
鈞	斤一儿乙广
憐	米卜米儿十
昆	曲一儿儿儿
禹	竹添口目巛
娥	巛竹竹寸七
醇	梄寸言口乙
橙	梄一又口米
辨	言十曲寸言
暮	十卜曲大曲
祕	二曲之巛竹
薪	十卜言梄斤
煥	米人儿人大
巢	巛寸曲卜梄
鉀	斤一曲乙
脾	月一川口十
淵	添添川又巛
愚	曲一目巛之
蜀	目曲儿乙口
裹	言儿曲卜梄
藕	十卜三目巛
滕	月一米二曲
劈	又竹口言乙
堤	二一曲一卜
拱	寸添十一人
夸	大寸一添一
傍	川添言之言
燥	米人口口梄
綫	巛一七竹七
漁	添添儿一
茜	十卜梄口
允	巛言儿寸
杏	梄一口一
芒	十卜言七
畔	曲卜米二
豹	斤月儿乙言
澄	添添又口米
冥	之之曲言人
媒	巛竹十二梄
燦	米人卜又米
酥	梄寸竹梄
垮	二一大一一
枯	梄一十寸口
軌	梄曲月乙
塑	米一巛月二
卜	卜寸
構	梄一十目二
茅	十卜又又川
鉅	斤一七添又
慾	人一人儿之
搏	寸添梄二寸
鑄	斤一二口寸
沐	添添梄一
豫	又言又口大
蒜	十卜二曲二
淩	添添二人儿
雀	曲人川卜
鈦	斤一大寸言
亨	言一口一又
詳	言寸米三
腐	广大川人人
皓	川曲竹二口
央	目寸大寸
氟	竹乙乙巛川
冤	之之儿儿言
据	寸添又十口
浙	添添寸添斤
瑋	三一又口十
栓	梄一人寸三
梳	梄一言巛川
冀	广卜儿十人
叄	巛言巛人三
輩	曲三梄曲
筱	竹言川卜竹
冉	目寸二一
餡	人又儿添川
彤	月添言一斤
奕	言曲大寸
卑	川口十寸
誓	寸添斤寸言
蜂	口巛儿卜三
勺	儿乙言添
迅	之一乙七十
虫	口巛
恥	三十之巛
匹	七添儿寸
曦	曲一米七一
仰	川添川一乙
煞	儿添又竹米
羞	米三又二卜
注	添添言添三
嫂	巛竹川卜又
瞳	目一言曲二
黛	川添七二米
妾	言米巛竹
拂	寸添乙巛川
挨	寸添巛言竹
泄	添添十一巛
綱	巛一目米目
茨	十卜广寸儿
夷	大寸乙巛
慎	米卜十目人
汽	添添竹乙
婕	巛竹一又卜
恭	十一人一米
弊	目卜添竹十
屌	又竹口一目
摳	寸添七口口
貳	七言二寸目
旦	曲一一添
涂	添添人寸竹
氯	竹乙又二曲
祁	二曲乙口
蠟	口巛巛人巛
乍	竹一卜寸
孰	言一口乙月
耕	三卜梄二川
飆	大言大大月
稻	竹梄斤添川
屠	又竹二竹
綺	巛一大一口
荊	十卜一十曲
桿	梄一曲一一
笛	竹言曲二
捕	寸添梄二
蕊	十卜之之之
喪	二一口口儿
盪	添添曲斤目
氨	竹乙之寸巛
愣	米卜目曲言
幺	巛巛
瀾	添添又梄目
悔	米卜竹一巛
敦	言一口乙竹
葵	十卜又一大
煒	米人又口十
磕	大一二巛目
顫	言一口一大
閩	又寸口巛
渴	添添曲人巛
曝	曲一曲人曲
閔	又寸言人
撇	寸添目添竹
梗	梄一一曲人
絡	巛一儿卜口
貫	巛乙目人
蔚	十卜又二寸
翅	十寸又乙乙
估	川添十寸口
鎂	斤一米三大
復	人卜竹曲儿
瓣	言十斤言言
濫	添添七竹目
況	添添口一儿
淮	添添川卜
陀	乙口之寸儿
莖	十卜一巛二
勳	竹十目米乙
惑	七竹口一之
簾	竹言广曲人
巡	之一巛寸
墩	二一言乙竹
徽	人卜目巛竹
謹	言寸十口三
脹	月一三七
噓	口一卜七斤
瞞	目一十人人
娛	巛竹口巛大
蓄	十卜言巛曲
梓	梄一言十
匪	七添曲三
昕	曲一斤寸
濺	添添目七七
敘	人寸竹梄竹
鑑	斤一七竹目
溢	添添米人目
彌	乙巛一人人
覓	斤添目儿
寇	之寸一卜又
佟	川添儿卜广
獵	月竹巛人巛
滄	添添人之口
葷	十卜之之梄
蓬	十卜之儿三
薦	十卜广巛米
硫	大一言巛川
俏	川添曲人月
迫	之一川曲
貌	斤月川曲儿
弔	乙巛卜添
舜	斤添之儿十
炳	米人一目人
茄	十卜乙竹口
頤	七一大人
訣	言寸又添大
廚	广大二米寸
炭	目目大寸米
綿	巛一川曲目
搗	寸添儿巛目
萱	十卜之二曲
岡	目寸米一目
挂	寸添二一二
掀	寸添斤寸儿
誘	言寸竹乙竹
翰	十寸曲乙乙
睜	目一斤添又
撓	寸添二二一
掩	寸添大寸曲
蹬	口卜又口米
泳	添添言添曲
玫	三一竹人
椅	梄一大一口
鈺	斤一三一言
遜	之一乙竹巛
甄	梄口二一一
侍	川添二一寸
抑	寸添川一乙
啞	口一二巛
敖	三卜乙竹竹
酮	梄寸目一口
毫	言一口之竹
侵	川添又之又
妥	斤添巛竹
覽	七一竹目目
概	梄一又七儿
貢	二卜目人
呦	口一巛巛乙
援	寸添斤大又
昔	十一曲一
晾	曲一言口曲
逮	之一又大添
卒	言一人人十
鬆	三七斤人巛
捆	寸添口寸梄
厭	大大曲月大
峽	目目大人人
彷	人卜言乙
寢	之寸巛之又
菱	十卜二人儿
梯	梄一米乙川
僑	川添竹目口
籽	米梄乙一
腕	月一之儿乙
挫	寸添人人二
膝	月一梄人曲
嗦	口一十之巛
璇	三一言又卜
眨	目一竹添之
循	人卜斤十目
臀	又竹十月月
矛	又言又添川
努	巛竹又言乙
黔	目曲二言又
乏	竹添之一
魅	川口二寸梄
徹	人卜言月竹
凶	人言巛卜
胺	月一之寸巛
廈	广大一川儿
掘	寸添又巛巛
茗	十卜儿言口
絨	巛一七竹大
璐	三一口儿口
擾	寸添一之儿
襯	之广言梄目
雌	卜卜儿儿川
旱	曲一一十
掰	竹寸人乙竹
伽	川添乙竹口
蛙	口巛二一二
雕	月添二口川
嬰	目人目人巛
痣	广一二二之
譽	川二一人言
跡	口卜言曲
廂	广大梄一目
汀	添添一卜
隋	乙口大二月
緒	巛一二竹
蘊	十卜巛人目
勻	儿乙二寸
祛	二曲二一巛
芙	十卜二言
棲	梄一一又巛
刁	乙添一添
瑛	三一十目大
禽	人寸言目巛
腺	月一川曲曲
迦	之一乙竹口
矯	竹大竹目口
欺	十三儿人
杉	梄一斤三
党	曲人之口儿
竅	之人川言竹
鑲	斤一言口十
緯	巛一又口十
曏	曲一巛又乙
繆	巛一乙人斤
玖	三一儿添言
肆	三七又大二
悉	斤梄之巛
掂	寸添广卜口
菁	十卜三卜月
鎳	斤一川目梄
冶	广寸巛言口
絆	巛一米二
嘔	口一七口口
遣	之一口一乙
岑	目目人言又
皖	川曲之一一
糕	米梄米三米
斐	曲三言人
閤	又寸人一口
釀	梄寸言口十
彙	巛又之曲梄
址	二一卜卜
蘸	十卜梄川米
茵	十卜口寸大
簿	竹言添梄寸
旬	儿乙曲一
丈	一添人言
咸	七大一添口
呸	口一大卜一
胤	儿寸巛巛月
摻	寸添巛人斤
蹤	口卜人人卜
婁	曲口巛竹
鎚	斤一之竹乙
桓	梄一二寸曲
碘	大一目十人
瞅	目一竹梄米
廊	广大言又乙
焰	米人儿添川
壘	曲卜曲曲二
燁	米人十十二
淳	添添言口乙
畏	曲卜一添儿
屑	又竹曲人月
酯	梄寸儿儿曲
覃	梄口曲一十
嵌	目目十二儿
販	目人斤寸又
泣	添添言米
嗆	口一人之口
眾	目曲大川
袍	之广儿乙乙
菴	十卜大寸曲
僵	川添三曲曲
饞	人又儿儿言
沫	添添一添梄
滯	添添十之目
臻	七二三人竹
眺	目一儿寸添
寂	之寸卜曲又
醣	梄寸广又口
晏	曲一之寸巛
秤	竹梄一米十
嗚	口一儿川
蘿	十卜目巛川
誅	言寸竹一梄
瑾	三一十口三
藻	十卜添口梄
螺	口巛曲卜巛
錠	斤一之一卜
診	言寸人寸斤
恤	米卜竹添目
污	添添一添一
涯	添添大二二
滋	添添米巛巛
蘆	十卜卜曲目
嗜	口一二儿曲
貿	儿七乙寸目
療	广一一曲曲
滲	添添巛人斤
瀝	添添大竹卜
陡	乙口二人
栗	梄口梄一
筍	竹言儿乙曲
朔	米一巛曲月
淇	添添十三
捻	寸添人又之
勃	十寸之乙乙
矩	竹大七添又
沽	添添十寸口
淤	添添言人广
描	寸添十卜曲
膚	卜七曲卜月
契	三卜乙寸大
靳	十十斤寸
祠	二曲乙一口
陝	乙口大人人
鞏	二卜月言十
峻	目目巛人儿
稠	竹梄月二口
爵	斤添目又寸
秉	竹梄又二
刨	儿乙乙二曲
雍	言一巛人川
群	又大口一米
麵	梄一人口目
盞	七竹七竹目
役	人卜月又
烙	米人儿卜口
灾	之寸米人
强	乙巛口一口
痘	广一一口米
髓	目之之二月
嫣	巛竹一巛米
募	十卜曲大乙
苟	十卜儿乙口
析	梄一斤寸
篩	竹言竹一目
魁	川口广寸十
斥	斤寸言添
棕	梄一之寸二
匡	七添三一
倦	川添米二乙
疆	乙巛二曲曲
蔓	十卜曲目又
樺	梄一十十二
牟	巛言竹二
芷	十卜卜卜
霆	梄添乙竹二
蠶	七寸儿口口
嘰	口一巛七人
靴	十十川添儿
慮	卜七曲卜之
眸	目一巛言竹
烟	米人口寸大
惱	米卜巛川人
巾	目卜
殊	一添儿竹梄
叮	口一一卜
晟	曲一七大乙
艇	斤乙乙竹二
熔	米人之人口
裘	一添曲言言
芹	十卜斤寸
儘	川添又米目
寡	之寸大人乙
擲	寸添米大乙
蔔	十卜儿口曲
硪	大一竹寸七
迥	之一目寸口
巖	目目口三竹
瞬	目一斤儿十
邑	口一乙曲
〇	口一
鉻	斤一儿卜口
榕	梄一之人口
庸	广大又大月
渾	添添之之梄
棠	曲人之口梄
仨	川添三寸
祺	二曲十三
紡	巛一言乙
蝕	人又口巛
窺	之人二言目
埠	二一竹乙十
酚	梄寸人一乙
奮	大寸川卜曲
剎	人言梄言曲
濁	添添目儿口
茬	十卜大卜二
濾	添添卜曲之
珂	三一一卜口
嗅	口一川目大
簫	竹言又川巛
佰	川添一添川
滇	添添十目人
寅	之寸一曲人
婧	巛竹三卜月
姦	巛竹巛竹巛
梵	梄一梄一月
蛾	口巛竹寸七
慰	又竹二寸之
履	又竹人曲儿
駛	三米口一人
宛	之寸儿言乙
襪	之广十七言
嫖	巛竹梄口二
綸	巛一人目十
礙	大一儿又卜
肽	月一大寸言
獄	月竹言寸大
闢	又寸又口言
歎	十一口二儿
蟬	口巛口曲一
涮	添添又目曲
督	卜一曲又目
衍	人卜添添
違	之一又口十
絞	巛一言人人
廿	十一
摁	寸添口大之
劣	曲人竹添乙
銜	人卜斤一
祈	二曲斤寸
搵	寸添口人目
尅	十寸口儿寸
貶	目人竹添之
魄	川曲川口
崽	目目曲卜之
斧	人一人言斤
裔	言儿目人口
湛	添添十三巛
琛	三一之人梄
淌	添添曲目口
簇	竹言言竹竹
償	川添曲口目
沛	添添一添目
澗	添添又寸曲
殤	一添儿儿斤
掠	寸添言口曲
崎	目目大一口
贛	言米曲二目
蕩	十卜添儿斤
菇	十卜巛十口
砌	大一七寸乙
眯	目一米梄
闌	又寸梄一目
嬲	曲卜乙曲乙
辱	大七寸言
匠	七添斤寸
肘	月一寸言
淹	添添大寸曲
洽	添添人一口
溟	添添之言人
諗	言寸人又之
究	之人月乙
慼	七大卜曲之
矢	竹大
蟻	口巛米竹七
澈	添添言月竹
葦	十卜又口十
瞥	目卜添竹目
崑	目目曲儿儿
墮	乙口大月二
輓	梄曲儿口儿
鴿	人寸一口儿
錘	斤一竹十二
懼	米卜目目川
坨	二一之寸儿
椰	梄一三十乙
梢	梄一曲人月
嘟	口一二竹乙
瀟	添添十川巛
障	乙口言曲十
霄	梄添曲人月
疇	曲卜二口寸
揣	寸添目目大
槐	梄一川口
粟	梄口米梄
唆	口一巛人儿
誦	言寸又言月
綜	巛一之寸二
詢	言寸儿乙曲
劃	又大二一曲
札	梄一巛添
駁	三米人言人
拴	寸添人寸三
攏	寸添言卜
聳	人卜人卜三
燭	米人目儿口
襖	之广川米大
臘	月一巛人巛
吏	一添口一人
堰	二一七曲巛
棺	梄一之寸乙
腥	月一曲一竹
胞	月一儿乙乙
羨	米三添添儿
韶	言米曲乙口
阜	竹添乙又十
剖	言米口一曲
羹	米三米米大
剃	米寸乙川曲
寓	之寸曲目巛
峪	目目人人口
煜	米人曲一言
竊	之人斤目巛
撩	寸添一曲曲
扳	寸添斤寸又
桔	梄一二二口
轄	梄曲之三口
臧	巛大七竹七
喀	口一之儿口
妄	言七巛竹
陌	乙口一添川
弧	乙巛斤言
弩	巛竹又言乙
撰	寸添乙十人
瞿	目一目一川
卞	言一卜寸
蛤	口巛人一口
襄	言儿口口十
肅	又大川又巛
擒	寸添人目巛
哨	口一曲人月
鑿	曲米米月斤
皂	川曲七寸
佘	人寸二曲
鋸	斤一又十口
汞	二卜曲添
芭	十卜乙曲
膿	月一曲曲大
懿	二二之儿之
蔭	十卜乙二巛
椒	梄一卜曲又
戎	七竹大寸
肋	月一乙竹
翎	人寸之乙乙
煌	米人川曲三
錐	斤一川卜
疤	广一乙曲
瀚	添添十乙乙
闕	又寸米巛儿
絹	巛一口一月
僱	川添之竹川
泓	添添乙巛巛
昧	曲一二寸梄
柒	添添七寸梄
棧	梄一七竹七
硯	大一目儿
錳	斤一乙一目
旨	儿儿曲一
鱗	儿一米儿十
巳	乙二
辜	十寸口一言
筐	竹言七添三
膊	月一梄二寸
遵	之一米梄寸
摺	寸添乙乙川
輥	梄曲曲儿儿
嗒	口一十一口
剁	月寸梄一曲
愧	米卜川口
拙	寸添巛曲巛
彆	目卜添竹乙
竿	竹言一十
鈔	斤一曲人竹
鏟	斤一言竹竹
驛	三米目二米
鱉	目卜添竹儿
稜	竹梄二人儿
憤	米卜十十目
綽	巛一卜曲十
鶯	米人米之儿
緻	巛一七二竹
圭	二一二一
塚	二一之之大
甸	儿乙曲卜
衷	言儿口口
燜	米人又寸之
脊	添添人寸月
憨	又添三竹之
搽	寸添十人梄
捶	寸添竹十二
勵	大大十巛乙
毓	竹一巛巛川
苔	十卜巛言口
鉗	斤一十二
鉢	斤一梄一一
奸	巛竹一十
坂	二一斤寸又
淼	曲添曲添曲
黏	竹梄人卜口
縷	巛一曲口巛
甭	大卜月二
瞟	目一梄口二
舅	川二曲卜乙
錚	斤一斤添又
阪	乙口斤寸又
恕	巛竹口一之
轎	梄曲竹目口
啼	口一言之目
繭	十卜目卜口
鬱	竹一十儿斤
曠	曲一广曲人
睹	目一二竹
禿	竹梄儿寸
諦	言寸言之目
疲	广一又卜
褪	之广之一又
鞠	十十儿乙米
釉	斤梄曲二
彰	言米曲十斤
綴	巛一又又又
軋	梄曲巛添
酬	梄寸添寸川
橘	梄一又人口
啪	口一寸添川
睛	目一三卜月
斂	人寸一人竹
遁	之一斤十目
晝	又大二曲一
殲	一添儿曲一
樸	梄一曲米米
哆	口一儿言儿
窟	之人又巛巛
鈍	斤一一添巛
垢	二一斤一口
愿	大大川曲之
奚	斤添巛巛大
誼	言寸之寸目
緋	巛一曲三
紛	巛一人一乙
褚	之广二竹
腮	月一曲卜之
枉	梄一三一
旳	曲一儿乙言
鍍	斤一广十又
涓	添添口一月
嗟	口一米三二
蠱	口巛口口目
笙	竹言竹三
沸	添添乙巛川
妓	巛竹十寸又
儉	川添人人人
猿	月竹二口儿
漠	添添十曲大
撬	寸添竹竹竹
巍	目目竹巛川
鉑	斤一川曲
漾	添添米言曲
擎	十卜儿竹竹
詐	言寸竹一卜
絃	巛一言一巛
靶	十十乙曲
鴉	七卜儿巛
俐	川添竹梄曲
胚	月一大卜一
楷	梄一儿儿川
侶	川添口竹口
迭	之一竹二人
詔	言寸乙寸口
嗣	口一目一口
嵩	目目言目口
驕	三米竹目口
蠅	口巛之又
蹄	口卜言之目
穫	竹梄十川又
潰	添添口一目
褐	之广曲人巛
丞	又添曲添一
芮	十卜目寸人
梭	梄一巛人儿
瘡	广一人之口
槓	梄一二卜目
唷	口一言巛月
曜	曲一乙乙川
鯨	儿一言口曲
灝	添添曲曲大
鎊	斤一言之言
畜	言一巛巛曲
廬	广大卜曲目
砼	大一人寸二
粽	米梄之寸二
韌	又口口乙言
囉	口一目巛川
唑	口一人人二
鋰	斤一曲卜二
鸞	言寸巛巛儿
鈾	斤一曲二
宵	之寸曲人月
榆	梄一人月曲
嚷	口一言口十
釵	斤一又言言
焱	米人米人米
絮	巛竹口一巛
戊	七大
鄔	儿川乙口
剷	言米竹竹曲
罕	之之人一一
欒	言寸巛巛梄
糾	巛一巛卜
駝	三米之寸儿
叩	口一乙目
箏	竹言斤添又
俯	川添广川寸
瀑	添添曲人曲
濕	添添曲巛米
肇	之竹竹又二
窪	之人添二二
毋	巛乙竹添
摞	寸添曲卜巛
暇	曲一又又又
岐	目目十寸又
睬	目一斤添梄
郊	言一人人乙
璧	又竹口三言
挾	寸添大人人
捎	寸添曲人月
嶼	目目川卜人
汶	添添言人
糸	巛一
嘀	口一言十口
斃	目卜添儿儿
犁	竹梄曲寸竹
怔	米卜一添卜
焚	梄一梄一米
恁	川添竹二之
鷗	七添口口儿
癖	广一又口言
灼	米人儿乙言
孽	十卜竹言乙
岱	川添七言目
麓	梄一梄一广
匙	曲一一卜儿
嚎	口一言之大
爻	人言人言
鏢	斤一梄口二
涇	添添一巛二
珏	三一三一言
摧	寸添目目川
械	梄一七竹十
乞	竹一乙七
卯	儿竹
凋	广寸月二口
蕙	十卜梄曲之
噗	口一曲米米
硒	大一梄口
嗔	口一十目人
卟	口一卜寸
筠	竹言二儿广
諧	言寸儿儿川
咔	口一卜一卜
喧	口一之二曲
癲	广一十人大
汎	添添月言
瓢	梄口二曲斤
嚕	口一儿一曲
裳	曲人之口言
釗	斤一曲寸
謊	言寸十言川
晤	曲一二又口
竭	言米曲人巛
妨	巛竹言乙
玻	三一又卜
聾	言卜三十
宸	之寸大七
擅	寸添言曲一
蔘	十卜巛人斤
諫	言寸梄一目
烹	言一口又米
卉	十寸十卜
綾	巛一二人儿
括	寸添竹卜
檐	梄一儿人言
漬	添添三卜目
戟	十寸曲十七
韜	又口口斤川
尸	又竹
椎	梄一川卜
恬	米卜竹卜
胥	又添卜卜月
檀	梄一言曲一
坯	二一大卜一
葡	十卜儿乙梄
仄	大大人寸
噯	口一斤之儿
溴	添添川目大
縛	巛一梄二寸
姝	巛竹竹一梄
嬸	巛竹之斤曲
塢	二一儿川
壙	二一广曲人
伙	川添米人
蠍	口巛曲巛儿
暱	曲一七大口
垣	二一二寸曲
拘	寸添儿乙口
呱	口一斤言
昱	曲一言米
篤	竹言三米
箍	竹言寸七目
鳩	月乙儿巛
噁	口一二巛之
躁	口卜口口梄
噬	口一竹人人
鎢	斤一儿川
孚	斤添乙一
穀	二二之竹月
玥	三一月一
蓓	十卜川言口
蛆	口巛目三
囚	口寸人寸
癱	广一十二川
鞘	十十曲人月
瀨	添添梄儿目
滷	添添卜口人
匣	七添曲乙
鉬	斤一目一
銹	斤一竹乙竹
凳	又米一米月
隙	乙口曲曲曲
娣	巛竹米乙川
驟	三米三又大
莞	十卜之一一
曆	大大竹竹曲
躥	口卜之川巛
銨	斤一之寸巛
荃	十卜人寸三
伶	川添人寸之
謠	言寸儿十巛
璽	一添人三言
拭	寸添七言二
醃	梄寸大寸曲
墅	曲卜二卜二
釩	斤一月言
懵	米卜十之目
苷	十卜十二
碾	大一又十儿
雋	川卜目寸巛
禧	二曲二米口
囡	口寸巛竹
鷺	口卜儿口儿
鵑	口一月一儿
脅	乙竹乙乙月
榨	梄一之竹卜
黯	目曲二言曲
侖	人寸一目十
荼	十卜人寸竹
苞	十卜儿乙乙
戚	七大卜一曲
曄	曲一十十二
饃	人又十曲大
頒	人一乙寸大
倘	川添曲目口
怯	米卜二一巛
淪	添添人目十
礁	大一川卜米
睏	曲一口寸梄
瞻	目一儿人言
躬	川三乙巛
餌	人又三十
脖	月一十之乙
襟	之广梄梄二
尉	又竹二曲寸
絳	巛一儿卜十
軼	梄曲竹二人
亥	言一巛人人
屄	又竹之人
蘋	十卜卜曲大
尐	曲人言添
肢	月一十寸又
悄	米卜曲人月
紐	巛一又二卜
閹	又寸大寸曲
弋	七言
厘	大大曲卜二
貯	目人之寸一
僕	川添曲米米
憎	米卜米目曲
禎	二曲卜寸目
隴	乙口言卜
緬	巛一又口目
頰	大寸人人大
砷	大一曲梄
糙	米梄之竹口
炯	米人目寸口
莘	十卜言十
盔	大寸米人目
睦	目一二人二
仟	川添竹十
炕	米人言一月
渦	添添目口
鬢	三七斤曲目
艷	三卜三儿乙
荔	十卜乙乙乙
嗷	口一三乙竹
盅	口口目梄
籲	竹言人十大
鯊	添添曲竹儿
藩	十卜添斤曲
楨	梄一卜寸目
奢	大寸二竹
尬	大儿人寸川
趾	口卜卜卜
贖	目人二目目
瘀	广一言人广
悼	米卜卜曲十
臍	月一言儿川
抿	寸添乙二七
憾	米卜七口之
愷	米卜目口米
孓	又乙言添
滌	添添川儿梄
浣	添添之一一
兀	一添儿寸
蹟	口卜三卜目
囿	口寸大寸月
嶽	目目月言大
稚	竹梄川卜
褒	言儿川口梄
痔	广一二一寸
烘	米人十一人
渭	添添曲卜月
嘻	口一二米口
錨	斤一十卜曲
鍛	斤一川三月
喏	口一十大口
町	曲卜一卜
麒	广又十三
熄	米人川目之
烯	米人人大目
艮	又人
珉	三一乙二七
捋	寸添斤添寸
薯	十卜目曲二
禦	人卜竹乙二
蕉	十卜川卜米
荀	十卜儿乙曲
逍	之一曲人月
冼	广寸竹二儿
泪	添添目一
拗	寸添巛巛乙
檯	梄一二之七
轍	梄曲言月竹
鵰	月添二口儿
毯	竹七米人米
鐸	斤一目二米
邸	儿七言添乙
柵	梄一目寸十
炙	儿言米人
倭	川添竹梄巛
翊	言米乙广乙
熾	米人言曲七
馱	三米大寸
莽	十卜大言十
笠	竹言言米
勉	儿添口儿乙
亢	言一月寸
羌	米三儿寸
璋	三一言曲十
毆	七添口口月
咚	口一儿卜广
癟	广一川目十
槳	巛大儿寸梄
恪	米卜儿卜口
涌	添添又言月
妒	巛竹之竹
醯	梄寸言川目
圩	二一一添寸
噹	口一曲口曲
暑	曲一二竹
軀	川三七口口
鈷	斤一十寸口
疫	广一月又
歉	米一又人儿
汐	添添儿言
績	米卜三卜目
樟	梄一言曲十
峩	目目竹寸七
錒	斤一乙一口
豁	之寸三人口
窖	之人竹二口
脉	月一言添曲
启	之竹口一
驥	三米广十人
扭	寸添又二卜
胰	月一大寸乙
梟	儿巛梄一
泗	添添目曲
邇	之一一人人
啟	之竹口一竹
帘	之人目卜
隅	乙口曲目巛
葆	十卜川口梄
岔	人一乙寸目
歆	言米曲一儿
禰	二曲一人人
弛	乙巛乙卜
秘	竹梄之巛竹
渚	添添二竹
纜	巛一七目目
枴	梄一口一乙
畀	曲卜一添川
鑼	斤一目巛川
廁	广大目人曲
撼	寸添七口之
雛	儿乙巛巛川
痞	广一大卜口
瘟	广一曲一目
樽	梄一米梄寸
崢	目目斤添又
颳	月卜竹卜
澇	添添米之乙
歧	卜卜十寸又
椿	梄一三人
确	大一儿添月
咀	口一目三
箋	竹言七竹七
价	川添人寸川
寮	之寸一曲曲
緹	巛一曲一卜
繃	巛一目月月
蒿	十卜言目口
醛	梄寸十人三
肏	人寸目人人
譟	言寸口口梄
悍	米卜曲一一
嬋	巛竹口曲一
駭	三米言巛人
碁	十三大一
硼	大一月一月
啤	口一川口十
壬	竹添二二
鄺	广大十人乙
叛	米二斤寸又
浚	添添巛人儿
獒	三卜乙竹大
捌	寸添口乙曲
霽	梄添言儿川
嘮	口一米之乙
鎘	斤一一米一
勘	十三巛添乙
剌	梄一口一曲
樵	梄一川卜米
啄	口一大月
倡	川添曲一曲
肛	月一二卜
糜	广大梄梄米
漪	添添月一口
迴	之一口寸口
駒	三米儿乙口
瑕	三一又又又
蔽	十卜目添竹
鐳	斤一梄添曲
糯	米梄梄添大
茫	十卜添添言
噎	口一二口米
飼	人又乙一口
狹	月竹大人人
凰	月寸川曲三
溺	添添乙乙广
寰	之寸目口儿
璞	三一曲米米
霓	梄添川二儿
醚	梄寸之一米
硝	大一曲人月
囤	口寸一添巛
吭	口一言一月
靡	广大梄梄曲
厥	大大米巛儿
凜	广寸言口竹
跺	口卜月寸梄
沓	曲添曲一
忻	米卜斤寸
遛	之一儿竹曲
萃	十卜言人十
氈	言一口一竹
埔	二一梄二
扼	寸添大大乙
吱	口一十寸又
竺	竹言二寸
綢	巛一月二口
霏	梄添曲三
蛟	口巛言人人
圃	口寸梄二
晗	曲一人又口
鉉	斤一言一巛
鋤	斤一目三乙
誕	言寸乙竹卜
泠	添添人寸之
瘸	广一乙人人
琢	三一大月
酉	梄寸
棘	梄一目梄目
蚌	口巛三卜
虜	卜七曲卜乙
吋	口一寸言
夥	曲卜梄儿儿
譁	言寸十十二
辮	言十巛一言
疣	广一大儿
恍	米卜曲人一
貽	目人巛言口
糠	米梄广又添
渺	添添目曲竹
洙	添添竹一梄
瀛	添添言巛月
祀	二曲乙二
瓏	三一言卜
琅	三一言添又
攥	寸添竹大巛
苛	十卜一卜口
苓	十卜人寸之
丕	大卜一添
唬	口一卜七
夭	竹添大寸
腌	月一大寸曲
姍	巛竹目寸十
橡	梄一儿口大
嗄	口一一川儿
眩	目一言一巛
弈	言曲十卜
珞	三一儿卜口
拈	寸添卜寸口
茸	十卜三十
倔	川添又巛巛
諜	言寸十巛梄
喆	二二口二口
艱	十一口二又
貂	斤月乙寸口
諒	言寸言口曲
丰	三卜
耙	三卜梄一乙
跋	口卜大言又
踱	口卜广十又
叭	口一人一
恢	米卜大寸米
彝	巛又米巛十
綰	巛一之寸乙
扽	寸添一添巛
磯	大一巛七人
旌	言乙竹一竹
濮	添添川曲米
孜	乙一竹人
琨	三一曲儿儿
琰	三一米人米
踐	口卜七竹七
舵	斤乙之寸儿
廝	广大十三斤
寐	之寸巛二梄
璃	三一言目巛
荻	十卜月竹米
孬	大卜巛竹乙
懈	米卜儿乙竹
漕	添添一曲曲
磐	斤乙月又大
宦	之寸七一
撅	寸添大巛儿
櫟	梄一川巛梄
罡	目曲一添卜
漱	添添梄口儿
櫥	梄一广米寸
諱	言寸又口十
庶	广大十一米
癬	广一儿一米
馭	三米又言
掄	寸添人目十
釜	人一人三米
焯	米人卜曲十
熵	米人言人口
騫	之寸十人三
釐	二寸梄曲二
挎	寸添大一一
茉	十卜一添梄
隸	梄一二又添
匾	七添之目十
筑	竹言二卜月
膳	月一米米口
濡	添添梄添大
蕪	十卜竹十米
鎬	斤一言目口
痹	广一曲一川
恃	米卜二一寸
淞	添添梄人巛
頹	竹梄儿寸大
鋇	斤一目人
舀	斤添川二
閑	又寸梄一
搔	寸添又言口
矇	目一十一大
縈	米人米之巛
嬪	巛竹之曲目
梧	梄一二又口
匝	七添目卜
哌	口一斤寸儿
羈	目曲十十三
屹	目目竹一乙
侑	川添大寸月
頃	儿儿大人
鯉	儿一曲卜二
灸	儿添言添米
甦	一添曲人竹
熹	二二口米米
鵲	十一曲一儿
鑰	斤一人目十
焙	米人言米口
蹈	口卜斤添川
牡	竹二二一
秧	竹梄目寸大
飢	人又月寸
狸	月竹曲卜二
訶	言寸一卜口
訥	言寸目寸人
沼	添添乙寸口
襠	之广曲口曲
夯	大寸乙竹
毗	曲卜儿儿儿
慫	人卜人卜之
懲	人卜目竹之
炬	米人七添又
逞	之一口一三
曖	曲一斤之儿
簧	竹言十曲人
脲	月一又竹曲
鰭	儿一二儿曲
窘	之人又大口
赦	二一米人竹
蔫	十卜一巛米
柚	梄一曲二
煨	米人曲一儿
溯	添添米巛月
宙	之寸曲二
薹	十卜二之七
斟	十三巛广十
柑	梄一十二
匿	七添十大口
剔	曲一儿斤曲
崴	目目七一巛
胯	月一大一一
眷	米二目一
癸	又米一添大
緞	巛一川三月
馴	三米川寸
蟎	口巛十人人
顱	卜七曲目大
嘲	口一十十月
噤	口一梄梄二
弒	人言梄七二
諭	言寸人月曲
謬	言寸乙人斤
甕	言一巛川一
噩	三一口口口
鬚	三七斤斤大
蟒	口巛十大十
偵	川添卜寸目
鎧	斤一目口米
攆	寸添二二梄
巔	目目十人大
燮	言寸米米又
汲	添添乙添人
筷	竹言米又大
輿	川二梄曲人
侄	川添七二
詭	言寸儿大乙
滔	添添斤添川
銑	斤一竹二儿
姣	巛竹言人人
丐	一添卜寸巛
檸	梄一之目一
硃	大一竹一梄
戌	七大一添
敝	目卜添添竹
壟	言卜二一
諮	言寸广儿口
疹	广一人寸斤
炊	米人儿人
涕	添添米乙川
瑣	三一曲人目
摹	十卜曲大竹
樞	梄一七口口
覈	梄口川言竹
杵	梄一竹一十
棣	梄一又大添
羚	米三人寸之
渤	添添十乙乙
蝨	乙七十口口
墟	二一卜七曲
柿	梄一言一目
烷	米人之一一
綏	巛一斤添巛
薔	十卜二口口
蹙	七大卜曲口
噪	口一口口梄
頑	一添一儿大
璟	三一曲口曲
氖	竹乙乙添竹
攸	川添卜添竹
帛	川曲目卜
膨	月一二米斤
涐	添添竹寸七
甬	又言月二
琉	三一言巛川
抒	寸添又又卜
薊	十卜儿一曲
酌	梄寸儿乙言
榭	梄一川三寸
鐺	斤一曲口曲
爍	米人川巛梄
沅	添添一添一
濠	添添言之大
闇	又寸言米曲
嬉	巛竹二米口
殖	一添儿十目
珀	三一川曲
眶	目一七添三
稼	竹梄之寸大
錛	斤一大十十
咎	儿卜卜寸口
潞	添添口儿口
絢	巛一儿乙曲
莓	十卜竹一巛
嘈	口一一曲曲
馥	竹梄曲曲儿
皋	川曲大寸十
粹	米梄言人十
瀅	添添米三言
祗	二曲儿七言
穢	竹梄卜一曲
褂	之广二二卜
娼	巛竹曲一曲
鰲	三卜乙竹儿
琱	三一月二口
鳶	七言儿巛
叟	川二卜添又
墾	斤月又人二
廓	广大言乙乙
弼	乙巛一川乙
珈	三一乙竹口
旻	曲一言人
翡	曲三乙广乙
曳	曲梄竹添
偕	川添儿儿川
諶	言寸十三巛
羲	米三竹七一
汾	添添人一乙
陂	乙口又卜
藺	十卜又寸川
軾	梄曲七言二
蛹	口巛又言月
丿	竹添
儷	川添一言广
僦	川添言曲大
郅	七二乙口
啖	口一米人米
籬	竹言言巛川
豚	月一大月
湄	添添又竹目
熨	又竹二寸米
犀	又竹曲添竹
珺	三一又大口
咂	口一七添目
釹	斤一巛竹
糗	米梄川目大
摯	二一米月竹
騏	三米十三
吡	口一儿儿儿
冕	曲一儿口儿
頜	人寸一口大
褶	之广乙乙川
巿	一添目卜
垛	二一月寸梄
髻	三七斤二口
擂	寸添梄添曲
芊	十卜竹十
檬	梄一十一大
砬	大一言米
咕	口一十寸口
嘶	口一十三斤
昀	曲一儿乙广
卹	竹添目梄乙
疝	广一目目
尻	又竹月乙
孑	又乙一添
坳	二一巛巛乙
薈	十卜人目曲
槌	梄一之竹乙
吮	口一巛言儿
厂	大大
芋	十卜一添寸
萎	十卜竹梄巛
榻	梄一曲乙乙
嗡	口一人乙乙
漣	添添之一梄
妤	巛竹又又卜
墒	二一言人口
瑄	三一之二曲
隼	川卜十寸
訟	言寸人一巛
燬	米人川二月
烴	米人一巛二
巒	言寸巛巛目
吠	口一大言
囑	口一又儿口
幡	目卜斤梄曲
篷	竹言之儿三
伢	川添七卜
仂	川添乙竹
沂	添添斤寸
尕	乙添竹添曲
聆	三十人寸之
騁	三米曲二一
嗑	口一二巛目
稟	言一口口竹
漳	添添言曲十
沱	添添之寸儿
卅	一添川寸
碌	大一又二曲
偈	川添曲人巛
蒽	十卜口大之
颱	月卜巛言口
燴	米人人目曲
冪	之之十大目
怠	巛言口一之
擄	寸添卜曲乙
杠	梄一二卜
砰	大一一米十
鹵	卜寸口寸人
曙	曲一目曲二
稽	竹梄大儿曲
簪	竹言七儿曲
偎	川添曲一儿
潁	儿儿曲添大
恙	米三之巛
敞	曲人目口竹
徙	人卜卜卜卜
嬴	言七口巛月
瘺	广一又竹梄
祚	二曲竹一卜
巽	乙二乙十人
拇	寸添巛乙
兢	十寸口口儿
踮	口卜广卜口
觴	儿添月儿斤
汕	添添目目
纓	巛一目目巛
綻	巛一之一卜
亓	二寸川寸
磺	大一十曲人
囂	口一口大口
啜	口一又又又
氰	竹乙三卜月
羥	米三一巛二
螢	米人米之口
闞	又寸又三竹
璉	三一之一梄
壑	卜寸之又二
嗪	口一三人竹
呤	口一人寸之
峨	目目竹寸七
濂	添添广曲人
閨	又寸二一二
姊	巛竹竹巛川
驪	三米一言广
敕	梄一口一竹
嘖	口一三卜目
瞼	目一人人人
謁	言寸曲人巛
讒	言寸儿儿言
愉	米卜人月曲
溥	添添梄二寸
緇	巛一巛寸曲
鄢	一添卜米乙
捨	寸添人寸竹
罔	目寸米一言
衙	人卜二又口
懇	斤月又人之
厝	大大十一曲
鄙	口一十口乙
勛	口一目人乙
餃	人又言人人
錕	斤一曲儿儿
桀	儿言十口梄
痠	广一巛人儿
澎	添添二米斤
宥	之寸大寸月
聿	又大二寸
頡	二二口一大
骸	目之言巛人
彿	人卜乙巛川
煽	米人之乙乙
澱	添添又人月
驍	三米二二一
驊	三米十十二
檻	梄一七竹目
隕	乙口口一目
饋	人又口一目
餉	人又川目口
鈥	斤一米人
狙	月竹目三
惶	米卜川曲三
酣	梄寸十二
輒	梄曲三十巛
杳	梄一曲一
顰	卜卜曲川十
煦	曲一儿口米
鍔	斤一口一一
庇	广大儿儿儿
芥	十卜人寸川
苡	十卜巛言人
戍	七大言添
蝗	口巛川曲三
暄	曲一之二曲
鱷	儿一三口口
床	广大梄一
楽	川曲添添梄
泯	添添乙二七
衹	之广儿七
陋	乙口一人巛
戮	乙广乙斤七
壤	二一言口十
墉	二一广又月
揖	寸添口一三
攙	寸添儿儿言
菡	十卜又曲巛
伎	川添十寸又
脛	月一一巛二
愕	米卜口一一
紳	巛一曲梄
呷	口一曲乙
唧	口一又人乙
朧	月一言卜
詣	言寸儿儿曲
烽	米人儿卜三
慨	米卜又七儿
菂	十卜川儿言
嘸	口一竹十米
乒	斤二竹添
朦	月一十一大
諡	言寸人一目
粱	添添乙人米
宓	之寸之巛竹
囗	口寸
峙	目目二一寸
侗	川添目一口
征	人卜一添卜
鋯	斤一竹二口
詰	言寸二二口
淒	添添一又巛
畦	曲卜二一二
骶	目之儿七言
膘	月一梄口二
庾	广大川二人
淬	添添言人十
掖	寸添言儿言
柬	梄一目曲
犢	竹二二目目
逵	之一二人二
悳	十寸目巛之
秩	竹梄竹二人
颯	言米月卜
湜	添添曲一卜
蕃	十卜斤梄曲
朽	梄一一乙
塹	梄曲斤寸二
杞	梄一乙乙
蛛	口巛竹一梄
啡	口一曲三
晦	曲一竹一巛
傈	川添梄口梄
佷	川添又人
餿	人又川卜又
昶	言添曲添曲
痂	广一乙竹口
扉	之竹曲三
嫉	巛竹广一竹
酈	一添目广乙
蓆	十卜广十目
蕁	十卜又口寸
鍼	斤一七一口
謨	言寸十曲大
广	广大
垠	二一又人
萘	十卜大寸二
蜷	口巛米二乙
嗤	口一巛一口
幌	目卜曲曲一
篆	竹言巛又大
臼	川二
傭	川添广又月
鍺	斤一二竹
諷	言寸月卜
諳	言寸言米曲
慚	米卜梄曲斤
怖	米卜大寸目
灶	米人二一
宁	之寸一卜
裱	之广三卜儿
扈	之竹口一乙
嫡	巛竹言十口
磬	二二又月大
嗖	口一川卜又
鍥	斤一三乙大
哺	口一梄二
踝	口卜曲卜梄
叱	口一儿儿
婢	巛竹川口十
婿	巛竹又卜月
擀	寸添十人一
挽	寸添儿口儿
氾	添添乙目
歹	一添儿言
矗	十寸目十目
叨	口一乙寸
喙	口一巛又大
晰	曲一梄一斤
晁	曲一儿寸添
箐	竹言三卜月
鼬	川二巛寸曲
閏	又寸三一
辷	之一一添
揩	寸添儿儿川
砣	大一之寸儿
罈	竹一十曲十
氬	竹乙二巛
偃	川添七曲巛
濛	添添十一大
蝸	口巛目口
銻	斤一米乙川
氐	儿七言添
迸	之一米一十
酪	梄寸儿卜口
嘜	口一梄人儿
咿	口一川添又
幔	目卜曲目又
戇	言米曲目之
淖	添添卜曲十
渥	添添又竹七
瑰	三一川口
蔗	十卜广十米
嗓	口一又又梄
郜	竹二口一乙
籮	竹言目巛川
鉚	斤一儿竹
膛	月一曲口二
孢	乙一儿乙乙
黒	曲卜二一米
幟	目卜言曲七
涔	添添目言又
嬡	巛竹斤之儿
饗	巛人言乙人
瓚	三一竹儿目
蛻	口巛人口儿
浠	添添人大目
汛	添添乙七十
剿	巛寸曲梄曲
菿	十卜七二曲
噌	口一米目曲
円	目寸卜添一
掣	竹二目曲竹
娑	添添曲竹巛
蔬	十卜又巛川
枷	梄一乙竹口
啉	口一梄一梄
俑	川添又言月
腋	月一言儿言
癒	广一人曲之
憫	米卜又寸言
灞	添添梄十月
吆	口一巛巛
憊	川添十月之
舫	斤乙言乙
瀏	添添儿斤曲
羿	乙广乙广十
為	斤米
璜	三一十曲人
拄	寸添言添三
郴	梄一梄一乙
蟾	口巛儿人言
腚	月一之一卜
誡	言寸七竹十
吝	言人口一
沏	添添七寸乙
渙	添添儿人大
穹	之人乙巛
媞	巛竹曲一卜
嘌	口一梄口二
岫	目目曲二
筵	竹言乙竹卜
裊	儿巛言儿
矜	又言又言又
掬	寸添儿乙米
皿	目梄
纂	竹言目大巛
徊	人卜口寸口
鰓	儿一曲卜之
誨	言寸竹一巛
焗	米人又乙口
鬍	三七斤口月
撂	寸添曲儿口
覷	卜七曲米目
嗽	口一梄口儿
曇	曲一梄二巛
悖	米卜十之乙
耘	三卜梄二巛
蜃	大七口巛
郢	口一三一乙
罘	目曲大卜
鍘	斤一目人曲
銓	斤一人寸三
鏽	斤一又川巛
雒	儿卜口一川
勐	乙一目梄乙
鑾	言寸巛巛斤
蔻	十卜之卜又
榴	梄一儿竹曲
蹺	口卜二二一
伺	川添乙一口
尒	人寸曲人
饑	人又巛七人
諞	言寸之目十
瀦	添添大月二
胜	月一竹三
芣	十卜大卜
榛	梄一三人竹
弌	七言一添
簍	竹言曲口巛
筏	竹言川添七
銬	斤一二竹一
奐	儿添目人大
癩	广一梄儿目
淅	添添梄一斤
澹	添添儿人言
禱	二曲二口寸
辟	又竹口一言
姥	巛竹二竹儿
欖	梄一七目目
嗝	口一一米一
譏	言寸巛七人
粕	米梄川曲
燊	米人米米梄
甾	巛寸曲卜
坷	二一一卜口
莢	十卜大人人
靄	梄添言人巛
顎	口一口一大
嶄	目目梄曲斤
髖	目之之目言
仆	川添卜寸
佚	川添竹二人
脯	月一梄二
痢	广一竹梄曲
煸	米人之目十
灃	添添三口米
汰	添添大寸言
濯	添添乙乙川
萼	十卜口一一
楔	梄一三乙大
軻	梄曲一卜口
輻	梄曲一口曲
呲	口一卜卜儿
唰	口一又目曲
疃	曲卜言曲二
煊	米人之二曲
淶	添添梄人人
亍	一添一卜
圳	二一川寸
煉	米人梄一目
洵	添添儿乙曲
犟	乙巛口口竹
顳	三十三三大
槎	梄一米三二
甌	七添口口一
峭	目目曲人月
気	竹乙人言
猥	月竹曲一儿
惺	米卜曲一竹
締	巛一言之目
楣	梄一又竹目
嘩	口一十十二
僚	川添一曲曲
忿	人一乙寸之
孵	儿竹言斤乙
紊	言人巛一
罄	二二又十巛
髯	三七斤目二
贅	三卜乙竹目
捺	寸添大寸二
懋	梄一又梄之
魘	大大曲大川
齲	卜人竹目巛
帷	目卜川卜
嶸	目目米之梄
雉	竹大川卜
舸	斤乙一卜口
膈	月一一米一
洩	添添曲梄竹
寞	之寸十曲大
蹇	之寸十人口
櫓	梄一儿一曲
蚜	口巛七卜
畸	曲卜大一口
箕	竹言十三
匆	儿乙斤三言
壕	二一言之大
撣	寸添口曲一
堇	十一口一三
蕞	十卜曲三又
涎	添添乙竹卜
渲	添添之二曲
寳	之寸三曲目
闋	又寸又一大
耽	三十之之儿
菅	十卜之寸乙
仝	人寸二卜
猩	月竹曲一竹
詮	言寸人寸三
疵	广一卜卜儿
瀧	添添言卜
遐	之一又又又
袂	之广又添大
霾	梄添斤曲二
虔	卜七言人
蹴	口卜言曲大
鉸	斤一言人人
舶	斤乙川曲
斕	言人又梄目
謐	言寸之竹目
燎	米人一曲曲
熠	米人乙乙川
闔	又寸二巛目
殃	一添儿目大
軫	梄曲人寸斤
噼	口一又口言
遏	之一曲人巛
銼	斤一人人二
舛	儿言十口
匕	儿儿
謔	言寸卜七一
隘	乙口米人目
殑	一添儿口儿
騾	三米曲卜巛
檜	梄一人目曲
囝	口寸乙一
喈	口一儿儿川
稈	竹梄曲一一
澍	添添二米寸
珩	三一人卜
欏	梄一目巛川
畈	曲卜斤寸又
鵠	竹二口一儿
衢	人卜目目川
譴	言寸之一乙
泌	添添之巛竹
宕	之寸大一
邈	之一斤川儿
苄	十卜言一卜
菀	十卜之儿乙
礬	人言人大大
岷	目目乙二七
贍	目人儿人言
俘	川添斤添乙
衾	人寸言又言
衕	人卜目一口
鈀	斤一乙曲
狩	月竹之寸寸
襬	之广目儿儿
蠡	巛又大口口
邰	巛言口一乙
殆	一添儿巛口
鬃	三七斤之二
啶	口一之一卜
晌	曲一川目口
睫	目一一又卜
飭	人又竹一乙
鈿	斤一曲卜
獾	月竹十口川
鯤	儿一曲儿儿
琍	三一竹梄曲
捍	寸添曲一一
芾	十卜一添目
彧	七言口一斤
蝠	口巛一口曲
嘣	口一目月月
岢	目目一卜口
鑣	斤一广又米
鷲	言一口大儿
訛	言寸川添儿
詡	言寸乙广乙
潯	添添又口寸
靛	三卜月一卜
莆	十卜梄二
礪	大一大目巛
氦	竹乙言巛人
佯	川添米三
膀	月一言之言
瀆	添添二目目
緗	巛一梄一目
姻	巛竹口寸大
繽	巛一之曲目
葭	十卜又又又
鑒	七一竹目斤
贓	目人巛七七
徳	人卜十目之
関	又寸米一大
耆	二竹儿儿曲
捫	寸添又寸
拚	寸添巛言十
籤	竹言人曲一
夙	月寸一添儿
腑	月一广川寸
謾	言寸曲目又
蟄	二一米月口
樾	梄一二七巛
咣	口一曲人一
噙	口一人目巛
猝	月竹言人十
訖	言寸竹一乙
熒	米人米之米
潼	添添言曲二
窒	之人七二
翌	乙广乙广言
奼	巛竹竹添七
夔	米一川人儿
髂	目之之儿口
熏	竹十目二米
刈	人言曲寸
鉭	斤一曲一一
鍬	斤一竹梄米
舷	斤乙言一巛
肟	月一一添一
鱔	儿一米米口
誑	言寸月竹三
氓	言七乙二七
豢	米二大月
忱	米卜之之儿
洧	添添大寸月
雇	之竹川卜
閭	又寸口一口
媳	巛竹川目之
蠹	一添口口口
荐	十卜大卜乙
蟮	口巛米米口
踰	口卜人月曲
彡	斤三
鍶	斤一曲卜之
対	言人寸言
庖	广大儿乙乙
鶩	又言又竹儿
埂	二一一曲人
琥	三一卜七
賁	十寸十卜目
哏	口一又人
俟	川添巛言竹
懾	米卜三三三
汙	添添一添寸
紺	巛一十二
抻	寸添曲梄
缶	竹一十寸巛
絛	川添卜儿巛
鏤	斤一曲口巛
汴	添添言一卜
忝	一添大寸米
璨	三一卜又米
虯	口巛巛卜
躡	口卜三三三
喱	口一大曲二
嵇	竹梄大儿目
鉞	斤一七竹巛
鈊	斤一之巛
鴛	儿言乙目儿
誣	言寸二人人
諍	言寸儿添又
怵	米卜梄一言
湍	添添目目大
葳	十卜七一巛
藜	十卜竹人曲
輟	梄曲又又又
僻	川添又口言
鏃	斤一言竹竹
瓤	言儿口十斤
鶉	言一口乙儿
翦	米一月乙乙
羯	米三曲人巛
熳	米人曲目又
澶	添添言曲一
滸	添添言竹十
廴	乙言
燾	二二又寸米
撾	寸添之一目
拯	寸添又曲一
芡	十卜儿人
枰	梄一一米十
俸	川添三人二
翱	川曲大乙乙
奠	米寸梄寸大
銥	斤一言儿
肱	月一大寸巛
瘧	广一卜七一
屙	又竹乙一口
邕	巛寸口一乙
埒	二一斤添寸
茱	十卜竹一梄
槿	梄一十口三
梔	梄一斤一乙
楹	梄一乙又目
僥	川添二二一
倖	川添二一米
慍	米卜口人目
玟	三一言人
礎	大一梄又卜
矽	大一儿言
蛭	口巛七二
哽	口一一曲人
髁	目之曲卜梄
骰	目之月又
氡	竹乙儿卜广
鏜	斤一曲口二
飧	儿言人又
訕	言寸目目
漚	添添七口口
翩	之竹目乙乙
祟	巛曲巛卜二
殉	一添儿儿曲
塬	二一大川曲
琬	三一之儿乙
剋	十寸口儿曲
芩	十卜人言又
様	梄一米三曲
硎	大一一十曲
冂	目寸
峁	目目儿竹
淦	添添斤一
皰	又卜儿乙乙
収	巛卜又言
苒	十卜目寸二
箔	竹言添添川
鐨	斤一乙川目
洎	添添川目
輦	二言二言梄
薆	十卜斤之儿
跤	口卜言人人
嗌	口一米人目
顥	曲一言曲大
懟	曲米米寸之
牲	竹二竹三
氳	竹乙口人目
牒	川又十巛梄
戦	添寸曲一七
漩	添添言又卜
殞	一添儿口目
玳	三一川添七
芪	十卜儿七
皙	梄一斤寸川
礫	大一川巛梄
賄	目人大寸月
僳	川添梄口米
饈	人又米又卜
胍	月一斤言
鮎	儿一卜寸口
詒	言寸巛言口
悵	米卜三七
涸	添添口十口
綬	巛一斤之又
攘	寸添言口十
嚄	口一十川又
喓	口一梄口巛
歟	川二一人儿
牋	川又七竹七
鐲	斤一目儿口
変	言曲儿卜
淥	添添巛又曲
宀	之寸
剜	之寸儿乙曲
孖	乙一乙一
卍	乙添卜一卜
綣	巛一米二乙
圻	二一斤寸
苣	十卜七添又
芍	十卜儿乙言
菩	十卜言米口
蠔	口巛言之大
哂	口一梄口
佣	川添月二
仞	川添乙寸言
諏	言寸三十又
冽	广寸一儿曲
廡	广大竹十米
綃	巛一曲人月
耦	三卜梄目巛
桉	梄一之寸巛
粲	卜寸儿又米
喳	口一梄曲一
啐	口一言人十
儺	川添十二川
鏗	斤一七又二
諛	言寸川二人
庋	广大十寸又
粑	米梄乙曲
籹	米梄巛竹
瀘	添添卜曲目
鋈	添添竹大斤
滘	添添之二口
戾	之竹大言
亟	又乙口又一
嬈	巛竹二二一
堀	二一又巛巛
莧	十卜目儿
蘑	十卜广梄大
輾	梄曲又十儿
跛	口卜又卜
崾	目目梄口巛
顓	目目大目大
鉍	斤一之巛竹
鎔	斤一之人口
鯽	儿一又人乙
憬	米卜曲口曲
愀	米卜竹梄米
湮	添添梄口二
洇	添添口寸大
祜	二曲十寸口
闡	又寸口曲一
亙	二寸儿添广
囍	二二口米口
撻	寸添之二米
芏	十卜二一
莣	十卜言七之
蒞	十卜添川言
檫	梄一之又二
饕	口一一卜人
盹	目一一添巛
脩	川添卜儿月
畲	人寸二曲曲
鎵	斤一之寸大
謗	言寸言之言
糰	米梄口梄寸
灩	添添三巛目
寤	之寸巛又口
縉	巛一二巛曲
娉	巛竹曲二一
垟	二一米三
硌	大一儿卜口
盎	目寸大寸目
睢	目一川卜
徠	人卜梄人人
斛	儿添月广十
泮	添添米二
汊	添添又言言
灤	添添言巛梄
繕	巛一米米口
歿	一添儿儿又
碴	大一梄曲一
逕	之一一巛二
哮	口一二竹乙
嘬	口一曲三又
嶂	目目言曲十
乓	斤二言添
逯	之一又二曲
閾	又寸七口一
葽	十卜梄口巛
枳	梄一口一人
杓	梄一儿乙言
鄴	曲米米梄乙
岬	目目曲乙
誥	言寸竹二口
汏	添添大寸
売	二二之之儿
埭	二一又大添
螯	三卜乙竹口
孛	十寸之之乙
啷	口一言又乙
笥	竹言乙一口
鵒	人一人口儿
狡	月竹言人人
竦	言米梄一口
癰	广一巛乙川
瀹	添添人目十
潙	添添斤米
硐	大一目一口
蹶	口卜大巛儿
蹋	口卜曲乙乙
篡	竹言目大巛
俚	川添曲卜二
伈	川添之巛
魷	儿一大儿
鰻	儿一曲目又
讕	言寸又梄目
恣	广寸儿人之
羧	米三巛人儿
紂	巛一寸言
緲	巛一目曲竹
戩	二寸巛曲七
児	卜添曲一儿
呿	口一二一巛
胄	曲二月一
禺	曲一目寸巛
矚	目一又儿口
笆	竹言乙曲
鉈	斤一之寸儿
竣	言米巛人儿
甑	米寸目曲一
悸	米卜竹梄乙
煬	米人曲儿斤
縐	巛一儿儿巛
玓	三一儿乙言
萇	十卜三七
蓯	十卜人人卜
韭	曲三一添
暝	曲一之言人
凼	曲添巛卜
睨	目一川二儿
仩	川添卜一
倌	川添之寸乙
銦	斤一口寸大
鍇	斤一儿儿川
肪	月一言乙
馗	月乙米一川
孺	乙一梄添大
緝	巛一口一三
殮	一添儿人人
琮	三一之寸二
芫	十卜一添一
菈	十卜寸添言
檣	梄一二口口
賚	梄一人人目
掱	竹寸竹寸竹
秸	竹梄二二口
儼	川添口三竹
皎	川曲言人人
龕	人寸一口言
諼	言寸斤大又
瘓	广一儿人大
癆	广一米之乙
煅	米人川三月
慵	米卜广又月
涙	添添之竹大
惢	之巛之巛之
耨	三卜梄大寸
蜇	寸添斤寸口
莒	十卜口一口
蘅	十卜人曲大
苕	十卜乙寸口
橇	梄一竹竹竹
翳	七添竹乙乙
哐	口一七添三
賑	目人大七
崛	目目又巛巛
篁	竹言川曲三
偌	川添十大口
釧	斤一川寸
鈮	斤一又竹儿
諺	言寸言竹斤
庵	广大大寸曲
炷	米人言添三
濄	添添之一目
洳	添添巛竹口
隧	乙口之米大
塒	二一曲二寸
茆	十卜儿竹
橈	梄一二二一
靨	大大曲口目
蜈	口巛口一大
喹	口一大二二
咲	口一米一大
冑	曲二目寸二
乄	竹添言添
偠	川添梄口巛
澧	添添曲口米
屜	又竹人十巛
卐	巛添一卜一
纈	巛一二口大
姒	巛竹巛言人
瓔	三一目目巛
柘	梄一大一
枋	梄一言乙
虻	口巛言七
釕	斤一又乙
廕	广大乙二巛
惰	米卜大二月
懺	米卜人曲一
洮	添添儿寸添
蚤	又言言添口
婊	巛竹三卜儿
斡	十寸曲广十
韃	十十之二米
轅	梄曲二口儿
栩	梄一乙广乙
攴	卜寸又言
哧	口一二一米
睞	目一梄人人
僖	川添二米口
傣	川添三人曲
倏	川添卜儿大
銫	斤一儿添乙
銃	斤一言巛儿
諤	言寸口一一
苹	十卜一米十
蕨	十卜大巛儿
茴	十卜口寸口
藐	十卜斤川儿
芠	十卜言人
酵	梄寸二竹乙
蛔	口巛口寸口
崮	目目口十口
嶠	目目竹目口
膦	月一米儿十
鮭	儿一二一二
匈	儿乙人言巛
譙	言寸川卜米
洹	添添二寸曲
沢	添添又竹言
璁	三一川儿之
蒯	十卜月月曲
醞	梄寸口人目
椋	梄一言口曲
叵	七添口一
齦	卜人又人
嗶	口一曲十二
唾	口一竹十二
哖	口一竹一十
噔	口一又口米
笫	竹言竹巛川
惚	米卜儿斤之
澮	添添人目曲
閫	又寸口寸梄
瑙	三一巛川人
棹	梄一卜曲十
蜥	口巛梄一斤
蛀	口巛言添三
螟	口巛之言人
唏	口一人大目
畹	曲卜之儿乙
黍	竹梄人寸曲
鑊	斤一十川又
腓	月一曲三
詎	言寸七添又
庥	广大川添梄
濰	添添巛一川
緘	巛一七一口
攣	言寸巛巛竹
轂	二二之梄月
蓴	十卜梄曲寸
蒔	十卜曲二寸
佇	川添之寸一
鈐	斤一人言又
貉	斤月儿卜口
瀕	添添卜曲大
闃	又寸目一大
翀	乙广乙广口
妊	巛竹竹添二
紓	巛一又又卜
荇	十卜人卜
蔸	十卜川又儿
艿	十卜乙添竹
櫛	梄一竹又乙
斫	大一斤寸
咻	口一川添梄
箴	竹言七一口
适	之一竹卜
飴	人又巛言口
訝	言寸七卜
淙	添添之寸二
嫦	巛竹曲口目
弁	巛言十卜
韉	十十十巛米
萜	十卜目卜口
薏	十卜言曲之
趺	口卜二言
賒	目人人寸二
郗	人言大目乙
饌	人又乙十人
虢	斤添寸言卜
慷	米卜广又添
濼	添添川巛梄
実	之寸三寸人
寥	之寸乙人斤
褋	之广十巛梄
摑	寸添口口一
邯	十二乙口
蔑	十卜目七言
楮	梄一二竹
圧	大大二一
砥	大一儿七言
迄	之一竹一乙
儆	川添十口竹
讎	川卜言寸川
銪	斤一大寸月
臊	月一口口梄
鴕	儿巛之寸儿
誆	言寸七添三
咫	又竹言口人
鍪	又言又竹斤
婺	又言又竹巛
綹	巛一儿卜口
搪	寸添广又口
葑	十卜二二寸
噫	口一言曲之
瞰	目一又三竹
攵	竹人
僮	川添言曲二
佗	川添之寸儿
鐫	斤一川目巛
塾	言一口月二
旎	言乙竹又儿
壅	言一巛川二
懦	米卜梄添大
発	又米二寸儿
繚	巛一一曲曲
繹	巛一目二米
酆	三卜三米乙
藹	十卜言人巛
箬	竹言十大口
爰	斤添一大又
鋮	斤一七大乙
鏘	斤一巛儿寸
魴	儿一言乙
詼	言寸大寸米
謖	言寸曲人儿
炔	米人又添大
燼	米人又米目
妲	巛竹曲一一
勱	十卜曲巛乙
蓼	十卜乙人斤
鸕	卜七曲目儿
螭	口巛言目巛
峒	目目目一口
県	目一巛添曲
狽	月竹目人
觥	儿添月曲一
羔	米三米言
熘	米人儿竹曲
衿	之广人言又
騖	又言又竹三
盂	一添寸言目
髦	三七斤三竹
萸	十卜川二人
磧	大一三卜目
蜆	口巛目儿
踞	口卜又十口
昴	曲一儿竹
僾	川添斤之儿
卮	斤寸一添乙
氷	曲添言添
詬	言寸斤一口
癥	广一人三竹
湫	添添竹梄米
綵	巛一斤添梄
娓	巛竹又竹竹
恚	二一二一之
莜	十卜川卜竹
蘚	十卜儿一米
尢	大寸巛添
匭	七添梄曲月
籟	竹言梄儿目
魑	川口言目巛
頦	言一巛人大
汜	添添乙二
縝	巛一十目人
芰	十卜十寸又
椏	梄一二巛
榫	梄一川卜十
椽	梄一巛又大
蟠	口巛斤梄曲
啫	口一二竹
蹊	口卜斤巛大
晞	曲一人大目
詈	目曲言寸
肴	人言大寸月
銠	斤一二竹儿
鈑	斤一斤寸又
獠	月竹一曲曲
誚	言寸曲人月
諂	言寸儿添川
痿	广一竹梄巛
焓	米人人又口
湃	添添竹一三
湟	添添川曲三
祉	二曲卜卜
縵	巛一曲目又
妗	巛竹人言又
擻	寸添曲巛竹
菘	十卜梄人巛
菏	十卜添一口
葯	十卜巛儿言
砦	卜卜儿儿大
鶚	口一口一儿
睪	目曲二一米
釁	川二目人乙
鏞	斤一广又月
啻	言一米目口
旖	言乙竹一口
饔	言一巛川人
劭	乙寸口一乙
姘	巛竹米一十
畿	巛巛巛七曲
坭	二一又竹儿
霈	梄添添一目
呔	口一大寸言
崧	目目梄人巛
箸	竹言二竹
稔	竹梄人又之
籩	竹言之之言
乂	人言
鏵	斤一十十二
塍	月一米二二
詫	言寸之竹七
庹	广大十又言
疚	广一儿添言
怛	米卜曲一一
瀋	添添之斤曲
黽	之又
窿	之人乙一竹
芐	十卜一添卜
霰	梄添十月竹
歩	卜卜曲人竹
噘	口一大巛儿
啾	口一竹梄米
崙	目目人目十
俅	川添一曲言
鎰	斤一米人目
腱	月一乙又二
鱸	儿一卜曲目
処	儿卜月寸
瘁	广一言人十
浹	添添大人人
漓	添添言目巛
寔	之寸曲一卜
禕	二曲又口十
闆	又寸口口口
迂	之一一添寸
菰	十卜乙一斤
碇	大一之一卜
嗬	口一十一口
笄	竹言一添十
筧	竹言目儿
鐮	斤一广曲人
凇	广寸梄人巛
洌	添添一儿曲
袒	之广曲一一
鄄	梄口二一乙
櫚	梄一又口口
呋	口一二言
囁	口一三三三
唳	口一之竹大
篙	竹言言目口
氛	竹乙人一乙
鋌	斤一乙竹二
詘	言寸巛曲巛
賡	广大又人目
禛	二曲十目人
闥	又寸之二米
嬤	巛竹广梄巛
垚	二一二一二
垃	二一言米
蕎	十卜竹目口
蚴	口巛巛巛乙
跖	口卜大一
鄖	口一目人乙
踉	口卜言添又
牘	川又二目目
佃	川添曲卜
腈	月一三卜月
腊	月一十一曲
膺	广大川川月
焐	米人二又口
洱	添添三十
衲	之广目寸人
邏	之一目巛川
蛩	二卜月言口
琶	三一三一乙
菟	十卜儿儿言
薌	十卜巛又乙
稷	竹梄曲人儿
簣	竹言口一目
笈	竹言乙添人
鱟	川二人人儿
鄣	言米曲十乙
痙	广一一巛二
惲	米卜之之梄
冨	之之一口曲
韞	又口口曲目
蘼	十卜广梄曲
螅	口巛川目之
嚯	口一梄添川
篪	竹言斤寸卜
夊	儿卜
誹	言寸曲三
讖	言寸人曲一
燻	米人竹二米
沮	添添目三
轡	梄曲巛巛口
挹	寸添口一乙
逑	之一一曲言
鞅	十十目寸大
桜	梄一添寸巛
蚧	口巛人寸川
骯	目之言一月
笏	竹言儿乙斤
鎦	斤一儿竹曲
酋	米寸梄寸
鎏	添添言川斤
滁	添添乙人竹
媸	巛竹巛一口
媧	巛竹目口
并	米一十卜
苫	十卜卜寸口
楸	梄一竹梄米
檳	梄一之曲目
賾	七一三卜目
迓	之一七卜
匱	七添口一目
蛘	口巛米三
踵	口卜竹曲二
炅	曲一米人
罹	目曲米卜川
笱	竹言儿乙口
鈹	斤一又卜
肼	月一二寸川
臏	月一之曲目
鮃	儿一一米十
旃	言乙竹月言
懊	米卜川米大
涫	添添之寸乙
瀰	添添乙人人
遽	之一卜七大
陛	乙口儿儿二
紸	巛一言添三
觳	二二之月月
鬩	三三川二儿
摶	寸添梄曲寸
揸	寸添梄曲一
苊	十卜大大乙
萄	十卜儿十巛
薜	十卜又口言
囈	口一十二巛
嚦	口一大竹卜
崆	目目之人二
佽	川添广寸儿
銖	斤一竹一梄
獺	月竹梄儿目
脘	月一之一一
芻	儿乙巛儿巛
贇	言人一卜目
惻	米卜目人曲
闈	又寸又口十
嫵	巛竹竹十米
舂	三人川二
璦	三一斤之儿
蔦	十卜儿巛
橢	梄一乙二月
达	之一大寸
唇	大七口一
豕	大月
呎	口一又竹言
嵊	目目竹广儿
睋	目一竹寸七
幃	目卜又口十
况	广寸口一儿
褰	之寸十人言
冗	之之月寸
恵	一添曲二之
薨	十卜目儿儿
蓀	十卜乙竹巛
葒	十卜巛一二
鏨	梄曲斤寸斤
椴	梄一川三月
齶	卜人口一一
噲	口一人目曲
雎	目三川卜
鏂	斤一七口口
腩	月一十目米
鮫	儿一言人人
謫	言寸言十口
瘴	广一言曲十
憚	米卜口曲一
満	添添十目目
浼	添添儿口儿
閬	又寸言添又
媼	巛竹口人目
絀	巛一巛曲巛
芎	十卜乙巛
酊	梄寸一卜
笞	竹言巛言口
侮	川添竹一巛
胱	月一曲人一
肓	言七月一
痧	广一添曲竹
袢	之广米二
黿	一添一儿之
髡	三七斤三一
擢	寸添乙乙川
麴	梄一人儿米
厴	大大曲大曲
嘁	口一七卜曲
罅	竹一十米寸
佼	川添言人人
侷	川添又乙口
釔	斤一乙七
鑠	斤一川巛梄
亳	言一口竹七
悴	米卜言人十
閌	又寸言一月
壎	二一竹二米
菓	十卜曲卜梄
梆	梄一三卜乙
乩	卜寸口一巛
呶	口一巛竹又
賂	目人儿卜口
誄	言寸三卜梄
疽	广一目三
淄	添添巛寸曲
逅	之一斤一口
逄	之一儿卜十
亜	二巛
堺	二一曲人川
擷	寸添二口大
菽	十卜卜曲又
蓖	十卜川儿儿
菔	十卜月乙又
苧	十卜之寸一
蟆	口巛十曲大
齪	卜人口卜
嘭	口一二米斤
尜	曲人大寸曲
嵋	目目又竹目
佤	川添一巛
鼾	川目曲川一
鎩	斤一人梄月
凊	广寸三卜月
猷	米寸梄寸大
閎	又寸大寸巛
閿	又寸斤之又
卩	乙目
縭	巛一言目巛
螚	巛言月儿口
萁	十卜十三
葩	十卜川曲乙
蛐	口巛曲曲
勖	曲一目一乙
岜	目目乙曲
笪	竹言曲一一
舐	竹卜儿七
佶	川添二二口
倨	川添又十口
餒	人又斤添巛
鳧	儿巛月寸
詿	言寸二一二
溉	添添又七儿
赭	二一米人二
檠	十卜儿竹梄
桅	梄一儿大乙
眥	卜卜儿儿目
訾	卜卜儿儿言
嘹	口一一曲曲
嚀	口一之目一
犇	竹二竹二竹
伝	川添二寸巛
鱘	儿一又口寸
諟	言寸曲一卜
庠	广大米三
慳	米卜七又二
慟	米卜竹二乙
葙	十卜梄一目
杈	梄一又言言
砧	大一卜寸口
蛉	口巛人寸之
蟀	口巛言添十
咭	口一二二口
嚙	口一卜人
飫	人又竹添大
鈰	斤一言一目
惕	米卜曲儿斤
惘	米卜目米言
惦	米卜广卜口
潦	添添一曲曲
窠	之人曲卜梄
裨	之广川口十
迨	之一巛言口
矸	大一一十
贗	大大川儿目
蜓	口巛乙竹二
嘵	口一二二一
唚	口一又之又
餼	人又竹乙米
褻	言儿二二月
袞	言儿人一口
懍	米卜言口竹
褔	之广一口曲
蚩	巛曲一添口
櫱	巛曲竹言梄
殯	一添儿曲目
耒	三卜梄一
芄	十卜月口
榷	梄一之之川
奄	大寸曲梄
碚	大一言米口
喑	口一言米曲
鋨	斤一竹寸七
繇	斤添竹竹巛
裾	之广又十口
窈	之人巛巛乙
豉	一添口十又
箌	竹言七二曲
讜	言寸曲二米
劾	言一巛人乙
憧	米卜言曲二
裑	之广川三
裼	之广曲儿斤
孿	言寸巛巛乙
嫠	二寸梄大巛
琇	三一竹乙竹
荏	十卜川竹二
蘢	十卜言卜
杪	梄一曲人竹
榔	梄一言又乙
隹	川卜
餳	人又曲儿斤
鉺	斤一三十
鎌	斤一米曲人
旆	言乙竹一目
癇	广一又寸月
燧	米人之米大
遑	之一川曲三
橐	一添口大梄
圪	二一竹一乙
嗇	二一人口口
駢	三米米一十
藪	十卜曲巛竹
芃	十卜月言
槭	梄一七卜曲
棰	十卜竹十二
噥	口一曲曲大
嗥	口一川大十
峴	目目目儿
岣	目目儿乙口
佉	川添二一巛
魈	川口曲人月
頎	斤寸大人
鏌	斤一十曲大
颼	月卜川卜又
詵	言寸竹二儿
諢	言寸之之梄
覚	添寸之之目
瀬	添添梄口大
珥	三一三十
駟	三米目曲
茤	十卜儿言儿
砭	大一竹添之
碓	大一川卜
蟑	口巛言曲十
蚓	口巛乙巛卜
嗵	口一之又月
嵴	目目添人月
憩	竹卜川目之
俁	川添口巛大
臚	月一卜曲目
昝	儿卜卜寸曲
隗	乙口川口
繾	巛一之一乙
紉	巛一乙寸言
壊	二一十目言
琚	三一又十口
葫	十卜十口月
鞣	十十又川梄
顴	十卜口川大
蕕	十卜月米梄
醴	梄寸曲口米
饜	大大曲大人
齠	卜人乙寸口
顒	曲一目巛大
嘗	曲人之儿曲
嵛	目目人月曲
牯	竹二十寸口
簟	竹言梄曲十
笮	竹言竹一卜
囪	川口斤三言
儈	川添人目曲
鷂	斤添竹巛儿
譲	言寸言人十
麝	广又川三寸
沌	添添一添巛
勰	乙竹乙曲之
婀	巛竹乙一口
縞	巛一言目口
瑁	三一曲一目
綦	十三巛一
齷	卜人又竹七
喋	口一十巛梄
躋	口卜言儿川
瓴	人寸之一一
毖	儿儿儿之竹
悽	米卜一又巛
愫	米卜三卜巛
悚	米卜梄一口
搴	之寸十人竹
朶	乙添竹添梄
増	二一米曲曲
菋	十卜口二梄
驀	十卜曲大三
醪	梄寸乙人斤
囀	口一梄梄寸
趿	口卜乙添人
蹌	口卜人之口
嗍	口一米巛月
杲	曲一梄一
暘	曲一曲儿斤
骷	目之十寸口
爨	川二目大米
羸	言七口米月
誶	言寸言人十
廄	广大又人月
瀲	添添人人竹
攫	寸添目川又
茼	十卜目一口
齜	卜人卜卜儿
圜	口寸目口儿
秣	竹梄一添梄
僭	川添七儿曲
囟	川口人言
鑭	斤一又梄目
鰳	儿一十十乙
鰨	儿一曲乙乙
慊	米卜米曲人
媯	巛竹斤米
鞀	十十乙寸口
樅	梄一人人卜
団	口寸寸言
罌	目人目十巛
儔	川添二口寸
羶	米三言曲一
汨	添添曲一
閼	又寸言人广
閽	又寸儿七曲
閡	又寸言巛人
譬	又竹口言言
縹	巛一梄口二
摒	寸添又米十
齬	卜人二又口
嘧	口一之竹目
嵬	目目川口
瞑	目一之言人
穡	竹梄二口口
氪	竹乙十口儿
笳	竹言乙竹口
魃	川口大言又
佸	川添竹卜
艉	斤乙又竹竹
穌	儿一竹梄
浯	添添二又口
溱	添添三人竹
阡	乙口竹十
璩	三一卜七大
醮	梄寸川卜米
硤	大一大人人
蠊	口巛广曲人
圉	口寸二一米
嚓	口一之又二
纍	曲卜曲曲巛
賙	目人月二口
豺	斤月寸言竹
獐	月竹言曲十
旄	言乙竹一竹
広	广大巛言
糝	米梄巛人斤
泖	添添儿竹
溏	添添广又口
裉	之广又人
戸	之竹
琺	三一添二巛
芟	十卜月又
棖	梄一三七
柜	梄一七添又
蚨	口巛二言
蟶	口巛三口三
俎	人寸人寸目
肫	月一一添巛
糍	米梄米巛巛
槊	米一巛月梄
涑	添添梄一口
涪	添添言米口
漉	添添广又
緄	巛一曲儿儿
彗	三卜三卜又
鞦	十十竹梄米
莔	十卜口人目
躉	十卜曲巛口
櫪	梄一大竹卜
齔	卜人儿儿
屾	目目目目
鶻	目之儿巛
泱	添添目寸大
泫	添添言一巛
鴆	之之儿寸儿
帚	又二之之目
埕	二一口一三
珪	三一二一二
瑗	三一斤大又
茁	十卜巛曲巛
檄	梄一川言竹
竽	竹言一添寸
稗	竹梄川口十
佺	川添人寸三
鍆	斤一又寸
鯢	儿一川二儿
戠	言米曲一七
咨	广寸儿人口
淀	添添之一卜
謇	之寸十人言
逖	之一月竹米
羋	卜添卜卜二
靼	十十曲一一
莋	十卜川竹卜
唵	口一大寸曲
吩	口一人一乙
哞	口一巛言竹
羆	目曲巛儿米
嶧	目目目二米
迤	之一竹一乙
秈	竹梄目目
簞	竹言口曲一
佞	川添二寸巛
鉿	斤一人一口
艫	斤乙卜曲目
諉	言寸竹梄巛
瘍	广一曲儿斤
憒	米卜口一目
郯	米人米人乙
邋	之一巛人巛
闐	又寸十目人
孃	巛竹言口十
縊	巛一米人目
垌	二一目一口
璀	三一目目川
芘	十卜儿儿儿
蹩	目卜添竹口
昉	曲一言乙
鱈	儿一梄添又
鮒	儿一川添寸
涿	添添大月
鼐	乙添竹巛川
戛	一添川目七
髪	三七斤大又
瑀	三一竹目巛
驄	三米川儿之
璣	三一巛七人
芨	十卜乙添人
蠓	口巛十一大
蚪	口巛广寸十
吒	口一竹添七
瞋	目一十目人
毎	竹一巛乙十
倥	川添之人二
猓	月竹曲卜梄
頫	儿寸添添大
褥	之广大七寸
嬖	又竹口言巛
孀	巛竹梄梄目
縋	巛一之竹乙
珣	三一儿乙曲
璘	三一米儿十
菠	十卜添添又
卣	卜寸口寸又
嚶	口一目目巛
跚	口卜月月一
嶷	目目儿又卜
牖	川又之竹梄
徨	人卜川曲三
鉄	斤一竹二人
豸	斤月
溧	添添梄口梄
寀	之寸斤添梄
阱	乙口二寸川
愍	乙二七竹之
皴	巛言人儿又
撳	寸添斤一儿
蘺	十卜言巛川
櫸	梄一川人二
磣	大一巛人斤
蠐	口巛言儿川
咑	口一寸添一
踔	口卜卜曲十
黜	目曲二巛巛
崍	目目梄人人
魎	川口一人人
偸	川添人月巛
兗	言一人口儿
淝	添添月一乙
鷸	又言又口儿
続	巛一二之儿
梘	梄一目儿
虺	一儿口巛
磋	大一米三二
蠛	口巛十七言
蠖	口巛十川又
哃	口一目一口
吽	口一竹二
徘	人卜曲三
粼	米梄儿十巛
烊	米人米三
紆	巛一一添寸
紈	巛一月口
埗	二一卜卜曲
鄹	三十又大乙
瓁	三一十川又
鸛	十卜口川儿
蓑	十卜言儿曲
酢	梄寸竹一卜
醌	梄寸曲儿儿
樘	梄一曲口二
楦	梄一之二曲
蜒	口巛乙竹卜
唲	口一川二儿
咜	口一之寸儿
彫	月添二口斤
偲	川添曲卜之
鐿	斤一言曲之
胂	月一曲梄
忤	米卜竹一十
潶	添添目二米
紜	巛一二寸巛
艽	十卜月乙
醭	梄寸曲米米
蜡	口巛十一曲
蚝	口巛竹七
嚨	口一言卜
毬	竹七一曲言
鍖	斤一十三巛
鏍	斤一曲卜巛
癜	广一又人月
沭	添添梄一言
滓	添添之寸言
娌	巛竹曲卜二
繒	巛一米目曲
跫	二卜月言口
鏊	三卜乙竹斤
葶	十卜言之一
酞	梄寸大寸言
榱	梄一言儿曲
槨	梄一言乙乙
郟	大寸人人乙
踴	口卜又月乙
兎	竹添口儿言
倳	川添一口又
煳	米人十口月
嬛	巛竹目口儿
嫚	巛竹曲目又
驃	三米梄口二
柰	梄一二曲
桁	梄一人卜
蜱	口巛川口十
餚	人又人大月
鯀	儿一竹添巛
郞	言添又人乙
恫	米卜目一口
憔	米卜川卜米
剡	米人米人曲
姫	巛竹七一
彀	二二之乙月
珅	三一曲梄
萿	十卜添添竹
雹	梄添儿乙乙
橄	十卜又三竹
匚	七添
蟛	口巛二米斤
咴	口一大寸米
噈	口一言曲大
冏	目寸人一口
髕	目之之曲目
値	川添十目巛
俶	川添卜曲又
皚	川曲目口米
錈	斤一米二乙
遒	之一米寸梄
畑	米人曲卜
衩	之广又言言
嬙	巛竹二口口
媄	巛竹米三大
圮	二一乙乙
耔	三卜梄一乙
揆	寸添又一大
苤	十卜大卜一
苴	十卜目三
苻	十卜川添寸
婪	梄一梄一巛
櫫	大月二竹梄
碉	大一月二口
咼	目口
倬	川添卜曲十
饉	人又十口三
彳	人卜
譎	言寸又人口
奘	巛大二二大
痱	广一曲三
疙	广一竹一乙
浞	添添口卜
湔	添添米月曲
潺	添添又乙乙
袷	之广人一口
爿	巛大
鸝	一添目广儿
驤	三米言口十
覲	十一口三目
鄞	十一口三乙
蕗	十卜口儿口
梶	梄一又竹竹
邨	一添巛曲乙
鹺	卜寸口米二
鼉	口一口一之
鴰	竹卜儿巛
伲	川添又竹儿
劬	儿乙口一乙
炤	米人乙寸口
単	添寸曲乙一
閶	又寸曲一曲
恿	又言月二之
坍	二一月添言
垸	二一之一一
鬟	三七斤口儿
耪	三卜梄之言
芑	十卜乙乙
逋	之一梄二
蚶	口巛十二
曷	曲一儿人巛
侈	川添儿言儿
刖	月一曲寸
獯	月竹竹二米
觶	儿添月曲一
鰍	儿一竹梄米
旒	言乙竹巛川
忖	米卜寸言
惆	米卜月二口
閂	又寸一添
邐	之一一言广
鬮	三三竹添之
驁	三卜乙竹三
掇	寸添又又又
鶘	十寸口月儿
鞫	十十儿乙言
槲	梄一儿广十
齟	卜人目三
噺	口一言梄斤
韙	曲一一口十
冄	目寸二寸
鸚	目人目巛儿
鉦	斤一一添卜
鋟	斤一又之又
錙	斤一巛寸曲
猗	月竹大一口
堃	言乙言乙二
沔	添添一巛乙
灕	添添言巛川
窨	之人言米曲
厾	乙七二一巛
緦	巛一曲卜之
耄	二竹儿儿竹
杴	梄一儿人
蚵	口巛一卜口
蛄	口巛十寸口
蠣	口巛大目巛
篦	竹言川儿儿
俳	川添曲三
錸	斤一梄人人
鐐	斤一一曲曲
獬	月竹儿乙竹
胝	月一儿七言
礱	言卜大一
濉	添添目一川
洺	添添儿言口
邃	之一之米大
屐	又竹人十又
経	巛一又言二
殄	一添儿人斤
瞽	二二口又目
鷙	二一米月儿
験	三米人口人
蠆	十卜曲巛口
芴	十卜儿乙斤
楝	梄一梄一目
鶇	梄曲儿巛
耷	大寸三十
曛	曲一竹二米
稹	竹梄十目人
氤	竹乙口寸大
込	之一人寸
臆	月一言曲之
髙	言一卜目口
埸	二一曲儿斤
拊	寸添川添寸
荑	十卜大寸乙
芤	十卜乙一巛
榧	梄一七添曲
砑	大一七卜
垡	川添七竹二
倮	川添曲卜梄
徇	人卜儿乙曲
鑷	斤一三三三
鑌	斤一之曲目
腆	月一目十人
胗	月一人寸斤
瘢	广一斤乙月
遨	之一三乙竹
弢	乙巛巛曲又
緙	巛一十十
駑	巛竹又言三
擤	寸添川一川
匏	大寸一儿乙
尷	大儿七竹目
蝴	口巛十口月
虼	口巛竹一乙
曈	曲一言曲二
澩	川二人人曲
餱	人又川又竹
粿	米梄曲卜梄
渀	添添大十十
宄	之寸月乙
隳	乙口大人米
堋	二一月一月
菹	十卜添添目
酐	梄寸一十
櫳	梄一言卜
哚	口一月寸梄
眭	目一二一二
鴦	目寸大寸儿
峰	目目儿卜三
侞	川添巛竹口
飩	人又一添巛
餾	人又儿竹曲
銣	斤一巛竹口
胛	月一曲乙
腴	月一川二人
獰	月竹之目一
詁	言寸十寸口
諑	言寸大月
訃	言寸卜寸
疳	广一十二
癤	广一竹又乙
惴	米卜目目大
怺	米卜言添曲
窕	之人儿寸添
陟	乙口卜卜曲
悪	二巛之巛
鼙	二二口川十
聵	三十口一目
鴣	十寸口一儿
蕈	十卜梄曲十
蘄	十卜口一斤
薺	十卜言儿川
釅	梄寸口三竹
楂	梄一梄曲一
楫	梄一口一三
碭	大一曲儿斤
戔	七竹七竹
呻	曲一曲梄
叺	口一人寸
咄	口一巛曲巛
崞	目目言口乙
嶗	目目米之乙
骼	目之儿卜口
籙	竹言斤又曲
魍	川口目米言
僉	人寸一人人
饅	人又曲目又
餛	人又曲儿儿
鍐	斤一人人儿
狎	月竹曲乙
麾	广大梄梄竹
羝	米三儿七言
糲	米梄大目巛
憷	米卜梄又卜
煋	米人曲一竹
燚	米人米米米
窣	之人言人十
窸	之人斤梄之
褡	之广十一口
闍	又寸二竹
閞	又寸巛言十
嬗	巛竹言曲一
絵	巛一人二巛
邛	二卜乙口
玎	三一一卜
瑚	三一十口月
琿	三一之之梄
玘	三一乙乙
茈	十卜卜卜儿
藎	十卜又米目
椐	梄一又十口
螞	口巛三米
蜘	口巛竹大口
嗉	口一三卜巛
唁	口一言寸
躚	口卜之大乙
筮	竹言二人人
箜	竹言之人二
瓮	人一巛言一
鈸	斤一大言又
錮	斤一口十口
鍤	斤一竹十川
鯁	儿一一曲人
鰱	儿一之一梄
粳	米梄一曲人
遄	之一目目大
裰	之广又又又
鞴	十十十竹月
蘩	十卜竹竹巛
麩	梄一人儿二
碲	大一言之目
觜	卜卜儿儿月
跏	口卜乙竹口
唎	口一竹梄曲
崚	目目二人儿
仵	川添竹一十
歙	人寸一乙儿
鏇	斤一言又卜
諄	言寸言口乙
竜	言米曲梄
蠲	米一人儿口
粞	米梄梄口
湢	添添一口曲
涳	添添之人二
蟊	又言又口口
媲	巛竹川儿儿
緱	巛一川又竹
繅	巛一巛曲梄
盍	二一巛言目
扦	寸添竹十
萵	十卜目口
菪	十卜之寸大
棱	梄一二人儿
輳	梄曲三一大
蛞	口巛竹卜
笤	竹言乙寸口
傀	川添川口
飪	人又竹添二
胭	月一口寸大
謄	月一米二言
殳	月又
旮	月乙曲一
悻	米卜二一米
巛	巛寸
埝	二一人又之
圯	二一乙二
栲	梄一二竹一
朮	十寸儿寸言
榊	梄一二曲曲
砹	大一十卜人
図	口寸广寸人
跣	口卜竹二儿
邾	竹一梄一乙
氚	竹乙川寸
俷	川添月一乙
譕	言寸竹十米
瓿	言米口一一
潢	添添十曲人
漷	添添言乙乙
辶	之一
禳	二曲言口十
鬻	乙巛米米一
綆	巛一一曲人
彘	巛又儿竹儿
殛	一添儿又一
堊	二巛二一
琵	三一三儿儿
頊	三一大人
拮	寸添二二口
枡	梄一竹添十
砟	大一竹一卜
骱	目之人寸川
笸	竹言七添口
頷	人寸言口大
鋃	斤一言添又
狻	月竹巛人儿
鴇	儿儿十寸儿
鴟	儿七言添儿
邙	言七乙口
悌	米卜米乙川
淠	添添曲一川
嫫	巛竹十曲大
妣	巛竹儿儿儿
餮	一添儿斤人
赳	二人巛卜
埽	二一又之目
圾	二一乙添人
荖	十卜二竹儿
薅	十卜巛大寸
樗	梄一梄一一
柞	梄一竹一卜
欹	大寸一口儿
蠼	口巛目川又
跆	口卜巛言口
嗐	口一之三口
黙	曲卜二大米
嵯	目目米三二
牝	竹二儿儿
怹	川添乙卜之
鏑	斤一言十口
瘛	广一三乙之
巻	米二乙乙
懌	米卜目二米
瀞	添添三儿又
漵	添添人竹竹
漈	添添儿又二
滂	添添言之言
繻	巛一梄添大
糶	巛曲巛乙川
嫘	巛竹曲卜巛
橛	梄一大巛儿
骺	目之斤一口
笊	竹言斤添
倀	川添三七
倜	川添月二口
皈	川曲斤寸又
鈳	斤一一卜口
鯛	儿一月二口
怙	米卜十寸口
滹	添添卜米寸
蔠	十卜巛儿广
撃	梄曲月又竹
槁	梄一言目口
酃	梄添口口乙
奩	大寸七口口
鴯	大目儿巛
郾	七添曲巛乙
畋	曲卜竹人
髀	目之川口十
穰	竹梄言口十
獗	月竹大巛儿
謅	言寸儿儿巛
癭	广一目目巛
羰	米三目大米
愴	米卜人之口
窬	之人人月曲
嬿	巛竹十儿米
砉	三卜大一
抉	寸添又添大
莩	十卜斤添乙
迣	之一十一巛
柩	梄一七儿言
蚰	口巛曲二
螳	口巛曲口二
蛑	口巛巛言竹
咆	口一儿乙乙
篋	竹言七人人
価	川添梄口
翕	人寸一乙乙
郄	人言大巛乙
朐	月一儿乙口
夤	儿言之曲人
窳	之人斤言斤
劼	二二口一乙
踅	寸添斤寸口
蘧	十卜之卜大
杼	梄一又又卜
磽	大一二二一
鳪	卜寸儿巛
蚋	口巛目寸人
跗	口卜川添寸
侔	川添巛言竹
艚	斤乙一曲曲
郇	儿乙曲一乙
裎	之广口一三
冢	之之大月
陔	乙口言巛人
埵	二一竹十二
瑭	三一广又口
醺	梄寸竹二米
喟	口一曲卜月
咐	口一川添寸
蜚	曲三口巛
旯	曲一月乙
嶙	目目米儿十
甥	竹三曲卜乙
篾	竹言目七言
皤	川曲斤梄曲
敫	川曲言乙竹
鵜	米寸乙川儿
洄	添添口寸口
裟	添添曲竹言
弭	乙巛三十
媾	巛竹十目二
緡	巛一乙七曲
莨	十卜言添又
櫺	梄一梄口口
霹	梄添又口言
邳	大卜一添乙
蟪	口巛梄曲之
歳	卜卜七一曲
蚣	口巛人一巛
跎	口卜之寸儿
呉	口一巛一人
嶝	目目又口米
嶁	目目曲口巛
郃	人寸一口乙
貘	斤月十曲大
読	言寸二之儿
紶	巛一二一巛
婞	巛竹二一米
靑	三卜目卜一
苾	十卜之巛竹
霑	梄添添卜口
蝽	口巛三人
犧	竹二米七一
恂	米卜儿乙曲
夬	又添大寸
翮	一添口乙乙
両	一添目寸目
邴	一添目人乙
玠	三一人寸川
蕤	十卜大月竹
鷯	一添米曲儿
蚱	口巛竹一卜
趵	口卜儿乙言
帰	曲寸又之目
罟	目曲十寸口
矍	目一目川又
峋	目目儿乙曲
嶋	目目儿巛
髏	目之曲口巛
嚳	川二人竹口
皁	川曲十寸
齎	言一米川目
萆	十卜川口十
槔	梄一川大十
磴	大一又口米
蟣	口巛巛七人
畛	曲卜人寸斤
岈	目目七卜
犍	竹二乙又二
釤	斤一斤三
臃	月一言巛川
譖	言寸七儿曲
廛	广大曲人二
愎	米卜竹曲儿
茚	十卜斤添乙
軛	梄曲大大乙
匴	七添竹目十
曩	曲一言口十
暾	曲一言乙竹
罱	目曲十目米
岵	目目十寸口
畬	人寸竹梄曲
粢	广寸儿人米
庀	广大儿儿
湎	添添又口目
鐾	又竹口言斤
総	巛一人巛之
炱	巛言口一米
墻	二一二口口
摜	寸添巛乙目
苜	十卜目一
硨	大一梄曲
錁	斤一曲卜梄
窆	之人竹添之
聴	三十十目之
瑠	三一儿竹曲
搧	寸添之乙乙
藿	十卜梄添川
薱	十卜曲米寸
葰	十卜川人儿
茭	十卜言人人
菑	十卜巛寸曲
霎	梄添言米巛
蛺	口巛大人人
蜿	口巛之儿乙
昃	曲一大大人
簸	竹言十三又
佹	川添儿大乙
儕	川添言儿川
剣	人寸一人曲
艋	斤乙乙一目
齏	言一米曲一
鶿	米一巛巛儿
炆	米人言人
惋	米卜之儿乙
湓	添添人乙目
褆	之广曲一卜
蓁	十卜三人竹
萣	十卜之一卜
柊	梄一儿卜广
泅	添添口寸人
紱	巛一大言又
擯	寸添之曲目
搡	寸添又又梄
帯	十一之之目
酹	梄寸斤添寸
雩	梄添一添一
靂	梄添大竹卜
兕	口寸巛卜儿
帙	目卜竹二人
簌	竹言梄口儿
穂	竹梄一曲之
僂	川添曲口巛
鄱	斤梄曲卜乙
獍	月竹言曲儿
廩	广大言口竹
瀠	添添米之巛
韝	又口口目二
顙	又言又梄大
綈	巛一米乙川
堝	二一目口
辻	之一十寸
蔵	十卜七大七
晷	曲一儿卜口
筇	竹言二卜乙
賃	川添竹二目
鐙	斤一又口米
脒	月一米梄
炻	米人大一
泔	添添十二
専	一添曲二寸
墀	二一又曲竹
挈	三卜乙寸竹
玹	三一言一巛
騅	三米川卜
嘏	十寸口又又
蓽	十卜曲十二
転	梄曲二寸巛
弍	七言二寸
蟯	口巛二二一
圏	口寸米二乙
豊	曲曲一口米
衄	竹添目又卜
儻	川添曲二米
狆	月竹口口
痤	广一人人二
塋	米人米之二
煢	米人米乙十
惇	米卜言口乙
溲	添添川卜又
鷚	乙广乙斤儿
丌	一添川寸
掾	寸添巛又大
萩	十卜竹梄米
崤	目目人大月
仃	川添一卜
倗	川添月一月
鈁	斤一言乙
艏	斤乙米一川
狷	月竹口一月
肷	月一儿人
鯖	儿一三卜月
麋	广又米梄
逶	之一竹梄巛
辺	之一乙寸
縲	巛一曲卜巛
絎	巛一人卜
銎	二卜月言斤
鞔	十十儿口儿
櫨	梄一卜曲目
瓠	大寸一一斤
蚯	口巛斤二
圇	口寸人目十
圊	口寸三卜月
蹕	口卜曲十二
罨	目曲大寸曲
簹	竹言曲口曲
簋	竹言又人目
氘	竹乙川寸
邉	之一川之口
徦	人卜又又又
艄	斤乙曲人月
煺	米人之一又
泚	添添卜卜儿
湝	添添儿儿川
褳	之广之一梄
璠	三一斤梄曲
夼	大寸川寸
蠕	口巛梄添大
蹼	口卜曲米米
暌	曲一又一大
眇	目一曲人竹
儐	川添之曲目
鈽	斤一大寸目
釙	斤一卜寸
詆	言寸儿七言
馘	米一川口一
襦	之广梄添大
遢	之一曲乙乙
逡	之一巛人儿
婼	巛竹十大口
縟	巛一大七寸
鬲	一添口米一
殫	一添儿曲一
螫	二一米竹口
騕	三米梄口巛
藶	十卜大竹卜
酩	梄寸儿言口
砘	大一一添巛
戢	口一三十七
噦	口一卜一曲
躂	口卜之二米
跩	口卜曲梄竹
旰	曲一一十
篳	竹言曲十二
鍑	斤一竹曲儿
鎪	斤一川卜又
脳	月一添人巛
鴝	儿乙口一儿
応	广大之巛
愬	米一巛月之
滎	米人米之曲
濞	添添川一川
窶	之人曲口巛
穸	之人儿言
弾	乙巛添曲一
薍	十卜斤又巛
蔟	十卜言竹竹
蕖	十卜添又梄
硭	大一十卜言
吲	口一乙巛卜
氙	竹乙目目
璺	川二目三言
鷦	川卜米言儿
徂	人卜目三
錆	斤一三卜月
刎	儿乙斤三曲
燔	米人斤梄曲
洸	添添曲人一
瀵	添添米十人
宬	之寸七大乙
綪	巛一三卜月
玦	三一又添大
蔞	十卜曲口巛
繋	梄曲月又巛
榿	梄一目口米
硇	大一川口人
跬	口卜二一二
牸	竹二之寸乙
簑	竹言言儿曲
仮	川添斤寸又
傛	川添之人口
辵	斤三卜卜
舾	斤乙梄口
颺	月卜曲儿斤
膾	月一人目曲
憮	米卜竹十米
泐	添添乙口乙
褸	之广曲口巛
衽	之广竹添二
闘	又寸一米寸
擘	又竹口言竹
綞	巛一竹十二
縑	巛一米曲人
鵡	一添七卜儿
玢	三一人一乙
喥	口一广十又
笹	竹言十一巛
篔	竹言口一目
餞	人又七竹七
錟	斤一米人米
舯	斤乙口口
隈	乙口曲一儿
戞	一添川之七
薤	十卜一曲一
剽	梄口二曲曲
僰	梄一目目人
枇	梄一儿儿儿
砝	大一二一巛
劌	卜卜七曲曲
蟈	口巛口口一
囹	口寸人寸之
罾	目曲米目曲
笓	竹言儿儿儿
佧	川添卜一卜
俜	川添曲二一
仡	川添竹一乙
儋	川添儿人言
舳	斤乙曲二
胙	月一竹一卜
愜	米卜七人人
沬	添添二寸梄
潒	添添儿口大
瀼	添添言口十
鄆	之之梄曲乙
叚	又竹二又又
隠	乙口斤又之
垓	二一言巛人
枸	梄一儿乙口
蝟	口巛曲卜月
秫	竹梄梄一言
笶	竹言竹大
餑	人又十之乙
愆	人卜添添之
猊	月竹川二儿
詛	言寸目三
瘩	广一十一口
疥	广一人寸川
迢	之一乙寸口
隰	乙口曲巛米
畚	巛言大寸曲
甏	二二口斤一
堠	二一川又竹
醅	梄寸言米口
椛	梄一十川儿
輅	梄曲儿卜口
梃	梄一乙竹二
霊	梄添二寸曲
曌	曲一月之二
舎	人寸二一口
涘	添添巛言竹
哿	乙竹口一口
珙	三一十一人
葚	十卜十三巛
蒝	十卜大川曲
萑	十卜川卜
櫝	十卜二目目
蚺	口巛目寸二
螄	口巛竹一目
蚍	口巛儿儿儿
嶇	目目七口口
幗	目卜口口一
筌	竹言人寸三
鵂	川添梄一儿
鴒	人寸之一儿
謳	言寸七口口
痌	广一目一口
愾	米卜竹乙米
捯	寸添七二曲
摭	寸添广十米
葜	十卜三乙大
榦	十寸曲人梄
藁	十卜言口梄
醢	梄寸大口目
喞	口一川儿乙
屼	目目一儿
烀	米人竹米寸
繴	又竹口言巛
紇	巛一竹一乙
絯	巛一言巛人
坼	二一斤寸言
柟	梄一目寸二
巰	一添巛巛川
鬯	人言巛卜儿
鐠	斤一米曲曲
鯃	儿一二又口
糅	米梄又川梄
嫗	巛竹七口口
鬨	三三十一人
嶅	三卜乙竹目
騮	三米儿竹曲
莠	十卜竹乙竹
茳	十卜添添二
暁	曲一十十一
偅	川添竹曲二
錡	斤一大一口
鏹	斤一乙口口
亀	儿添曲一曲
鶼	米一又人儿
烜	米人二寸曲
湁	添添寸一口
袼	之广儿卜口
甓	又竹口言一
乸	乙卜巛乙
紾	巛一人寸斤
螂	口巛言又乙
暹	之一曲一川
帔	目卜又卜
佾	川添人一月
肜	月一斤三
胳	月一儿卜口
瘠	广一添人月
翥	二竹乙广乙
聃	三十目寸二
髟	三七斤三
栢	梄一一添川
酡	梄寸之寸儿
櫧	梄一言寸二
杷	梄一乙曲
篠	竹言川儿梄
箛	竹言乙一斤
鋏	斤一大人人
鐓	斤一言乙竹
凪	月寸卜卜
颶	月卜目三人
糀	米梄十川儿
淰	添添人又之
滃	添添人乙乙
済	添添言人川
湴	添添米一曲
鷥	巛一巛一儿
琯	三一之寸乙
卌	一添曲寸曲
艨	斤乙十一大
誃	言寸儿言儿
慄	米卜梄口梄
鵓	十寸之乙儿
薷	十卜梄添大
萢	十卜添儿乙
楛	梄一十十口
櫬	梄一言梄目
柁	梄一之寸儿
黠	目曲二二口
迕	之一竹一十
観	竹二川卜目
稲	竹梄斤卜曲
俓	川添一巛二
鵯	川口十寸儿
偓	川添又竹七
鄯	米三米口乙
悕	米卜人大目
悩	米卜添人巛
澪	添添梄人之
滏	添添人三米
寛	之寸十卜目
襝	之广人人人
険	乙口人口人
醵	梄寸卜七大
碣	大一曲人巛
晡	曲一梄二
矬	竹大人人二
篼	竹言川又儿
徉	人卜米三
舴	斤乙竹一卜
鷄	斤添巛大儿
胩	月一卜一卜
狒	月竹乙巛川
訳	言寸又竹言
麂	广又月寸
忉	米卜乙寸
蓜	十卜梄寸乙
囔	口一一十儿
躒	口卜川巛梄
唦	口一添曲竹
噉	口一又三竹
畎	曲卜大言
乗	竹十十卜梄
毽	竹七乙又二
脿	月一三卜儿
忔	米卜竹一乙
熸	米人七儿曲
湉	添添米卜竹
緶	巛一川曲人
孌	言寸巛巛巛
纛	三卜巛竹巛
荘	十卜广卜二
豳	大月大月目
幄	目卜又竹七
徼	人卜川言竹
猖	月竹曲一曲
鰩	儿一斤十巛
癍	广一三言三
悱	米卜曲三
湞	添添卜寸目
孱	又竹乙乙乙
謦	二二又月言
柙	梄一曲乙
雫	梄添一添卜
嚧	口一卜曲目
瞠	目一曲口二
覬	目目一米目
侏	川添竹一梄
戧	人寸之口七
効	言一人人乙
焜	米人曲儿儿
屮	巛曲
坩	二一十二
琤	三一儿添又
菝	十卜寸大又
茯	十卜川添大
蒍	十卜斤米
蓿	十卜之一川
戡	十三巛添七
蜻	口巛三卜月
圄	口寸二又口
筘	竹言寸添口
簦	竹言又口米
僨	川添十十目
鍰	斤一斤大又
猾	月竹目之
冲	广寸口口
戕	巛大七竹
痊	广一人寸三
渫	添添十巛梄
洶	添添儿人巛
迹	之一言曲
疋	又添卜卜
隍	乙口川曲三
鬣	三七斤人巛
耩	三卜梄目二
駅	三米又竹言
抜	寸添大寸又
揺	寸添斤一巛
蓶	十卜口一川
茽	十卜川添口
蕹	十卜言巛川
蓙	十卜广人二
薬	十卜川添梄
槸	梄一二二月
醍	梄寸曲一卜
轆	梄曲广又
麮	梄一人二巛
桷	梄一儿添月
歴	大大梄梄卜
尥	大儿儿乙言
噱	口一卜七大
唿	口一儿斤之
禸	目寸巛言
黝	目曲二巛乙
缽	竹一十梄一
傕	川添之之川
従	人卜米一卜
敓	人一口儿竹
鋝	斤一斤添寸
蠃	言七口口月
庢	广大七二
瘞	广一大人二
痋	广一口巛
燿	米人乙乙川
漃	添添之曲又
縌	巛一之米巛
郷	巛人又人乙
抔	寸添大卜
椹	梄一十三巛
柢	梄一儿七言
呴	口一儿乙口
蹉	口卜米三二
銭	斤一七竹
鰥	儿一目曲曲
愔	米卜言米曲
溻	添添曲乙乙
漯	添添曲卜巛
窀	之人一添巛
堔	二一之人梄
騸	三米之乙乙
軹	梄曲口一人
貲	卜卜儿儿目
翾	目曲一乙乙
鐃	斤一二二一
廋	广大川卜又
鷓	广大十米儿
痾	广一乙一口
糢	米梄十曲大
惔	米卜米人米
襘	之广人目曲
陘	乙口一巛二
紟	巛一人言又
璵	三一川卜人
萋	十卜一又巛
豨	大月人大目
崦	目目大寸曲
坌	人一乙寸二
鯧	儿一曲一曲
恛	米卜口寸口
洣	添添米梄
邂	之一儿乙竹
繢	巛一口一目
廾	十卜
蓍	十卜二儿曲
榀	梄一口口口
檁	梄一言口竹
榍	梄一又曲月
磔	大一儿十梄
嗏	口一十人梄
峇	目目人一口
岌	目目乙添人
笢	竹言乙二七
皛	川曲川曲川
舨	斤乙斤寸又
亶	言一口曲一
癯	广一目目川
焼	米人十十一
滈	添添言目口
滝	添添言米曲
褟	之广曲乙乙
嫿	巛竹又曲一
菥	十卜梄一斤
菖	十卜曲一曲
栳	梄一二竹儿
杌	梄一一儿
椥	梄一竹大口
桴	梄一斤添乙
螓	口巛三人竹
跽	口卜乙乙之
筅	竹言竹二儿
逭	之一之寸乙
廻	乙言口寸口
弖	乙巛一添
紿	巛一巛言口
嚭	二二口大口
赧	二一米乙又
鋆	二一儿广斤
贄	二一米月目
鬘	三七斤目又
騶	三米儿儿巛
葺	十卜口一三
莛	十卜乙竹二
酔	梄寸月乙十
検	梄一人口人
呺	口一口一一
敤	曲卜梄卜又
幛	目卜言曲十
剴	目目一米曲
籜	竹言寸二米
働	川添竹二乙
舥	斤乙乙曲
腙	月一之寸二
斎	言人川寸二
汩	添添口寸一
禤	二曲目乙乙
劦	乙竹乙竹乙
妺	巛竹一添梄
媔	巛竹又口目
胬	巛竹又人人
儿	儿寸
玷	三一卜寸口
琲	三一曲三
萠	十卜月一月
蔇	十卜又七儿
栖	梄一梄口
柝	梄一斤寸言
砵	大一梄一一
嚅	口一梄添大
箝	竹言寸添十
凭	川添竹二月
佝	川添儿乙口
徥	人卜曲一卜
疔	广一一卜
堍	二一儿儿言
埌	二一言添又
髑	目之目儿口
穏	竹梄斤又之
僤	川添口曲一
仫	川添竹添巛
傯	川添川儿之
颮	月卜儿乙乙
韵	言米曲儿广
翫	乙广乙一一
彅	乙巛米曲乙
嬬	巛竹梄添大
馹	三米曲一
檎	梄一人目巛
踊	口卜又言月
魡	儿一儿乙言
懨	米卜大月大
澔	添添川竹口
渢	添添月卜
幇	二一二寸目
髭	三七斤卜儿
珎	三一儿添曲
虆	十卜曲曲巛
槇	梄一儿巛人
囲	口寸二寸川
暀	曲一人言三
儚	川添十之儿
傖	川添人之口
偝	川添广儿月
糴	人寸米乙川
鐔	斤一梄曲十
肭	月一目寸人
狍	月竹儿乙乙
匐	儿乙一口曲
謌	言寸一一口
懐	米卜言目言
漖	添添二乙竹
獣	添寸曲口大
鼡	添寸月寸二
濆	添添十十目
戻	之竹大寸
陲	乙口竹十二
牁	巛大一卜口
繲	巛一儿乙竹
坻	二一儿七言
掟	寸添之一卜
嚏	口一十又卜
佻	川添儿寸添
敉	米梄竹人
汸	添添言乙
陬	乙口三十又
驂	三米巛人斤
悊	寸添斤寸之
薫	十卜竹二米
蕝	十卜巛儿乙
厎	大大儿七言
覘	卜寸口一目
呰	卜卜儿儿口
嗞	口一米巛巛
鸀	目曲儿口儿
甡	竹三竹三
盥	川二曲添目
躱	川三乙竹梄
仳	川添儿儿儿
欷	人言大目儿
鍜	斤一又又又
魼	儿一二一巛
斉	言人川寸
慬	米卜十口三
営	添寸之口口
栄	添寸之之梄
汔	添添竹一乙
乀	言添
荽	十卜斤添巛
桎	梄一七二
蜞	口巛十三
蛸	口巛曲人月
盱	目一一添寸
溷	添添口寸大
袈	乙竹口一言
覡	二卜人人目
攖	寸添目目巛
蝲	口巛梄口曲
蝂	口巛川斤又
囷	口寸竹梄
趼	口卜一添十
嘽	口一口曲一
簭	竹言二人口
鐖	斤一巛七人
脕	月一儿口儿
夐	儿添目目儿
弚	米寸乙巛卜
澥	添添儿乙竹
扃	之竹目寸口
拏	巛竹又言竹
耜	三卜梄一乙
茛	十卜又人
叶	口一十寸
喰	口一人又
眚	竹三目一
徭	人卜斤十巛
胴	月一目一口
觚	儿添月二斤
繯	巛一目口儿
壢	二一大竹卜
蒎	十卜添斤儿
靉	梄添二之儿
樋	梄一之又月
鵪	大寸曲梄儿
蝰	口巛大二二
氅	曲人目竹竹
晩	曲一儿曲儿
黥	目曲二口曲
嵫	目目米巛巛
贔	目人目人目
倶	川添目一人
鰣	儿一曲二寸
訐	言寸一十
旂	言乙竹一斤
斿	言乙竹一乙
邶	广卜儿儿乙
犖	米人米之竹
溦	添添目月竹
窞	之人儿添川
紒	巛一人寸川
堞	二一十巛梄
聒	三十竹卜
蹂	口卜又川梄
笂	竹言月口
箹	竹言巛儿言
僬	川添川卜米
猙	月竹斤添又
鰈	儿一十巛梄
袱	之广川添大
遴	之一米儿十
纊	巛一广曲人
紼	巛一乙巛川
壚	二一卜曲目
愨	二二之月之
駙	三米川添寸
蘀	十卜寸二米
蓐	十卜大七寸
蔀	十卜言口乙
軽	梄曲又言二
嘂	口一口巛口
巋	目目竹之目
嵂	目目人又二
徴	人卜目三竹
郤	人一人口乙
鏝	斤一曲目又
瘕	广一又又又
滒	添添一一口
叕	又言又又又
璫	三一曲口曲
莃	十卜人大目
樻	梄一口一目
嗾	口一言竹竹
舄	川二儿乙米
疸	广一曲一一
悝	米卜曲卜二
殂	一添儿言目
迋	之一三一
墼	梄曲巛月二
楀	梄一竹目巛
奭	大寸一一川
臸	七二七二
蜩	口巛月二口
鴞	口一一乙儿
黼	曲米目添梄
嵖	目目梄曲一
睺	目一川又竹
侀	川添一十曲
鋱	斤一七言之
鉯	斤一巛言人
塱	言添又月二
頖	米二大人
憍	米卜竹目口
悾	米卜之人二
忸	米卜又二卜
滆	添添一米一
浭	添添一曲人
潵	添添十月竹
洊	添添大卜乙
浥	添添口一乙
迡	之一又竹儿
妁	巛竹儿乙言
毐	二二巛乙竹
捩	寸添之竹大
奓	大寸儿言儿
哫	口一口卜
鯓	儿一川三
渼	添添米三大
紘	巛一大寸巛
豌	一添口儿乙
駘	三米巛言口
頼	梄一口一大
蹚	口卜曲口二
躊	口卜二口寸
嚜	口一目米二
毘	曲卜儿儿儿
嶆	目目一曲曲
簬	竹言口儿口
犵	月竹竹一乙
鮱	儿一二竹儿
讞	言寸卜一大
剤	言人川寸曲
竑	言米大寸巛
瀡	添添乙二月
顁	之寸一卜大
衯	之广人一乙
襞	又竹口言言
姉	巛竹言一目
彖	巛又大月
姙	巛竹川竹二
帑	巛竹又言目
髹	三七斤川梄
揶	寸添三十乙
呬	口一目曲
瞌	目一二巛目
鼯	川二巛又口
猱	月竹又川梄
縻	广大梄梄巛
怦	米卜一米十
忡	米卜口口
渋	添添卜卜添
洫	添添竹添目
濘	添添之目一
榖	二二之梄月
甍	十卜目之一
蒗	十卜添言又
櫞	梄一巛巛大
蝮	口巛竹曲儿
嗼	口一十曲大
呪	口一口一儿
嶒	目目米目曲
顗	目目一米大
歓	竹二川卜儿
龠	人寸一目十
痍	广一大寸乙
懣	添添十人之
渟	添添言之一
褦	之广巛儿儿
娸	巛竹十三
嬢	巛竹言人十
邗	一十乙口
堙	二一梄口二
抨	寸添一米十
蝌	口巛竹广十
哘	口一人卜
矓	目一言卜
臾	川二人寸
螣	月一米二口
夌	二一人一儿
瑢	三一之人口
鞞	十十川口十
蕓	十卜梄二巛
剞	大寸一口曲
綔	大寸一竹巛
囮	口寸川添儿
眄	目一一巛乙
嶈	目目巛儿寸
黐	竹梄人目巛
懞	米卜十一大
湡	添添曲目巛
淆	添添人大月
沆	添添言一月
袙	之广川曲
姤	巛竹斤一口
鬈	三七斤米乙
酗	梄寸人言巛
篝	竹言十目二
穠	竹梄曲曲大
伉	川添言一月
徜	人卜曲目口
貊	斤月一添川
悃	米卜口寸梄
継	巛一米梄巛
扞	寸添一十
蕻	十卜三十人
蒶	十卜巛人乙
唖	口一二巛
賅	目人言巛人
睽	目一又一大
箅	竹言曲一川
傜	川添斤十巛
鏚	斤一七卜曲
臌	月一二十又
犴	月竹一十
匍	儿乙梄二
瘌	广一梄口曲
曽	米寸曲卜曲
濋	添添梄又卜
潕	添添竹十米
戣	又米一大七
姮	巛竹二寸曲
塄	二一目曲言
桄	梄一曲人一
吁	口一一添寸
佴	川添三十
仉	川添月寸
湲	添添斤大又
祓	二曲大言又
紲	巛一十一巛
垜	二一乙竹梄
齧	三卜乙寸卜
栫	梄一大卜乙
枘	梄一目寸人
権	梄一竹二川
檞	梄一儿乙竹
刳	大寸一一曲
犒	竹二言目口
剰	竹十十梄曲
秕	竹梄儿儿儿
佌	川添卜卜儿
鯪	儿一二人儿
癘	广一十目巛
粄	米梄斤寸又
炘	米人斤寸
悢	米卜言添又
湅	添添梄一目
礽	二曲乙添竹
皯	又卜一十
薠	十卜米人大
芓	十卜乙一
喁	口一曲目巛
稞	竹梄曲卜梄
皞	川曲川大十
鯗	米三儿一
悒	米卜口一乙
忑	一添卜寸之
縶	二一米月巛
瓘	三一十口川
聡	三十人巛之
鞚	十十之人二
榎	梄一一川儿
槻	梄一二言目
鄲	口一口一乙
黟	目曲二儿儿
鎹	斤一之米大
濇	添添二口口
労	添寸之之乙
汭	添添目寸人
扆	之竹言儿
隩	乙口川米大
繐	巛一梄曲之
娩	巛竹儿口儿
搠	寸添米巛月
枵	梄一口一一
螈	口巛大川曲
睥	目一川口十
臬	川目梄一
傺	川添儿又二
邠	人一乙寸乙
鮞	儿一大目
鰷	儿一川儿梄
鯇	儿一之一一
沚	添添卜卜
澠	添添之又
瑨	三一二巛曲
耬	三卜梄曲巛
挻	寸添乙竹卜
靺	十十一添梄
葃	十卜曲竹卜
屺	目目乙乙
迮	之一竹一卜
脡	月一乙竹二
朓	月一儿寸添
痩	广一曲梄又
巣	添寸曲卜梄
挲	添添曲竹竹
祆	二曲一添大
芞	十卜竹乙
茌	十卜川添二
栝	梄一竹卜
螃	口巛言之言
昪	曲一巛言十
幘	目卜三卜目
儇	川添目口儿
獷	月竹广曲人
嫄	巛竹大川曲
殧	一添儿曲大
丼	二寸川寸言
墁	二一曲目又
捜	寸添曲梄又
鞨	十十曲人巛
欐	梄一一言广
磡	大一十巛乙
覧	七一竹言目
歔	卜七曲米儿
艶	曲曲一儿乙
髎	目之乙人斤
黌	川二人曲人
躰	川三梄一一
鱧	儿一曲口米
麈	广又言添三
淏	添添曲一大
禊	二曲三乙大
烝	又添曲一米
纋	巛一一之儿
繰	巛一口口梄
趔	二人一儿曲
玡	三一七卜
掊	寸添言米口
蟋	口巛斤梄之
迚	之一口口
暐	曲一又口十
毳	竹七竹七竹
儰	川添十卜斤
錬	斤一梄一曲
鱖	儿一大巛儿
訇	儿乙言寸
汚	添添一乙一
陴	乙口川口十
紑	巛一大卜
犛	二寸梄大竹
埴	二一十寸目
搐	寸添言巛曲
藸	十卜大月二
蒛	十卜竹又大
蕅	十卜添目巛
軔	梄曲乙寸言
靦	又添口目目
蛯	口巛二竹儿
喨	口一言之月
黻	曲米目大又
鍚	斤一曲儿斤
凖	广寸川卜十
廨	广大儿乙竹
瘳	广一乙人斤
鶺	添添人月儿
滻	添添言竹竹
窓	之人巛言之
屨	又竹人曲巛
騭	乙口卜曲三
婠	巛竹之寸乙
孥	巛竹又言乙
埤	二一川口十
琊	三一七卜乙
晢	寸添斤寸曲
呣	口一巛乙
昜	曲一一儿斤
籀	竹言寸儿曲
媵	月一米二巛
癶	又米
覿	二二目目目
騒	三米又言口
揄	寸添人月曲
拶	寸添巛寸儿
萏	十卜儿添川
覇	梄口十十月
厓	大大二一二
躇	口卜十卜二
簀	竹言三卜目
偭	川添又口目
儡	川添曲曲曲
侘	川添之竹七
勍	言一口曲乙
纀	巛一川曲米
圬	二一一添一
垳	二一人卜
搛	寸添米曲人
楯	梄一斤十目
椈	梄一儿乙米
尨	大儿斤三
銚	斤一儿寸添
痦	广一二又口
懮	米卜一之儿
氶	又添曲添
塩	二一竹口目
蒨	十卜川三月
樨	梄一又曲竹
崕	目目大二二
巉	目目儿儿言
犠	竹二米竹七
笅	竹言人言人
弇	人寸一口十
貅	斤月川添梄
舭	斤乙儿儿儿
廆	广大川口
怍	米卜竹一卜
愮	米卜斤十巛
悛	米卜巛人儿
滀	添添言巛曲
寘	之寸十目人
夛	又二儿言
彑	巛又
亏	一添一乙
垎	二一儿卜口
蒴	十卜米巛月
柃	梄一人寸之
鉒	斤一言添三
魨	儿一一添巛
鯡	儿一曲三
邡	言乙乙口
沋	添添大儿
氿	添添月乙
絪	巛一口寸大
紝	巛一竹添二
纘	巛一竹儿目
墠	二一口曲一
塲	二一竹儿斤
駆	三米七添人
撟	寸添竹目口
蔌	十卜梄口儿
瞢	十卜目之目
雱	梄添言乙
砕	大一月乙十
啁	口一月二口
岠	目目七添又
簨	竹言乙十人
俉	川添二又口
翛	川添卜乙乙
傝	川添曲乙乙
垕	斤寸一口二
艟	斤乙言曲二
誋	言寸乙乙之
冴	广寸七卜
怩	米卜又竹儿
滉	添添曲曲一
沴	添添人寸斤
浄	添添儿添又
澉	添添又三竹
衧	之广一添寸
阼	乙口竹一卜
牂	巛大米三
姞	巛竹二二口
垧	二一川目口
逹	之一二一米
栭	梄一大目
砒	大一儿儿儿
狃	月竹又二卜
澌	添添十三斤
綮	之竹竹人巛
趄	二人目三
絜	三卜乙寸巛
掭	寸添一大米
戁	十一口川之
茺	十卜言巛儿
螻	口巛曲口巛
崋	目目一十二
覦	人寸一曲目
庣	广大儿寸添
烺	米人言添又
熻	米人人乙乙
潸	添添梄梄月
沕	添添儿乙斤
褑	之广斤大又
繖	巛一十月竹
孋	巛竹一言广
妢	巛竹人一乙
檉	梄一三口三
霪	梄添添竹二
尪	大儿三一
崟	目目斤一
呑	竹添大寸口
玀	月竹目巛川
瘥	广一米三二
怫	米卜乙巛川
褙	之广广儿月
隣	乙口米儿十
郪	一添又巛乙
耋	二竹儿儿七
珧	三一儿寸添
遘	之一十目二
蕺	十卜口三七
椀	梄一之儿乙
剄	一添巛二曲
慝	七添十口之
嗛	口一米曲人
牾	竹二二又口
侉	川添大一一
倓	川添米人米
脰	月一一口米
賸	月一米二目
鰰	儿一二曲曲
憡	米卜竹梄目
烔	米人目一口
燠	米人川米大
濊	添添卜一曲
遅	之一又竹米
闀	又寸十人乙
婗	巛竹川二儿
紕	巛一儿儿儿
殪	一添儿口米
掤	寸添月一月
葸	十卜曲卜之
貰	十一巛添目
蓊	十卜人乙乙
柈	梄一米二
楗	梄一乙又二
划	七竹曲寸
匜	七添乙卜
躔	口卜广人二
伾	川添大卜一
瑆	三一曲一竹
皵	十一曲一又
茇	十卜大言又
蕆	十卜七大目
棬	梄一米二乙
簕	竹言十十乙
傒	川添斤巛大
獼	月竹乙人人
卆	月乙十寸
袤	言儿又又川
悗	米卜儿口儿
洑	添添川添大
瀷	添添乙十人
祌	二曲口口
褘	之广又口十
韡	又口口十二
縴	巛一言之竹
瑝	三一川曲三
葎	十卜人又二
椚	梄一又寸
礴	大一十梄寸
賻	目人梄二寸
鯠	儿一梄人人
鄜	广又乙口
忕	米卜大寸
屣	又竹人卜卜
翬	乙广乙之梄
圷	二一一添卜
酤	梄寸十寸口
柷	梄一口一儿
躅	口卜目儿口
昺	曲一一目人
罍	曲卜曲十巛
傋	川添十目二
俙	川添人大目
脙	月一一曲言
肄	儿儿竹又二
麿	广大梄口口
癔	广一言曲之
蛍	添寸之之口
湳	添添十目米
濈	添添口三七
祅	二曲竹添大
丮	乙七二卜
縁	巛一又二大
璿	三一卜人目
睚	目一大二二
癿	川曲巛添
鱒	儿一米梄寸
瘙	广一又言口
忪	米卜人一巛
阯	乙口卜卜
娠	巛竹大七
覯	十二目二目
蕢	十卜口一目
棼	梄一梄人乙
欑	梄一竹儿目
蜴	口巛曲儿斤
躕	口卜广米寸
甁	竹添一一一
簰	竹言川川十
侳	川添人人二
儴	川添言口十
鄶	人寸一曲乙
鏐	斤一乙人斤
鰾	儿一梄口二
迯	之一儿言卜
亰	言一曲一曲
裒	言儿川二
庤	广大二一寸
癃	广一乙一竹
浘	添添又竹竹
扂	之竹卜寸口
祫	二曲人一口
閺	又寸曲一言
臠	言寸巛人人
挿	寸添竹十曲
棌	梄一斤添梄
歭	卜卜二一寸
蝙	口巛之目十
戥	曲一竹三七
忮	米卜十寸又
惈	米卜曲卜梄
襻	之广人大竹
褫	之广斤寸卜
禚	二曲米三米
掲	寸添曲儿儿
攛	寸添之川巛
扱	寸添乙添人
鞎	十十又人
唴	口一米三儿
曚	曲一十一大
昳	曲一竹二人
岼	目目一米十
礐	川二人人大
伋	川添乙添人
鮀	儿一之寸儿
誸	言寸乙言巛
庁	广大一卜
慲	米卜十人人
慥	米卜之竹口
祧	二曲儿寸添
褕	之广人月曲
堥	又言又竹二
夃	乙添竹添又
妧	巛竹一添一
媺	巛竹目月竹
毿	巛言巛斤竹
拫	寸添又人
搦	寸添乙乙广
砢	大一一卜口
籐	竹言月米曲
穜	竹梄言曲二
倻	川添三十乙
癈	广一又乙月
漭	添添十大十
襤	之广七竹目
憙	二二口口之
趫	二人竹目口
瑱	三一十目人
耱	三卜梄梄大
攮	寸添一十儿
釃	梄寸一言广
嶌	目目儿巛
偛	川添竹十川
犽	月竹七卜
羑	米三儿添言
怏	米卜目寸大
灄	添添三三三
洿	添添大一一
渉	添添卜曲竹
潃	添添人儿月
瀙	添添言梄目
戭	之寸一人七
袛	之广儿七言
綍	巛一十之乙
嫜	巛竹言曲十
弆	二一巛言十
捭	寸添川口十
栱	梄一十一人
蜮	口巛七口一
蜢	口巛乙一目
舁	川二十卜
仏	川添巛言
鞤	二一二寸十
塝	二一言之言
搣	寸添七一米
撹	寸添添之目
茪	十卜曲人一
棻	十卜人乙梄
酴	梄寸人寸竹
槧	梄曲斤寸梄
栴	梄一竹月言
翃	大寸巛乙乙
歯	卜人
嗕	口一大七寸
嚌	口一言儿川
秭	竹梄竹巛川
畠	川曲曲卜
夎	人寸人二儿
猻	月竹乙竹巛
譃	言寸卜七曲
瘼	广一十曲大
涜	添添二之儿
褓	之广川口梄
艸	巛曲巛曲
姏	巛竹十二
垤	二一七二
哢	口一三一十
簏	竹言广又
釢	斤一乙添竹
熲	儿儿米人大
癀	广一十曲人
鏖	广又斤一
潲	添添竹曲月
殠	一添儿川大
堣	二一曲目巛
玕	三一一十
驫	三米三米三
荄	十卜言巛人
薀	十卜添人目
酲	梄寸口一三
囫	口寸儿乙斤
蹓	口卜儿竹曲
罽	目曲大米曲
嶢	目目二二一
崁	目目二一儿
崡	目目又曲巛
牤	竹二言七
黧	竹梄儿二米
僸	川添梄梄二
劊	人寸一曲曲
钀	斤一卜一大
銗	斤一斤一口
腄	月一竹十二
脇	月一乙乙乙
脧	月一巛人儿
孳	米一巛巛乙
涬	添添二一米
厳	添寸大三竹
涴	添添之儿乙
襁	之广乙口口
闅	又寸目卜又
菤	十卜米二乙
莙	十卜又大口
腠	月一三一大
腧	月一人月曲
鮪	儿一大寸月
瘰	广一曲卜巛
疧	广一儿七
疰	广一言添三
摽	寸添梄口二
蕘	十卜二二一
梺	梄一梄一卜
檑	梄一梄添曲
輞	梄曲目米言
霂	梄添添添梄
黷	目曲二目目
眈	目一之之儿
犤	竹二目儿儿
儞	川添一人人
敍	人寸竹卜又
衞	人卜又一目
飮	人又卜寸儿
鐡	斤一十口米
脥	月一大人人
亹	言一川口目
膂	言乙竹儿月
廃	广大又二儿
癉	广一口曲一
愭	米卜二儿曲
褗	之广七曲巛
衪	之广乙卜
妯	巛竹曲二
縼	巛一言又卜
蓂	十卜之言人
篥	竹言梄口梄
簃	竹言竹儿儿
儱	川添言卜
螽	儿卜广口口
爝	米人斤又寸
垰	二一卜一卜
堨	二一曲人巛
趠	二人卜曲十
拝	寸添一添三
鞮	十十曲一卜
酎	梄寸寸言
暠	曲一言目口
鼩	川二巛儿口
劓	川目曲川曲
燐	米人米儿十
涗	添添人口儿
漥	添添之二二
袴	之广大一一
襆	之广曲米米
姺	巛竹竹二儿
娭	巛竹巛言竹
趲	二人竹儿目
払	寸添巛言
楢	梄一米寸梄
貺	目人口一儿
艤	斤乙米竹七
膻	月一言曲一
胼	月一米一十
疻	广一口一人
煇	米人之之梄
羼	又竹米米米
埏	二一乙竹卜
珷	三一一七卜
珽	三一乙竹二
驩	三米十口川
騩	三米川口
苖	十卜曲二
蒢	十卜乙人竹
栻	梄一七言二
齢	卜人人寸之
喌	口一口添川
嗿	口一人又目
幪	目卜十一大
嶉	目目口一川
矧	竹大乙巛卜
犦	竹二曲人曲
簷	竹言儿人言
鼴	川二巛曲巛
魊	川口七口一
齁	川目曲儿口
偊	川添竹目巛
倞	川添言口曲
悆	人寸竹梄之
鍭	斤一川又竹
艂	斤乙儿卜三
脟	月一斤添寸
虓	月乙卜七
鰹	儿一七又二
褊	之广之目十
妀	乙乙巛竹
繧	巛一梄二巛
縄	巛一曲一曲
綎	巛一乙竹二
塏	二一目口米
垍	二一川目
琀	三一人又口
蒹	十卜米曲人
磻	大一斤梄曲
匸	七添
躓	口卜斤斤目
笘	竹言卜寸口
貔	斤月川儿儿
獮	月竹一人人
鮓	儿一竹一卜
痼	广一口十口
汧	添添一添十
涷	添添梄一曲
窅	之人目一
垗	二一儿寸添
瑅	三一曲一卜
藒	十卜竹人巛
蓧	十卜川儿梄
薸	十卜添梄二
槙	梄一十目人
椄	梄一言米巛
礅	大一言乙竹
跂	口卜十寸又
蹣	口卜十人人
畤	曲卜二一寸
晫	曲一卜曲十
黹	曲米目卜添
賎	目人七竹二
惣	竹二儿斤之
皝	川曲三曲一
傞	川添米三二
衎	人卜一十
諵	言寸十目米
竝	言米言米
洢	添添川添又
郿	又竹目一乙
姽	巛竹儿大乙
堷	二一言米曲
珵	三一口一三
捃	寸添又大口
芼	十卜竹七
槤	梄一之一梄
柸	梄一大卜一
梏	梄一竹二口
忐	卜一之巛
嘓	口一口口一
晧	曲一竹二口
麇	广又竹梄
潗	添添川卜梄
陜	乙口大人人
弐	一添七言二
赬	二一米卜目
埆	二一儿添月
玞	三一二言
駄	三米大寸言
薢	十卜儿乙竹
厜	大大竹十二
厖	大大大儿斤
劂	大大米儿曲
匼	七添人一口
蚡	口巛人一乙
崶	目目二二寸
勲	竹十曲乙米
蜑	乙言竹卜口
傴	川添七口口
儵	川添卜二米
劒	人寸一乙言
郛	斤添乙一乙
颻	斤添竹巛月
鵺	言一川言儿
奨	广卜斤寸大
湀	添添又一大
灉	添添巛乙川
矞	又言又人口
娯	巛竹口一人
邽	二一二一乙
択	寸添又竹言
苠	十卜乙二七
蝣	口巛言竹乙
嚗	口一曲人曲
偁	川添斤目二
狨	月竹七竹大
訏	言寸一添寸
諴	言寸七一口
瀣	添添卜曲一
綝	巛一梄一梄
堎	二一二人儿
壱	二二之之儿
聹	三十之目一
捔	寸添儿添月
菍	十卜人又之
杮	梄一一添目
勅	梄一口一乙
輊	梄曲七二
栃	梄一斤一乙
磙	大一言人巛
齮	卜人大一口
罣	目曲二一二
瞴	目一竹十米
飳	人又言添三
譫	言寸儿人言
遹	之一又人口
翯	乙广乙目口
繍	巛一又川添
堧	二一大目大
捊	寸添斤添乙
掮	寸添之竹月
恧	大目之巛
蜾	口巛曲卜梄
咥	口一七二
辿	之一目目
詀	言寸卜寸口
蘾	十卜二目曲
蘞	十卜人人竹
樫	梄一七又二
睃	目一巛人儿
頲	乙言竹二大
怓	米卜巛竹又
禔	二曲曲一卜
禘	二曲言之目
弸	乙巛月一月
繘	巛一又人口
莰	十卜二一儿
棈	梄一三卜月
棤	梄一十一曲
楩	梄一川曲人
枹	梄一儿乙乙
郫	川口十寸乙
偟	川添川曲三
脽	月一川卜
獊	月竹人之口
膷	月一巛又乙
粺	米梄川口十
掎	寸添大一口
靷	十十乙巛卜
菉	十卜又二曲
橀	梄一言川目
碥	大一之目十
躑	口卜米大乙
跕	口卜卜寸口
褁	曲卜梄一儿
顕	曲一曲米大
鷡	竹一十米儿
甃	竹梄米人一
篨	竹言乙人竹
倷	川添大寸二
偍	川添曲一卜
鶲	人一巛乙儿
瓞	斤言竹二人
獴	月竹十一大
鮇	儿一二寸梄
炰	儿乙乙二米
糬	米梄目曲二
焮	米人斤寸儿
泙	添添一米十
挙	添寸一人竹
洚	添添儿卜十
祔	二曲川添寸
闓	又寸目口米
玗	三一一添寸
挵	寸添三一十
棓	梄一言米口
篚	竹言七添曲
銕	斤一大寸乙
瘵	广一儿又二
惛	米卜儿七曲
棨	之竹竹人梄
駸	三米又之又
揵	寸添乙又二
萭	十卜竹目巛
藠	十卜川川川
蔿	十卜斤米
藦	十卜广梄竹
榯	梄一曲二寸
斝	口一口广十
暍	曲一曲人巛
賥	目人言人十
舲	斤乙人寸之
狚	月竹曲一一
鰕	儿一又又又
怱	儿乙斤言之
讃	言寸二二目
癧	广一大竹卜
瘐	广一川二人
渃	添添十大口
浡	添添十之乙
涢	添添口一目
渕	添添米大曲
衶	之广口口
擐	寸添目口儿
挼	寸添斤添巛
莕	十卜梄一口
葥	十卜米月曲
栯	梄一大寸月
桕	梄一川二
蚷	口巛七添又
咡	口一三十
篌	竹言川又竹
俥	川添梄曲
脭	月一口一三
狁	月竹巛言儿
鯔	儿一巛寸曲
訞	言寸竹添大
埫	二一曲目口
摛	寸添言目巛
苨	十卜又竹儿
厰	大大曲口竹
尰	大儿竹曲二
躞	口卜言米又
囃	口一言梄川
婓	曲三巛竹
偢	川添竹梄米
鉶	斤一一十曲
钁	斤一目川又
舺	斤乙曲乙
狌	月竹竹三
頩	米一十卜大
憱	米卜言曲大
隉	乙口川二二
翋	乙广乙广言
姁	巛竹儿乙口
嫋	巛竹乙乙广
喤	口一川曲三
眳	目一儿言口
釭	斤一二卜
鋂	斤一竹一巛
洀	添添斤乙
湇	添添言米月
祏	二曲大一
墘	二一十竹乙
逜	之一二又口
捽	寸添言人十
揎	寸添之二曲
轌	梄曲梄添又
轢	梄曲川巛梄
吷	口一又添大
倂	川添竹竹一
飜	斤梄曲乙广
釈	斤梄又竹言
臑	月一梄添大
猹	月竹梄曲一
竷	言米曲十儿
瘽	广一十口三
淯	添添言巛月
宍	之寸言一人
裃	之广卜一卜
袘	之广竹一乙
嬶	巛竹川一川
嬾	巛竹梄儿目
絘	巛一广寸儿
蓇	十卜目之
茖	十卜儿卜口
朢	七一月一三
啕	口一儿十巛
賍	目人广大二
稃	竹梄斤添乙
籣	竹言又梄目
脤	月一大七
鮚	儿一二二口
鮐	儿一巛言口
鳽	一添十卜儿
堽	二一目一卜
縠	二二之巛月
苳	十卜儿卜广
樿	梄一口曲一
匰	七添口曲一
蜊	口巛竹梄曲
帴	目卜七竹七
嵎	目目曲目巛
伀	川添人一巛
盦	人寸言梄目
凮	月寸一添川
颸	月卜曲卜之
厹	月乙巛言
惝	米卜曲目口
溽	添添大七寸
涊	添添乙言之
婥	巛竹卜曲十
珦	三一川目口
輜	梄曲巛寸曲
碹	大一之二曲
鯝	儿一口十口
綀	巛一梄一口
縡	巛一之寸言
栞	一十一十梄
殢	一添儿之目
拠	寸添儿卜月
搌	寸添又十儿
遰	之一十之目
爇	十卜二月米
韁	十十三曲曲
轔	梄曲米儿十
橪	梄一儿大米
煕	七一乙二米
蝳	口巛三卜巛
蜉	口巛斤添乙
嗩	口一曲人目
噍	口一川卜米
啍	口一言口乙
髃	目之曲目巛
盉	竹梄目梄
猁	月竹竹梄曲
匂	儿乙儿儿
痃	广一言一巛
懆	米卜口口梄
惓	米卜米二乙
渱	添添口巛二
浛	添添人又口
祊	二曲言乙
祤	二曲乙广乙
閟	又寸之巛竹
娖	巛竹口一卜
繦	巛一乙口口
坫	二一卜寸口
珛	三一大寸月
珹	三一七大乙
揲	寸添十巛梄
攠	寸添广梄曲
扠	寸添又言言
茩	十卜斤一口
茀	十卜乙巛川
巘	目目卜一大
鋩	斤一十卜言
錧	斤一之寸乙
遯	之一月一大
脬	月一斤添乙
鮂	儿一口寸人
廒	广大三乙竹
怭	米卜之巛竹
皕	一添川一川
垝	二一儿大乙
垵	二一之寸巛
搢	寸添二巛曲
攄	寸添卜曲之
拡	寸添广大巛
鞐	十十卜一卜
蟿	梄曲巛月口
暦	大大梄梄曲
晄	曲一曲人一
眛	目一二寸梄
罥	目曲口一月
罠	目曲乙二七
嶵	目目目曲曲
啎	竹一十又口
筰	竹言川竹卜
簩	竹言米之乙
僛	川添十三儿
俍	川添言添又
龢	人寸一十竹
彴	人卜儿乙言
舢	斤乙目目
臓	月一十七七
毞	儿儿儿儿竹
豋	儿言又口米
庨	广大二竹乙
緳	广大三乙巛
羕	米三言添曲
愯	米卜川卜又
欻	米人米人儿
懠	米卜言儿川
悰	米卜之寸二
溂	添添梄口曲
滵	添添之竹目
禋	二曲梄口二
祾	二曲二人儿
冘	之之儿寸
冞	之之米梄
臦	七一七一
墬	乙口巛大二
縸	巛一十曲大
鬏	三七斤竹米
椇	梄一目三人
蠑	口巛米之梄
賕	目人一曲言
臢	月一竹儿目
悈	米卜七竹十
忭	米卜言一卜
瓅	三一川巛梄
藾	十卜梄儿目
苶	十卜人寸曲
杻	梄一又二卜
噭	口一川言竹
唼	口一言米巛
峠	目目卜一卜
笵	竹言添添乙
偰	川添三乙大
谻	人一人乙二
餠	人又竹竹一
巟	言七川寸
凘	广寸十三斤
麤	广又广又广
纇	米梄巛一大
悧	米卜竹梄曲
溘	添添二巛目
寑	之寸川之又
彠	又二二川又
陥	乙口儿卜曲
弶	乙巛言口曲
荍	十卜巛卜竹
桫	梄一添曲竹
昻	曲一二卜乙
鎛	斤一梄二寸
鈏	斤一乙巛卜
鵟	月竹三一儿
廑	广大十口三
垞	二一之竹七
騑	三米曲三
騲	三米十曲十
莁	十卜二人人
醑	梄寸又卜月
彯	梄口二曲斤
霙	梄添十目大
雰	梄添人一乙
跢	口卜儿言儿
甽	曲卜川寸
黢	目曲二人儿
斁	目曲二米竹
盻	目一人一一
睒	目一米人米
秪	竹梄儿七言
僈	川添曲目又
虒	斤寸卜七
膮	月一二二一
胲	月一言巛人
觔	儿添月二乙
忞	言人之巛
謧	言寸言目巛
冱	广寸一添巛
怞	米卜曲二
悇	米卜人寸竹
漻	添添乙人斤
縕	巛一口人目
妘	巛竹二寸巛
婻	巛竹十目米
紵	巛一之寸一
矻	大一竹一乙
呫	口一卜寸口
蹁	口卜之目十
曀	曲一二口米
籦	竹言斤曲二
傌	川添三米
鉏	斤一目三
脞	月一人人二
鯷	儿一曲一卜
鰉	儿一川曲三
庳	广大川口十
恉	米卜儿儿曲
冖	之之
檗	又竹口言梄
瞀	又言又竹目
絿	巛一一曲言
隷	二二二又添
鵐	二卜人人儿
垙	二一曲人一
墦	二一斤梄曲
瑧	三一三人竹
鞡	十十寸添言
莅	十卜川添言
軺	梄曲乙寸口
郕	七大乙添乙
齕	卜人竹一乙
蟳	口巛又口寸
嶮	目目人人人
徧	人卜之目十
瘊	广一川又竹
慓	米卜梄口二
溍	添添二巛曲
沄	添添二寸巛
灡	添添十梄目
渇	添添曲儿儿
濧	添添曲米寸
泆	添添竹二人
溞	添添又言口
屛	又竹竹竹一
姌	巛竹目寸二
縗	巛一言儿曲
綅	巛一又之又
楳	梄一十二梄
朿	梄一目寸
旼	曲一言人
瞍	目一川卜又
鍉	斤一曲一卜
銛	斤一竹卜
鮠	儿一儿大乙
詷	言寸目一口
潟	添添川儿米
泇	添添乙竹口
孅	巛竹人曲一
瑊	三一七一口
駰	三米口寸大
抃	寸添言一卜
葖	十卜之人大
楅	梄一一口曲
酺	梄寸梄二
棶	梄一梄人人
輠	梄曲曲卜梄
椑	梄一川口十
枠	梄一月乙十
楤	梄一儿言之
黶	大大曲二米
虷	口巛一十
吪	口一川添儿
屴	目目乙竹
簠	竹言梄二目
皜	川曲言目口
儗	川添儿又卜
臒	月一十川又
猢	月竹十口月
膬	月一竹竹竹
瘯	广一言竹竹
恅	米卜二竹儿
粋	米梄月乙十
裀	之广口寸大
襜	之广儿人言
閦	又寸人人人
剟	又言又又曲
恝	三卜乙寸之
蒻	十卜乙乙广
唪	口一三人二
踺	口卜乙又二
欥	曲一儿人
嵁	目目十三巛
眙	目一巛言口
氕	竹乙竹添
譾	言寸米乙乙
迉	之一又竹
絧	巛一目一口
賛	二言二言目
頬	二寸米人大
耵	三十一卜
瑒	三一曲儿斤
藨	十卜广又米
圀	口寸人一言
踣	口卜言米口
嘚	口一人一寸
黰	目曲二目人
崱	目目目人曲
鼽	川目曲川月
粍	米梄竹七
瑬	添添言三言
瀍	添添广人二
戽	之竹广寸十
閖	又寸曲添
弝	乙巛乙曲
揃	寸添米月曲
櫌	梄一一之儿
鱺	儿一一言广
觖	儿添月又大
豇	一添口米二
趧	二人曲一卜
慹	二一米月之
珸	三一二又口
毦	三十竹七
擗	寸添又口言
蔕	十卜十之目
蔱	十卜人梄月
棫	梄一七口一
轤	梄曲卜曲目
柎	梄一川添寸
硏	大一一十一
礌	大一梄添曲
磉	大一又又梄
敺	七添口卜又
蹀	口卜十巛梄
躪	口卜十又川
晥	曲一之一一
罶	目曲儿竹曲
犝	竹二言曲二
秖	竹梄儿七
倴	川添大十十
牮	川添七言竹
僗	川添米之乙
頠	儿添大乙大
焔	米人儿卜曲
熀	米人曲曲一
袽	之广巛竹口
鄩	又二二寸乙
弳	乙巛一巛二
嫪	巛竹乙人斤
枒	梄一七卜
燹	大月大月米
瘑	广一目口
焌	米人巛人儿
泂	添添目寸口
潚	添添又川巛
奡	一添川大川
殈	一添儿竹目
琭	三一又二曲
攉	寸添梄添川
萉	十卜月一乙
楱	梄一三一大
檟	梄一梄口目
輶	梄曲米寸梄
啢	口一一人人
慁	口寸大月之
圐	口寸目曲言
踽	口卜竹目巛
跘	口卜米二
喦	口一口口目
暅	曲一米二曲
幓	目卜巛人斤
瞹	目一斤之儿
皊	川曲人寸之
鐚	斤一二巛之
鑴	斤一目人口
舡	斤乙二卜
鱲	儿一巛人巛
鄘	广大又月乙
洘	添添二竹一
洈	添添儿大乙
襌	之广口曲一
躄	又竹口言口
媦	巛竹曲卜月
婸	巛竹曲儿斤
坏	二一大卜
坶	二一巛乙
撙	寸添米梄寸
艼	十卜一卜
蒠	十卜川目之
蒺	十卜广一竹
栁	梄一儿言乙
碏	大一十一曲
虸	口巛乙一
躦	口卜竹儿目
棐	曲三梄一
幬	目卜二口寸
够	儿乙口儿儿
恓	米卜梄口
汒	添添言七
袗	之广人寸斤
圣	又言二一
殙	一添儿儿曲
敔	二卜又口竹
摰	二一人月竹
趯	二人乙乙川
擭	寸添十川又
撚	寸添儿大米
鄀	十卜大口乙
蘘	十卜言口十
蒟	十卜言儿口
蒄	十卜之一寸
覅	梄口巛儿斤
猋	大言大言大
敊	卜一曲卜又
敹	卜寸之斤竹
跐	口卜卜卜儿
羉	目曲言巛巛
崥	目目川口十
歃	竹十川二儿
鍈	斤一十目大
凧	月寸目卜
颭	月卜卜寸口
膰	月一斤梄曲
鰺	儿一巛人斤
烠	米人大寸月
燋	米人川卜米
鵷	之寸儿乙儿
娷	巛竹竹十二
繺	巛巛儿竹米
繶	巛一言曲之
墚	二一添人梄
琁	三一竹又卜
晛	曲一目儿
帡	目卜米一十
筲	竹言曲人月
餤	人又米人米
訬	言寸曲人竹
瘖	广一言米曲
陊	乙口儿言儿
頇	一十大人
鬺	一添口儿斤
璈	三一三乙竹
璆	三一乙人斤
莿	十卜梄目曲
蒤	十卜添人竹
醐	梄寸十口月
蜍	口巛人寸竹
啀	口一大二二
餥	曲三人又
暎	曲一十目大
畯	曲卜巛人儿
幏	目卜之寸大
皦	川曲川言竹
僇	川添乙人斤
瓟	斤言儿乙乙
褩	斤乙月又言
鯸	儿一川又竹
爣	米人曲二米
潩	添添曲十人
襴	之广又梄目
褌	之广之之梄
塈	又人七儿二
纆	巛一目米二
縦	巛一人米卜
垪	二一米一十
蓱	十卜添米十
遝	之一目曲曲
眴	目一儿乙曲
筭	竹言三一十
稂	竹梄言添又
鮦	儿一目一口
謚	言寸米人目
殍	一添儿斤乙
墈	二一十巛乙
堌	二一口十口
垀	二一竹米寸
玊	三一言添
顢	十一目人大
韂	十十儿人言
芿	十卜川乙竹
喒	口一儿卜曲
噰	口一言巛川
噂	口一米梄寸
曵	曲梄竹添言
晙	曲一巛人儿
巂	目目川人口
箢	竹言之儿乙
鼢	川二巛人乙
俛	川添儿口儿
餖	人又一口米
鋀	斤一一口米
鋐	斤一之大巛
憓	米卜梄曲之
憺	米卜儿人言
綷	巛一言人十
紞	巛一之之儿
擿	寸添之十口
韮	十卜曲三一
蕣	十卜斤儿十
朸	梄一乙竹
蹯	口卜斤梄曲
仭	川添乙寸言
鏾	斤一十月竹
臗	月一之目言
痏	广一大寸月
誾	又寸言寸
蝥	又言又竹口
貮	一添七言目
摋	寸添人梄月
葍	十卜一口曲
遖	之一十目米
靬	十十一十
蕡	十卜十十目
蒡	十卜言之言
蕷	十卜又卜大
輇	梄曲人寸三
剗	七竹七竹曲
掔	七一又言竹
蚿	口巛言一巛
咮	口一竹一梄
鶡	曲一儿巛儿
秏	竹梄竹七
毪	竹七巛言竹
傉	川添大七寸
儽	川添曲曲巛
皐	川曲添添十
僋	川添人又目
鉐	斤一大一
鉱	斤一广大巛
猄	月竹言口曲
鱓	儿一口曲一
鰯	儿一乙乙广
鷟	言乙竹竹儿
癙	广一川二巛
怳	米卜口一儿
燂	米人梄曲十
洓	添添梄一目
淛	添添竹目曲
渓	添添斤添二
褖	之广巛又大
冦	之之一卜又
巹	又添曲一乙
阨	乙口大大乙
纚	巛一一言广
碃	大一三卜月
磲	大一添又梄
蹖	口卜三人川
唶	口一十一曲
呾	口一曲一一
踟	口卜竹大口
岍	目目一添十
劁	川卜米言曲
銤	斤一米梄
猰	月竹三乙大
訌	言寸二卜
濩	添添十川又
塨	二一十人米
靸	十十乙添人
菳	十卜斤一
薿	十卜儿又卜
槄	梄一斤添川
鄠	梄添一一乙
蟥	口巛十曲人
晻	曲一大寸曲
睆	目一之一一
穊	竹梄又七儿
鞗	川添卜儿十
侅	川添言巛人
貑	斤月又又又
艅	斤乙人寸竹
憝	言一口竹之
譹	言寸言之大
羮	米三米三人
鄫	米寸目曲乙
懽	米卜十口川
糨	米梄乙口口
燏	米人又人口
袨	之广言一巛
毣	乙广乙广竹
嫽	巛竹一曲曲
抮	寸添人寸斤
嚆	口一十目口
眊	目一竹七
眕	目一人寸斤
眵	目一儿言儿
瞷	目一又寸曲
箖	竹言梄一梄
釿	斤一斤寸
鱝	儿一十十目
皸	之之梄曲又
嫻	巛竹又寸梄
瓨	二卜一巛
騍	三米曲卜梄
揠	寸添七曲巛
鶾	十寸曲竹儿
菧	十卜广儿言
轕	梄曲十人巛
樛	梄一乙人斤
犮	大言又添
甗	卜七一一一
蟜	口巛竹目口
蟓	口巛儿口大
嗢	口一曲一目
昣	曲一人寸斤
嫳	目卜添竹巛
嶪	目目曲米梄
箶	竹言十口月
箙	竹言月乙又
仱	川添人言又
狳	月竹人寸竹
猟	月竹添月二
狖	月竹之人
嚲	言一口曲一
諝	言寸又卜月
廙	广大曲十人
潽	添添米曲曲
寖	之寸添之又
縩	巛一儿又二
墺	二一川米大
扐	寸添乙竹
栘	梄一儿言儿
圁	口寸言寸
曨	曲一言卜
鼷	川二巛巛大
眢	儿言乙目目
諆	言寸十三
絰	巛一七二
剅	一添口米曲
藟	十卜曲曲曲
薡	十卜目巛川
輐	梄曲之一一
迍	之一一添巛
岞	目目竹一卜
熈	竹添七乙米
牓	川又言之言
郈	斤寸一口乙
錼	斤一大寸二
脁	月一儿寸添
敻	儿添目目竹
欬	言一巛人儿
潅	添添竹二川
洨	添添言人人
寃	之寸儿儿言
頞	之寸巛竹大
窊	之人斤言
臩	七一七大川
焄	又大口一米
茻	巛曲巛巛巛
摂	寸添三十添
枻	梄一十一巛
晅	曲一二寸曲
侁	川添竹二儿
銍	斤一七二
猞	月竹人寸竹
讌	言寸十儿米
汋	添添儿乙言
艴	乙巛川儿乙
妬	巛竹大一
嚢	一添口十儿
遶	之一二二一
斲	曲米斤寸
髫	三七斤乙口
蓰	十卜人卜卜
桲	梄一十之乙
椆	梄一月二口
羍	大寸米三
厗	大大言十
勔	又添口目乙
蝻	口巛十目米
喍	口一卜儿梄
嶲	目目川目巛
敳	目目一米竹
嶰	目目儿乙竹
瞵	目一米儿十
矊	目一巛川目
牥	竹二言乙
嶨	川二人人目
擧	川二一人竹
僽	川添竹米之
侂	川添广竹七
魵	儿一人一乙
邅	之一言曲一
醤	广卜斤寸梄
慠	米卜三乙竹
煓	米人目目大
熥	米人之又月
沷	添添大言又
沘	添添儿儿儿
瀯	添添米口口
疎	又添卜梄口
妠	巛竹目寸人
妭	巛竹大言又
緵	巛一人人儿
霅	梄添言寸
昫	曲一儿乙口
嶔	目目斤一儿
僩	川添又寸月
鍠	斤一川曲三
猦	月竹月卜
縢	月一米二巛
膣	月一之人七
諲	言寸梄口二
淜	添添月一月
墝	二一二二一
覩	二竹目儿
璪	三一口口梄
莵	十卜川儿言
蔤	十卜之竹目
榼	梄一二巛目
醾	梄寸广梄米
椌	梄一之人二
牻	竹二大儿斤
酇	竹二儿目乙
穭	竹梄儿一曲
侹	川添乙竹二
倧	川添之寸二
粔	米梄七添又
炟	米人曲一一
焠	米人言人十
沇	添添巛言儿
窋	之人巛曲巛
孲	乙一二巛
暋	乙二七竹曲
姱	巛竹大一一
綼	巛一川口十
荸	十卜十之乙
萯	十卜儿添目
桯	梄一口一三
筬	竹言七大乙
泝	添添斤寸言
塅	二一川三月
埶	二一人二月
盩	二一米竹目
玶	三一一米十
駔	三米目三
驌	三米又川巛
掫	寸添三十又
硜	大一一巛二
螵	口巛梄口二
蠋	口巛目儿口
圌	口寸目目大
塁	曲卜添添二
罫	目曲二二卜
罝	目曲目三
骹	目之言人人
簳	竹言十人一
筦	竹言之一一
倢	川添一又卜
偨	川添卜儿梄
儹	川添竹儿目
俤	川添米乙川
腷	月一一口曲
狛	月竹川曲
肸	月一人一十
顚	儿儿目人大
廌	广又一巛米
瘝	广一目曲曲
澣	添添十人一
漎	添添人人卜
賨	之寸二曲目
岊	乙曲目目
媥	巛竹之目十
趑	二人广寸儿
鞬	十十乙又二
蝀	口巛梄一曲
嚥	口一十儿米
嚫	口一言梄目
贐	目人又米目
傃	川添三卜巛
偞	川添十巛梄
歛	人寸一人儿
鈃	斤一一添十
鏷	斤一曲米米
鈩	斤一之竹
谿	斤添巛人口
讘	言寸三三三
頏	言一月寸大
塭	二一曲一目
埇	二一又言月
耟	三卜梄七又
掞	寸添米人米
鞁	十十又卜
茝	十卜七一
苅	十卜人言曲
輣	梄曲月一月
衊	竹添目七言
筊	竹言言人人
偩	川添儿添目
侭	川添又言广
獏	月竹十曲大
狴	月竹儿儿二
鄮	儿竹目人乙
鱠	儿一人目曲
廯	广大儿一米
溚	添添十一口
鵼	之人二卜儿
祂	二曲乙卜
粛	又大川寸添
屓	又竹目人
翭	乙广乙又竹
娀	巛竹七竹大
綖	巛一乙竹卜
玭	三一儿儿儿
晊	曲一七二
盳	目一言七
簻	竹言之一目
簜	竹言添儿斤
儜	川添之目一
鏻	斤一米儿十
漶	添添口口之
垾	二一曲一一
墽	二一川言竹
塡	二一儿巛人
駺	三米言添又
摐	寸添人人卜
撖	寸添又三竹
劐	十卜川又曲
櫙	梄一十口口
輖	梄曲月二口
孁	梄添口口巛
齵	卜人曲目巛
蝤	口巛米寸梄
蚆	口巛乙曲
蹍	口卜又十儿
躐	口卜巛人巛
跼	口卜又乙口
囅	口一口十儿
唅	口一人又口
畳	曲卜之之目
秬	竹梄七添又
秡	竹梄大言又
錞	斤一言口乙
钃	斤一又儿口
獪	月竹人目曲
腃	月一米二乙
龒	言卜二曲
糈	米梄又卜月
惉	添添卜口之
澴	添添目口儿
禖	二曲十二梄
賮	又大一米目
繊	巛一十七曲
莇	十卜目三乙
礓	大一三曲曲
迵	之一目一口
輋	目目大寸梄
筢	竹言寸添乙
犄	竹二大一口
嬃	斤三大人巛
惏	米卜梄一梄
潾	添添米儿十
阢	乙口一儿
耥	三卜梄目口
駉	三米目寸口
萳	十卜十目米
鄚	十卜曲大乙
蒈	十卜儿儿川
蕫	十卜言曲二
榲	梄一口人目
嚠	口一儿斤曲
暕	曲一梄一目
巓	目目儿人大
睎	目一人大目
眹	目一米一大
勧	竹二川卜乙
箟	竹言曲儿儿
鋙	斤一二又口
鶵	儿乙巛巛儿
遆	之一言之目
潬	添添口曲一
鍌	添添竹儿斤
窉	之人一目人
姡	巛竹竹卜
菺	十卜之竹月
轘	梄曲目口儿
栟	梄一米一十
咇	口一之巛竹
蹜	口卜之一川
爞	米人口口口
陑	乙口大目
媱	巛竹斤十巛
繝	巛一又寸月
殗	一添儿大曲
郚	二卜又口乙
朅	二一巛人巛
鬪	三三一米寸
駏	三米七添又
騋	三米梄人人
騂	三米言十
珝	三一乙广乙
斠	十二目广十
酄	十卜口川乙
蘂	十卜之之梄
蔃	十卜乙口口
椪	梄一米一曲
厤	大大竹梄竹
蟌	口巛川儿之
螗	口巛广又口
幰	目卜之目之
犓	竹二儿儿巛
讐	川卜川卜言
倅	川添言人十
徯	人卜斤巛大
頴	儿儿二曲大
瘜	广一川目之
憕	米卜又口米
濔	添添一人人
潎	添添目添竹
濶	添添又寸竹
祣	二曲竹一儿
褵	之广言目巛
鸊	又竹口言儿
覗	乙添一口目
彉	乙巛十曲人
芔	巛曲巛曲巛
紩	巛一竹二人
妎	巛竹人寸川
偡	川添十三巛
錍	斤一川口十
鱕	儿一斤梄曲
耖	三卜梄曲竹
騛	三米乙乙广
輂	十一人一梄
輈	梄曲斤乙
棪	梄一米人米
雿	梄添儿寸添
蝓	口巛人月曲
呍	口一二寸巛
踡	口卜米二乙
甞	曲人之口十
晬	曲一言人十
罛	目曲斤言
岋	目目乙添人
犋	竹二目三人
鼱	川二巛三月
儃	川添言曲一
偐	川添言竹斤
餀	人又十卜人
鷉	斤寸卜七儿
鑞	斤一巛人巛
麑	广又川二儿
怮	米卜巛巛乙
窾	之人二二儿
襐	之广儿口大
裞	之广米口儿
裲	之广一人人
袧	之广儿乙口
糺	巛一巛添
薖	十卜之一目
蔊	十卜米曲一
襾	一添目寸巛
枓	梄一广寸十
砏	大一人一乙
蜎	口巛口一月
曊	曲一乙川目
倛	川添十三
腜	月一十二梄
脎	月一人言梄
雘	月添言川又
惵	米卜十巛梄
愐	米卜又口目
泃	添添儿乙口
阽	乙口卜寸口
緺	巛一目口
絣	巛一米一十
坲	二一乙巛川
瓛	三一卜一大
驓	三米米目曲
騄	三米又二曲
搋	寸添斤寸卜
靰	十十一儿
剳	十卜人口曲
蔉	十卜言人口
醁	梄寸又二曲
梣	梄一目言又
榶	梄一广又口
螘	口巛目口米
蠵	口巛目人口
吰	口一大寸巛
蹡	口卜巛儿寸
噛	口一卜人
勗	曲一目三乙
鷃	曲一之巛儿
幠	目卜竹十米
黲	目曲二人斤
罜	目曲言添三
巌	目目添三竹
崒	目目言人十
峛	目目一儿曲
牦	竹二竹七
稊	竹梄米乙川
伷	川添曲二
僔	川添米梄寸
錺	斤一十卜言
飂	月卜乙人斤
獥	月竹川言竹
狔	月竹又竹儿
腍	月一人又之
朏	月一巛曲巛
謣	言寸梄一一
謢	言寸川卜又
謵	言寸乙乙川
庌	广大七卜
麀	广又儿儿
灊	添添七米一
滭	添添曲十二
湩	添添竹曲二
溓	添添米曲人
潏	添添又人口
祴	二曲七竹十
闉	又寸梄口二
頵	又大口一大
阬	乙口言一月
丱	巛卜巛卜
緌	巛一竹梄巛
綯	巛一儿十巛
蓷	十卜寸添川
杕	梄一大寸
佖	川添之巛竹
迻	之一儿言儿
訧	言寸大儿
桊	米二梄一
怐	米卜儿乙口
沺	添添曲卜
墣	二一曲米米
瑳	三一米三二
騵	三米大川曲
揜	寸添人口十
薗	十卜口口儿
蒩	十卜竹梄目
棽	梄一梄言又
槪	梄一川七儿
盬	七一竹竹目
蝜	口巛儿添目
圂	口寸大月
牚	曲人之口七
矰	竹大米目曲
牬	竹二竹巛川
牿	竹二竹二口
篸	竹言巛人斤
犨	川卜川卜竹
餻	人又米三米
鑚	斤一二二目
鈚	斤一儿儿儿
鑱	斤一儿儿言
犰	月竹月乙
猭	月竹巛又大
鵩	月一乙又儿
廞	广大斤一儿
羖	米三月又
熇	米人言目口
瀿	添添竹竹巛
覜	儿寸添添目
澦	添添又卜大
湑	添添又卜月
祲	二曲又之又
褞	之广曲一目
繑	巛一竹目口
婌	巛竹卜曲又
坰	二一目寸口
琄	三一口一月
珖	三一曲人一
踇	口卜竹一巛
咍	口一巛言口
笭	竹言人寸之
鉧	斤一巛乙
觫	儿添月梄口
鮥	儿一儿卜口
緖	巛一二曲言
塙	二一言目口
毊	二二又目口
蔎	十卜言寸月
莐	十卜添之儿
荵	十卜乙言之
醽	梄寸梄口口
蚖	口巛一添一
鸆	卜七口大儿
嘒	口一三三又
碞	口一口口大
昄	曲一斤寸又
黮	目曲二十巛
睾	竹添目二米
郳	川二儿寸乙
倕	川添竹十二
狟	月竹二寸曲
猵	月竹之目十
頄	月乙大人
鱚	儿一二米口
讙	言寸十口川
瘈	广一三乙大
庛	广大卜卜儿
鷁	米一人目儿
惙	米卜又又又
愶	米卜乙乙月
漑	添添川七儿
澼	添添又口言
盝	又二曲添目
緤	巛一十巛梄
邘	一添寸言乙
朹	梄一月乙
蚚	口巛斤寸
饐	人又二口米
涒	添添又大口
慭	二寸曲大之
琈	三一斤添乙
珓	三一言人人
驎	三米米儿十
挍	寸添言人人
鞄	十十儿乙乙
蔝	十卜目一米
柂	梄一竹一乙
豲	大月大川曲
豗	一儿大月
皻	卜七目三又
嚬	口一卜曲大
暩	曲一儿又二
崌	目目又十口
巇	目目卜米七
箑	竹言一又卜
筯	竹言目三乙
傎	川添十目人
攽	人一乙寸竹
鯑	儿一人大目
鳦	儿巛乙七
瘲	广一人人卜
羱	米三大川曲
渮	添添十一口
漼	添添目目川
浟	添添川卜竹
袚	之广大言又
姈	巛竹人寸之
枲	巛言口一梄
坬	二一斤言
珌	三一之巛竹
顠	梄口二曲大
梛	梄一乙二乙
筥	竹言口一口
俴	川添七竹七
僿	川添之人二
鯫	儿一三十又
迖	之一大言
氂	二寸梄大竹
挀	寸添斤寸儿
捖	寸添之一一
蒚	十卜一米一
藂	十卜三又大
轀	梄曲口人目
梲	梄一人口儿
枌	梄一人一乙
霢	梄添月斤儿
攲	大寸一十又
耎	大目大寸
黺	曲米目人乙
牷	竹二人寸三
臿	竹十川二
秺	竹梄之竹七
筳	竹言乙竹二
毹	人寸一曲竹
鞶	斤乙月又十
猧	月竹目口
毚	儿添口儿言
旍	言乙竹人之
泭	添添川添寸
惌	之寸儿乙之
禡	二曲三米
韔	又口口十三
檃	乙口斤又梄
姧	巛竹巛竹一
媓	巛竹川曲三
緂	巛一米人米
杅	梄一一添寸
醱	梄寸又乙月
礞	大一十一大
厞	大大曲三
螝	口巛川口
蜣	口巛米三儿
筈	竹言竹卜
鮨	儿一儿儿曲
諌	言寸梄一曲
愲	米卜目之
怊	米卜乙寸口
紃	巛一川寸
鬐	三七斤儿曲
髧	三七斤之儿
菶	十卜三人二
惎	十三之巛
酨	十寸七竹梄
杬	梄一一添一
醨	梄寸言目巛
楪	梄一十巛梄
尞	一添米曲曲
蠀	口巛广儿目
昡	曲一言一巛
帨	目卜米口儿
髄	目之之大月
箊	竹言言人广
臈	月一十人巛
夆	儿卜三卜
鄗	言一口口乙
瓬	言乙一巛
犘	广大梄梄竹
癐	广一人目曲
憟	米卜梄口米
忳	米卜一添巛
熜	米人川儿之
湋	添添又口十
窫	之人三乙大
禷	二曲米大大
襶	之广十十人
襡	之广目儿口
閊	又寸目目
婍	巛竹大一口
挐	巛竹口一竹
媖	巛竹十目大
綛	巛一乙言之
鄕	巛人川儿乙
殭	一添儿曲曲
拑	寸添十二
揝	寸添儿卜曲
掻	寸添又言口
萺	十卜曲一目
蘹	十卜米目曲
檽	梄一梄添大
矼	大一二卜
砫	大一言添三
簙	竹言十梄寸
諀	言寸川口十
剫	广大十又曲
垺	二一斤添乙
蠧	二二之口口
玼	三一卜卜儿
糵	十卜竹言米
醸	梄寸言人十
歅	梄口二一儿
柅	梄一又竹儿
觱	七大一儿月
疁	曲卜乙人斤
虩	曲人曲曲卜
幙	目卜十曲大
嵃	目目言竹斤
嶓	目目斤梄曲
巃	目目言卜
犂	竹梄儿竹竹
魋	川口川卜
鐶	斤一目口儿
鋋	斤一乙竹卜
艒	斤乙曲一目
臞	月一目目川
獟	月竹二二一
鸑	月竹言大儿
鰮	儿一口人目
鮗	儿一儿卜广
鮡	儿一儿寸添
懪	米卜曲人曲
烱	米人目人口
慆	米卜斤添川
浤	添添之大巛
寪	之寸斤米
繀	巛一目目川
嫭	巛竹卜米寸
梠	梄一口一口
橚	梄一又川巛
犪	竹二米人儿
閷	人言梄又人
鐕	斤一七儿曲
鐋	斤一添儿斤
夘	儿言乙目
誷	言寸目米言
瑑	三一巛又大
搒	寸添言之言
葝	十卜一二乙
薋	十卜广儿目
酏	梄寸乙卜
楉	梄一十大口
繄	七添竹月巛
齛	卜人十一巛
噀	口一乙十人
氀	曲口巛竹竹
氍	目一目川竹
眽	目一斤寸儿
睠	目一米二乙
箒	竹言又之目
忥	竹乙之巛
侴	人寸一卜曲
獦	月竹十人巛
鯥	儿一二人二
觿	儿添月人口
浢	添添一口米
淔	添添十寸目
潐	添添川卜米
禨	二曲巛七人
閇	又寸一添卜
阹	乙口二一巛
繵	巛一言曲一
抆	寸添言人
芅	十卜七言
廼	乙言梄口
檛	梄一之一目
篛	竹言乙乙广
僆	川添之一梄
伬	川添又竹言
餕	人又巛人儿
錏	斤一二巛
媬	巛竹川口梄
殣	一添儿口三
塥	二一一米一
褧	三十米人言
髣	三七斤三言
聱	三卜乙竹三
珶	三一米乙川
攦	寸添一言广
挓	寸添之竹七
捥	寸添之儿乙
尭	十寸十卜一
藙	十卜言大月
蓪	十卜之又月
楬	梄一曲人巛
檓	梄一川二月
砯	大一曲添言
祡	卜卜儿儿二
蝪	口巛曲儿斤
甿	曲卜言七
旿	曲一竹一十
帾	目卜二竹
箷	竹言言竹乙
烋	川添梄一米
餂	人又竹卜
钂	斤一曲二米
獳	月竹梄添大
朘	月一巛人儿
鱣	儿一言曲一
匊	儿乙米梄
廗	广大十之目
忣	米卜乙添人
韣	又口口儿口
癹	又米月又
姎	巛竹目寸大
絻	巛一儿口儿
纕	巛一言口十
笴	竹言一卜口
鋳	斤一三卜寸
膍	月一川儿儿
糌	米梄儿卜曲
縎	巛一目之
塿	二一曲口巛
耠	三卜梄一口
璮	三一言曲一
驦	三米梄梄目
抾	寸添二一巛
搷	寸添十目人
擫	寸添大月大
搨	寸添曲乙乙
摡	寸添又七儿
靾	十十十一巛
蓳	十卜十口三
蟼	十卜儿竹口
棯	梄一人又之
敧	大寸一卜又
匽	七添曲一巛
匢	七添儿乙斤
嚚	口一口七口
崝	目目三卜月
崀	目目言添又
簉	竹言之竹口
篽	竹言人卜乙
儌	川添川言竹
儦	川添广又米
鄬	斤米乙口
狣	月竹儿寸添
胕	月一川添寸
腯	月一斤十目
腟	月一之寸七
雊	儿乙口一川
廇	广大儿竹曲
熅	米人口人目
褮	米人米之言
漙	添添梄曲寸
渻	添添曲竹目
漴	添添目之二
裄	之广人卜
裗	之广言巛川
鶤	之之梄曲儿
韎	又口口一梄
弽	乙巛十巛梄
嫇	巛竹之言人
繣	巛一又曲一
弃	言一巛言十
蒱	十卜寸添梄
菼	十卜米人米
穄	竹梄儿又二
鑛	斤一广曲人
鰒	儿一竹曲儿
涽	添添儿七曲
犎	二一二寸竹
壝	二一之一目
壌	二一言人十
摴	寸添梄一一
抇	寸添曲一
萐	十卜一又卜
靻	十十目三
栵	梄一一儿曲
尃	梄二寸言
櫑	梄一曲曲曲
楡	梄一人月巛
霫	梄添乙乙川
蝃	口巛又又又
羂	目曲巛口月
嵕	目目人人儿
岧	目目乙寸口
蠈	目人七大口
賵	目人曲一目
箘	竹言口寸竹
籔	竹言曲巛竹
兪	人寸一月巛
飣	人又一卜
瓥	斤言大口口
舠	斤乙乙寸
颲	月卜一儿曲
猺	月竹斤十巛
鮄	儿一乙巛川
褭	言儿三米
鸇	言一口一儿
惤	米卜乙言巛
裯	之广月二口
邲	之巛竹添乙
繠	之巛之之巛
敯	乙二七卜又
剼	巛言巛斤曲
极	梄一乙添人
茠	十卜川添梄
蔍	十卜广又
杙	梄一七言
柤	梄一目三
靃	梄添川卜川
儤	川添曲人曲
佁	川添巛言口
鐇	斤一斤梄曲
鋲	斤一斤二人
狺	月竹言寸
詧	儿言又言言
讋	言卜言寸
瘃	广一大月
沶	添添二曲
殏	一添儿曲言
刲	二一二一曲
堉	二一言巛月
垿	二一广又卜
棸	三十又言梄
莍	十卜一曲言
蕸	十卜之又又
芧	十卜又又卜
榃	梄一梄一曲
槬	梄一大一斤
檇	梄一川目巛
麭	梄一人儿乙
楟	梄一言之一
槮	梄一巛人斤
鷖	七添竹月儿
螬	口巛一曲曲
峘	目目二寸曲
矱	竹大十川又
玁	月竹口三竹
狪	月竹目一口
鯯	儿一竹目曲
羗	米三儿寸巛
緛	巛一大目大
媂	巛竹言之目
砮	巛竹又言大
茋	十卜儿七言
篴	竹言之一大
鉋	斤一儿乙乙
胑	月一口一人
腇	月一竹梄巛
訄	月乙言寸
迆	之一乙卜
刓	一添一儿曲
捗	寸添卜卜曲
扢	寸添竹一乙
擸	寸添巛人巛
茿	十卜二卜月
雚	十卜口口川
芺	十卜竹添大
蓹	十卜人卜乙
橁	梄一竹儿曲
磑	大一目口米
硿	大一之人二
蟫	口巛梄曲十
螠	口巛米人目
跅	口卜斤寸言
蹛	口卜十之目
咢	口一口一一
噣	口一目儿口
罞	目曲又又川
崿	目目口一一
睩	目一又二曲
筻	竹言一曲人
稙	竹梄十寸目
筩	竹言又言月
魆	川口七竹巛
侫	川添言七巛
伔	川添之之月
僝	川添又乙乙
儠	川添巛人巛
胠	月一二一巛
臛	月一梄添川
猀	月竹添曲竹
鰅	儿一曲目巛
讟	言寸二目言
譓	言寸梄曲之
裛	言儿口一乙
庈	广大人言又
癓	广一人月竹
煆	米人又又又
慴	米卜乙乙川
璗	添添曲三言
屧	又竹人巛梄
緀	巛一一又巛
娵	巛竹三十又
媟	巛竹十巛梄
繜	巛一米梄寸
珇	三一目三
磞	大一目月月
戉	七竹巛添
鱆	儿一言曲十
迿	之一儿乙曲
縺	巛一之一梄
墕	二一一巛米
璱	三一三之竹
耰	三卜梄之儿
顜	十二目二大
葹	十卜言竹乙
檮	梄一二口寸
楒	梄一曲卜之
椸	梄一言竹乙
櫠	梄一广乙月
耏	大目斤三
逴	之一卜曲十
惄	卜一曲又之
蛜	口巛川添又
喩	口一人月巛
矙	目一又三竹
牣	竹二乙寸言
倰	川添二人儿
鯈	川添卜儿儿
皀	川曲儿儿
饛	人又十一大
鎡	斤一米巛巛
狶	月竹人大目
胐	月一巛曲巛
鱨	儿一曲儿曲
麕	广又口寸竹
慒	米卜一曲曲
墯	米卜大月二
嫈	米人米之巛
瀀	添添一之儿
滮	添添卜七斤
澨	添添竹人人
宨	之寸儿寸添
歠	又言又梄儿
櫆	梄一川广十
柀	梄一又卜
蹐	口卜添人月
詗	言寸目寸口
疢	广一米人
耇	二竹儿乙口
騤	三米又一大
捄	寸添一曲言
莟	十卜人又口
杤	梄一一添乙
槱	梄一梄寸米
榤	梄一儿十梄
豭	大月又又又
蠙	口巛之曲目
嵜	目目言一口
睟	目一言人十
髇	目之言目口
鵞	竹寸七竹儿
儓	川添二之七
臮	川目大川
斶	斤寸目儿口
鈒	斤一乙添人
鉾	斤一巛言竹
獫	月竹人人人
胣	月一竹一乙
朣	月一言曲二
鯣	儿一曲儿斤
鵻	儿巛川卜
襃	言儿斤口梄
竸	言米曲曲儿
旐	言乙竹儿添
憯	米卜七儿曲
愓	米卜曲儿斤
憿	米卜川言竹
窐	之人二一二
禫	二曲梄曲十
闠	又寸口一目
劙	巛又大口曲
杄	梄一竹十
碪	大一十三巛
磥	大一曲卜巛
籛	竹言斤七七
鶖	竹梄米人儿
偖	川添二竹
鉼	斤一米一十
詖	言寸又卜
痓	广一七二
疕	广一儿儿
擏	寸添十口竹
拵	寸添大卜乙
葱	十卜儿言之
礑	大一曲口曲
磏	大一米曲人
虤	卜七卜七
虡	卜七曲米人
勴	卜七曲之乙
蟐	口巛曲口目
嗊	口一二卜目
咈	口一乙巛川
暿	曲一二米口
盷	目一儿乙广
犅	竹二目米目
犏	竹二之目十
嵆	竹梄大儿目
谺	人一人口七
鑯	斤一人曲一
魶	儿一目寸人
鰡	儿一儿竹曲
甮	儿乙斤三月
褢	言儿川口
炣	米人一卜口
熛	米人梄口二
焞	米人言口乙
澒	添添二卜大
潖	添添三三乙
浰	添添竹梄曲
瀺	添添儿儿言
闤	又寸目口儿
翆	乙广乙月十
緁	巛一一又卜
嫕	巛竹七竹之
莤	十卜梄寸
礉	大一川言竹
虰	口巛一卜
旴	曲一一添寸
鐻	斤一卜七大
狦	月竹目曲二
蠪	言卜口巛
洴	添添米一十
肂	一添儿又二
疌	一添又二卜
瑔	三一川曲曲
騊	三米儿十巛
颿	三米月卜
冓	十二目寸二
荂	十卜大一一
薁	十卜川米大
酖	梄寸之之儿
輴	梄曲斤十目
靆	梄添二又添
踼	口卜曲儿斤
緜	川曲目竹巛
谼	人一人十人
鶹	儿竹曲卜儿
玈	言一巛竹儿
爁	米人七竹目
溹	添添十之巛
滖	添添言儿曲
漒	添添乙口口
犚	又竹二寸竹
翴	乙广乙之梄
姶	巛竹人一口
絫	巛言巛巛巛
斮	十一曲一斤
蓏	十卜斤言斤
郙	梄二乙口
桭	梄一大七
椓	梄一大月
柶	梄一目曲
砠	大一目三
蚳	口巛儿七言
咺	口一二寸曲
羇	目曲十一口
睄	目一曲人月
垈	川添七言二
弅	人一乙寸十
旟	言乙竹卜人
絓	巛一二一二
郖	一添口米乙
墡	二一米米口
垏	二一又大二
鬒	三七斤目人
駣	三米儿寸添
鼒	寸言竹巛川
萷	十卜曲月曲
柾	梄一一添卜
覊	梄口十十三
揅	大一一十竹
鹸	卜寸口口人
胔	卜卜儿人人
蚗	口巛又添大
踘	口卜儿乙米
嗈	口一巛口乙
黚	目曲二米十
崏	目目儿七曲
穣	竹梄言人十
傱	川添人人卜
膃	月一口人目
腨	月一目目大
獞	月竹言曲二
愊	米卜一口曲
憭	米卜一曲曲
滍	添添巛一口
禓	二曲曲儿斤
雝	巛寸口乙川
繷	巛一曲曲大
塤	二一口一目
玔	三一川寸
璲	三一之米大
瑂	三一又竹目
搰	寸添目之
扡	寸添乙卜
垔	梄口二一
虖	卜七竹米寸
睧	目一儿七曲
鉥	斤一梄一言
怗	米卜卜寸口
恀	米卜儿言儿
浿	添添目人
垽	添添斤寸二
泒	添添斤言
戤	乙添竹目七
絽	巛一口一口
瓩	一巛竹十
埻	二一言口乙
埪	二一之人二
騨	三米添曲一
尠	十三巛曲竹
藰	十卜儿斤曲
轓	梄曲斤梄曲
樆	梄一言目巛
硴	大一十川儿
敁	卜寸口卜又
蚑	口巛十寸又
齗	卜人斤寸
鷶	目曲目人儿
籖	竹言十曲一
篊	竹言添十人
鰊	儿一梄一目
褱	言儿目曲曲
麌	广又口一大
籺	米梄竹一乙
浺	添添米卜口
鴳	之寸巛竹儿
鷫	又大川巛儿
脀	又添曲一月
絁	巛一竹一乙
縿	巛一巛人斤
玒	三一二卜
揤	寸添又人乙
橿	梄一三曲曲
榠	梄一之言人
箎	竹言卜七
腤	月一言米曲
蜰	月一乙曲口
渽	添添十七口
丏	一卜巛添乙
嫢	二言目儿巛
壖	二一梄添大
髢	三七斤三乙
珋	三一儿竹
摵	寸添七卜曲
搉	寸添之之川
鞙	十十口一月
橞	梄一梄曲之
輌	梄曲一目目
棆	梄一人目十
郲	梄一人人乙
椨	梄一广川寸
霒	梄添二言又
椵	梄一又又又
蟅	口巛广十米
踦	口卜大一口
喿	口一口口梄
帊	目卜乙曲
黓	目曲二米七
岨	目目目三
峿	目目二又口
鵙	目人儿巛
犆	竹二十寸目
笯	竹言巛竹又
儳	川添儿儿言
傔	川添米曲人
僪	川添又人口
嵞	人寸竹目目
劔	人寸一乙言
爼	人言人言目
饂	人又曲一目
狤	月竹二二口
魣	儿一又又卜
穈	广大梄梄竹
罃	米人米十巛
憸	米卜人人人
愼	米卜儿巛人
懰	米卜儿斤曲
漧	添添十竹乙
淴	添添儿斤之
礿	二曲儿乙言
鼆	之之曲人之
瑃	三一三人
桟	梄一七竹
杣	梄一目目
瞶	目一口一目
衖	人卜十一人
鋗	斤一口一月
腞	月一巛又大
訒	言寸乙寸言
泬	添添之人
坉	二一一添巛
挴	寸添竹一巛
茢	十卜一儿曲
靮	十十儿乙言
靿	十十巛巛乙
茘	十卜乙乙乙
醲	梄寸曲曲大
硠	大一言添又
逌	之一卜口又
蝋	口巛添月二
啅	口一卜曲十
踧	口卜卜曲又
囋	口一竹儿目
晼	曲一之儿乙
笝	竹言口寸又
衃	竹添目梄大
毇	川二米梄月
儑	川添曲巛米
鶬	人寸之口儿
鎞	斤一川儿儿
艎	斤乙川曲三
旓	言乙竹曲月
楶	广寸儿口梄
憀	米卜乙人斤
汫	添添二寸川
泲	添添竹巛川
瀌	添添广又米
韘	又口口巛梄
鳲	又竹儿巛
翣	乙广乙言巛
婐	巛竹曲卜梄
坴	二一人一二
掯	寸添卜卜月
蕼	十卜三又二
苙	十卜言米
榾	梄一目之
柲	梄一之巛竹
梫	梄一又之又
咶	口一竹卜
馝	竹梄曲之竹
筶	竹言竹二口
侲	川添大七
僶	川添之又
悁	米卜口一月
夒	一添川人儿
堐	二一大二二
栔	三卜乙寸梄
揊	寸添一口曲
薣	十卜二十又
醧	梄寸七口口
轒	梄曲十十目
輁	梄曲十一人
軦	梄曲口一儿
憖	梄一人大之
礵	大一梄梄目
硊	大一儿大乙
磳	大一米目曲
畷	曲卜又又又
罳	目曲曲卜之
黵	目曲二人言
簁	竹言人卜卜
侐	川添竹添目
豃	人一人三竹
癋	广一二巛之
麃	广又米言
粻	米梄三七
粃	米梄儿儿儿
燀	米人口曲一
悀	米卜又言月
汯	添添大寸巛
悹	之寸乙又之
窴	之人十目人
禬	二曲人目曲
袹	之广一添川
衭	之广二言
襗	之广目二米
襋	之广梄梄目
嫮	巛竹梄一一
綌	巛一人人口
琔	三一之一卜
珢	三一又人
挃	寸添七二
拸	寸添儿言儿
薕	十卜广曲人
碡	大一三卜巛
蝘	口巛七曲巛
唗	口一二人
鋘	斤一口一大
鈶	斤一巛言口
膕	月一口口一
肕	月一乙寸言
痁	广一卜寸口
痟	广一曲人月
憪	米卜又寸月
宧	之寸七一
櫜	一添口口梄
坋	二一人一乙
埢	二一米二乙
鷇	二二之儿月
畺	三寸曲卜曲
髽	三七斤人二
鬋	三七斤月曲
鬅	三七斤月月
髴	三七斤乙川
耞	三卜梄乙口
騇	三米人寸竹
揳	寸添三乙大
鞳	十十十一口
蔾	十卜竹竹梄
蓨	十卜川儿月
薝	十卜儿人言
芛	十卜又大
蘟	十卜乙又之
橾	梄一口口梄
軑	梄曲大寸
輵	梄曲曲人巛
朳	梄一人一
橧	梄一米目曲
梡	梄一之一一
槢	梄一乙乙川
礛	大一七竹目
豷	大月二口米
礒	大一米竹七
哳	口一寸添斤
跱	口卜二一寸
踖	口卜十一曲
踾	口卜一口曲
踛	口卜二人二
鼈	目卜添竹之
罿	目曲言曲二
睌	目一儿口儿
穟	竹梄之米大
箯	竹言川曲人
躾	川三米三大
魌	川口十三
伭	川添言一巛
畣	人寸一口曲
彾	人卜人寸之
膴	月一竹十米
狢	月竹儿卜口
雑	月乙梄一川
觭	儿添月一口
鶁	言一口曲儿
帟	言曲目卜
凔	广寸人之口
痷	广一大寸曲
痗	广一竹一巛
愒	米卜曲人巛
煟	米人曲卜月
濳	添添竹儿曲
滫	添添川儿月
戺	之竹乙二
穽	之人二寸川
袵	之广川竹二
袾	之广竹一梄
袟	之广竹二人
矠	又言又十曲
纒	巛一大米二
妦	巛竹三卜
嫴	巛竹十口言
媢	巛竹曲一目
梩	梄一曲卜二
呥	口一目寸二
嵥	目目儿十梄
釽	斤一斤添
諕	言寸卜七
恇	米卜七添三
忺	米卜儿人
抎	寸添二寸巛
搊	寸添儿儿巛
拹	寸添乙乙乙
靱	十十乙寸言
苉	十卜七添儿
薐	十卜竹人儿
蘤	十卜川曲斤
檝	梄一口三七
欉	梄一曲三又
鸉	梄一曲斤儿
霨	梄添又二寸
豝	大月乙曲
磜	大一儿又二
螋	口巛川卜又
齸	卜人米人目
哱	口一十之乙
唣	口一川曲七
颽	目目一米月
簗	竹言添人梄
齇	川目曲卜目
猨	月竹斤大又
猇	月竹卜七
粂	儿添言添米
齌	言一米川米
秶	广寸儿人竹
廘	广大广又
懁	米卜目口儿
熯	米人十口二
盓	添添一寸目
溔	添添米三米
慂	添添又月之
袺	之广二二口
邥	之之儿寸乙
衋	又大二竹目
閈	又寸一十
弨	乙巛乙寸口
帤	巛竹口一目
嫶	巛竹川卜米
繂	巛一言添十
俇	川添月竹三
僎	川添乙十人
搫	斤乙月又竹
朒	月一目人人
痄	广一竹一卜
埳	二一儿添川
埣	二一言人十
塀	二一又米十
聑	三十三十
駹	三米大儿斤
驏	三米又乙乙
摲	寸添梄曲斤
摓	寸添之儿三
莝	十卜人人二
薶	十卜斤曲二
蘱	十卜米大大
藋	十卜乙乙川
輑	梄曲又大口
軷	梄曲大言又
柍	梄一目寸大
桼	梄一人寸曲
磌	大一十目人
磹	大一梄曲十
嫛	七添竹月巛
暶	曲一言又卜
黫	目曲二梄二
歜	目曲儿口儿
岝	目目竹一卜
嶦	目目儿人言
牼	竹二一巛二
氠	竹乙曲梄
偫	川添人二寸
讆	人卜又十言
彸	人卜人一巛
巵	斤寸一添乙
獩	月竹卜一曲
猫	月竹十卜曲
猼	月竹梄二寸
鯰	儿一人又之
韹	言米曲川三
斻	言乙竹一月
鄌	广大又口乙
爌	米人广曲人
渿	添添梄一二
硰	添添曲竹大
渰	添添人口十
寍	之寸之巛目
衱	之广乙添人
隮	乙口言儿川
隒	乙口米曲人
盄	乙巛卜添目
琫	三一三人二
扜	寸添一添寸
茷	十卜川添七
柧	梄一斤言
暰	曲一人人卜
穬	竹梄广曲人
餧	人又竹梄巛
鎃	斤一添斤儿
胻	月一人卜
魛	儿一乙寸
翿	二二又乙乙
耹	三十人言又
搘	寸添二儿曲
搕	寸添二巛目
苀	十卜言一月
醂	梄寸梄一梄
軓	梄曲月言
軧	梄曲儿七言
楥	梄一斤大又
霠	梄添言言又
砆	大一二言
毉	七添竹人人
蠏	口巛儿乙竹
啑	口一一又卜
蹢	口卜言十口
鴠	曲一一添儿
昢	曲一巛曲巛
帢	目卜人一口
罧	目曲梄一梄
髆	目之梄二寸
鄦	竹一十米乙
犌	竹二又又又
礜	川二一人大
僄	川添梄口二
俋	川添口一乙
鄃	人寸一曲乙
徛	人卜大一口
谹	人一人大巛
錭	斤一月二口
鯵	儿一巛大斤
羓	米三乙曲
煠	米人十巛梄
瀸	添添人曲一
潠	添添乙十人
寱	之寸巛川梄
窵	之人儿巛
禗	二曲曲卜之
闚	又寸二言目
劀	又言又口曲
纎	巛一十曲一
塼	二一梄曲寸
莏	十卜寸曲竹
荓	十卜米一十
芀	十卜乙寸
俔	川添目儿
倠	川添川卜
胵	月一七二
誂	言寸儿寸添
痀	广一儿乙口
赩	二一米儿乙
壿	二二米梄寸
璊	三一十人人
驒	三米口曲一
馰	三米儿乙言
抶	寸添竹二人
蓺	十卜二二月
藇	十卜川卜人
虀	十卜言曲一
翲	梄口二乙乙
龗	梄添口口言
樒	梄一之竹目
鴎	七添人言儿
翽	卜卜七乙乙
嚘	口一一之儿
剕	曲三曲寸
晐	曲一言巛人
岻	目目儿七言
嶍	目目乙乙川
箾	竹言曲月曲
餲	人又曲人巛
鑢	斤一卜曲之
玃	月竹目川又
鱄	儿一梄曲寸
觺	儿儿竹儿月
鯒	儿一又言月
臝	言七口梄月
毃	言一口口月
廎	广大儿儿大
麞	广又言曲十
慱	米卜梄曲寸
禜	米人米之二
澁	添添卜卜卜
淈	添添又巛巛
袿	之广二一二
褾	之广梄口二
襚	之广之米大
褷	之广人卜卜
綟	巛一之竹大
堈	二一目米目
蕑	十卜又寸月
枅	梄一一添十
霣	梄添口一目
碈	大一儿七曲
硍	大一又人
蜼	口巛川卜
貤	目人乙卜
猲	月竹曲人巛
魬	儿一斤寸又
謑	言寸斤巛大
悺	米卜之寸乙
洭	添添七添三
阞	乙口乙竹
壻	二一又卜月
髷	三七斤三曲
駜	三米之巛竹
挋	寸添七一
抌	寸添之之儿
撏	寸添又口寸
蔏	十卜言人口
蘪	十卜广又米
橑	梄一一曲曲
輀	梄曲大目
雽	梄添竹米寸
碔	大一一七卜
顑	七大一口大
齯	卜人川二儿
蜋	口巛言添又
螾	口巛之曲人
鄤	曲一目又乙
猒	曲一月一大
眐	目一一添卜
嶊	目目寸添川
岒	目目人言又
巕	目目米言乙
嵙	目目竹广十
犞	竹二竹目口
牰	竹二曲二
稰	竹梄又卜月
籯	竹言言目月
侻	川添米口儿
谽	人一人又口
猘	月竹竹目曲
腅	月一米人米
弮	米二乙巛
爚	米人人目十
窔	之人言人人
褯	之广广十目
袸	之广大卜乙
闟	又寸人乙乙
隃	乙口人月曲
弉	巛大二二十
婤	巛竹月二口
緷	巛一之之梄
掗	寸添二巛
荁	十卜二寸曲
菵	十卜目米言
欂	梄一十梄寸
磎	大一斤巛大
螖	口巛目之
郋	川目乙口
鑐	斤一梄添大
瘏	广一二竹
泜	添添儿七言
絇	巛一儿乙口
聢	三十之一卜
琖	三一七竹七
瑫	三一斤添川
攩	寸添曲二米
挧	寸添乙广乙
兡	十寸口一川
菨	十卜言米巛
橖	梄一曲口梄
軥	梄曲儿乙口
麰	梄一人巛竹
柮	梄一巛曲巛
硲	大一人人口
齰	卜人十一曲
踆	口卜巛人儿
踠	口卜之儿乙
肙	口一月一
呟	口一言一巛
蟞	目卜添竹口
鷩	目卜添竹儿
瞁	目一目一大
郔	乙言竹卜乙
皭	川曲斤又寸
鑁	斤一人人儿
狉	月竹大卜一
魠	儿一竹添七
坒	儿儿儿儿二
譐	言寸米梄寸
麛	广又乙巛三
灈	添添目目川
溵	添添斤乙月
澭	添添言巛川
潳	添添又竹二
鶱	之寸十人儿
扅	之竹儿言儿
閵	又寸川卜
韥	又口口目目
屘	又竹竹七乙
凾	又乙口又巛
彃	乙巛曲十二
猪	月竹二竹
册	月添月添一
葀	十卜寸添竹
跓	口卜言添三
尟	曲一一曲竹
旵	曲一目目
郥	目人乙口
侜	川添斤乙
鼸	川二巛曲人
鉊	斤一乙寸口
魦	儿一曲人竹
綑	巛一口寸梄
趎	二人竹一梄
擩	寸添梄添大
拤	寸添卜一卜
靭	十十乙寸言
鄸	十卜目儿乙
莚	十卜乙竹卜
葅	十卜人人目
蘠	十卜巛口口
轃	梄曲三人竹
輹	梄曲竹曲儿
枍	梄一人一一
霬	梄添曲十人
礂	大一二米口
翈	曲乙乙广乙
畇	曲卜儿乙广
峮	目目又大口
甒	竹一十米一
犩	竹梄巛川竹
鼪	川二巛寸竹
敜	人寸言之竹
鈎	斤一儿乙巛
獡	月竹川巛米
肣	月一人言又
讔	言寸乙又之
瘭	广一梄口二
廐	广大又七儿
痎	广一言巛人
忨	米卜一添一
齹	米三二卜卜
糒	米梄十竹月
爊	米人广又米
漹	添添一巛米
漰	添添目月月
禴	二曲人目十
闒	又寸曲乙乙
鄝	乙广乙斤乙
揕	寸添十三巛
荴	十卜寸添二
薙	十卜竹大川
嘄	口一儿巛梄
獶	月竹一之儿
悋	米卜言人口
姼	巛竹儿言儿
髲	三七斤三又
镼	三七又巛巛
瑲	三一人之口
馺	三米乙添人
珒	三一又大二
螒	十寸曲人口
蕀	十卜梄梄目
藅	十卜目言曲
蕠	十卜巛口巛
榑	梄一梄二寸
樕	梄一梄口儿
覂	梄口竹添之
鑋	梄曲一二斤
輬	梄曲言口曲
轇	梄曲乙人斤
棭	梄一言儿言
顬	梄添大目大
霿	梄添又儿目
鄏	大七寸言乙
躣	口卜目目川
嘐	口一乙人斤
曻	曲一儿言十
骭	目之一十
濌	竹十曲曲曲
稭	竹梄儿儿川
簥	竹言竹目口
傿	川添一巛米
鼫	川二巛寸大
齉	川目曲十儿
忁	人卜曲大曲
膞	月一梄曲寸
猯	月竹目目大
腒	月一又十口
邍	之一儿又曲
夗	儿言乙目
譸	言寸二口寸
庲	广大梄人人
慉	米卜言巛曲
灪	添添竹儿斤
窌	之人儿竹
祩	二曲竹一梄
嶞	乙口大月目
楖	梄一又人乙
硾	大一竹十二
呇	曲添口一
氆	竹七米曲曲
飋	月卜三之竹
訹	言寸梄一言
漘	添添大七月
皷	二二口米又
髳	三七斤又川
瑖	三一川三月
駈	三米斤二
騬	三米竹广儿
璸	三一之曲目
璚	三一又人口
揥	寸添言之目
菎	十卜曲儿儿
葂	十卜儿儿乙
槵	梄一口口之
欋	梄一目目川
奅	大寸儿竹
碻	大一言目口
虴	口巛竹添七
踑	口卜十三
躙	口卜又寸川
嗃	口一言目口
昦	曲一大寸川
帩	目卜曲人月
眒	目一曲梄
瞛	目一人人卜
鼶	川二巛斤卜
雔	川卜川卜
牉	川又米二
貒	斤月目目大
舽	斤乙儿卜十
狿	月竹乙竹卜
腶	月一川三月
膌	月一添人月
曶	儿乙斤三曲
皽	言一口一又
竫	言米儿添又
癗	广一梄添曲
劘	广大梄曲曲
慺	米卜曲口巛
爔	米人米七一
慞	米卜言曲十
淢	添添七口一
汃	添添人一
扊	之竹米人米
袑	之广乙寸口
闛	又寸曲口二
陓	乙口大一一
彄	乙巛七口口
斨	巛大斤寸
縒	巛一米三二
紽	巛一之寸儿
摝	寸添广又
剸	梄曲寸言曲
硥	大一大儿斤
鴀	大卜儿巛
蟭	口巛川卜米
虙	卜七之巛竹
踶	口卜曲一卜
噅	口一斤米
覣	竹梄巛竹目
鱴	儿一十七言
鱍	儿一又乙月
詅	言寸人寸之
痡	广一梄二
愖	米卜十三巛
涍	添添二竹乙
澖	添添又寸梄
鷊	一添口一儿
髾	三七斤曲月
摮	三卜乙竹竹
騽	三米乙乙川
掝	寸添七口一
黇	十一曲卜口
疐	十寸之又卜
鞧	十十米寸梄
胾	十寸七人人
蕋	十卜卜卜卜
藘	十卜卜曲之
蔨	十卜口米乙
薃	十卜添目口
柣	梄一竹二人
梒	梄一人又口
怷	十寸儿言之
棳	梄一又又又
覤	卜七目儿
噳	口一卜一大
唌	口一乙竹卜
噇	口一言曲二
晱	曲一米人米
鸅	目曲二米儿
崣	目目竹梄巛
穱	竹梄斤又寸
魖	川口卜七曲
匁	儿乙人言
歊	言一口口儿
籵	米梄十寸
瀎	添添十七言
橤	之巛之之梄
韍	又口口大又
屭	又竹目目目
翏	乙广乙人斤
絏	巛一曲梄竹
蠁	巛人言乙口
扤	寸添一儿
荎	十卜七二
棷	梄一三十又
跧	口卜人寸三
肵	月一斤寸
觼	儿添月目儿
忯	米卜儿七
漦	二寸梄大曲
壷	二二之口一
駼	三米人寸竹
馻	三米巛言儿
薚	十卜一儿斤
薉	十卜卜一曲
樲	梄一七二目
槾	梄一曲目又
鶫	梄一目曲儿
欃	梄一儿儿言
霐	梄添添乙巛
梮	梄一又乙口
磿	大大竹竹大
礔	大一又口言
瑿	七添竹三言
蠎	口巛十十十
跦	口卜竹一梄
曣	曲一十儿米
睖	目一二人儿
逬	之一竹竹一
犑	竹二目一大
犉	竹二言口乙
籧	竹言之卜大
牏	川又人月曲
韽	人寸言言曲
鎉	斤一曲乙乙
腢	月一曲目巛
胏	月一竹巛川
鱊	儿一又人口
鯞	儿一又之目
鰼	儿一乙乙川
鱳	儿一川巛梄
鸁	言七口儿月
懅	米卜卜七大
濎	添添目巛川
蠥	巛曲竹言口
絖	巛一曲人一
机	梄一月寸
璥	三一十口竹
捁	寸添竹二口
椙	梄一曲一曲
桵	梄一斤添巛
笲	竹言巛言十
釴	斤一七言
陼	乙口二竹
鬷	一添口人儿
斄	二寸梄人人
趌	二人二二口
圠	二一巛添
聏	三十大目
撗	寸添十曲人
撌	寸添口一目
揟	寸添又卜月
擽	寸添川巛梄
菆	十卜三十又
鞿	十十巛七人
蟇	十卜曲大口
鴱	十卜人言儿
醰	梄寸梄曲十
樠	梄一十人人
槫	梄一梄曲寸
橝	梄一梄曲十
軱	梄曲斤言
慙	梄曲斤寸之
磝	大一三乙竹
豶	大月十十目
蟷	口巛曲口曲
蛈	口巛竹二人
蠰	口巛言口十
幖	目卜梄口二
嶕	目目川卜米
岉	目目儿乙斤
罏	竹一十曲目
犗	竹二之三口
穮	竹梄广又米
舑	竹卜目寸二
篹	竹言目大乙
帠	川二目卜
侇	川添大寸乙
膫	月一一曲曲
獝	月竹又人口
鮖	儿一大一
鰐	儿一口一一
欴	言添又人儿
羢	米三七竹大
懱	米卜十七言
熂	米人竹乙米
爓	米人又儿川
洍	添添七一
鶷	之寸三口儿
禂	二曲月二口
邆	之一又口米
隶	又大添添
陾	乙口大目大
阰	乙口儿儿儿
鶭	巛一言乙儿
坽	二一人寸之
蹔	梄曲斤寸口
奫	大寸添川巛
蠬	口巛言卜
犕	竹二十竹月
詑	言寸之寸儿
浧	添添口一三
沜	添添川又
歾	一添儿儿斤
墐	二一十口三
趮	二人口口梄
赸	二人目目
鬙	三七斤目曲
謷	三卜乙竹言
剚	一添口又曲
靽	十十米二
蚅	口巛大大乙
鮆	卜卜儿儿儿
蟧	口巛米之乙
畟	曲卜人一儿
鴫	曲卜儿巛
曒	曲一川言竹
暲	曲一言曲十
幨	目卜儿人言
瞏	目曲二口儿
穖	竹梄巛七人
稌	竹梄人寸竹
馞	竹梄曲之乙
簒	竹言目竹巛
鸒	川二一卜儿
獌	月竹曲目又
贕	儿竹言目目
粊	儿儿儿儿米
鰞	儿一儿川
譪	言寸十人巛
庉	广大一添巛
羒	米三人一乙
膋	米人米之月
惸	米卜儿曲乙
濿	添添大目巛
灨	添添言二目
竃	之人二曲曲
襂	之广巛人斤
隞	乙口三乙竹
敶	乙口梄曲竹
縅	巛一七一巛
纑	巛一卜曲目
繟	巛一口曲一
塴	二一目月月
蓫	十卜之一大
餫	人又之之梄
膇	月一之竹乙
湆	添添言米曲
襏	之广又乙月
堼	二一二寸二
尌	二二口米寸
珫	三一言巛儿
驞	三米之曲目
薵	十卜二口寸
荺	十卜二儿广
靫	十十又言言
虈	十卜口口口
苵	十卜竹二人
躠	十卜竹言口
楲	梄一七一巛
樀	梄一言十口
匳	七添人人人
蝒	口巛又口目
劋	口一口梄曲
逿	之一曲儿斤
羃	目曲十大目
崰	目目巛寸曲
眅	目一斤寸又
秮	竹梄巛言口
峊	竹添乙又目
鼵	川二巛之大
鬿	川口斤寸
倹	川添人口人
剱	人寸一乙言
胈	月一大言又
玂	月竹十一斤
謋	言寸儿十梄
廮	广大目目巛
燡	米人目二米
恔	米卜言人人
灂	添添斤又寸
襮	之广曲人曲
袶	之广儿卜十
韐	又口口一口
頚	又言二一大
緎	巛一七口一
掜	寸添川二儿
碨	大一曲一儿
蚄	口巛言乙
暵	曲一十口二
篿	竹言梄曲寸
鰶	儿一儿又二
詍	言寸十一巛
迾	之一一儿曲
奊	二一二一言
瓡	二一米二斤
刵	三十曲寸
騞	三米三卜大
騜	三米川曲三
璒	三一又口米
摎	寸添乙人斤
蔪	十卜梄曲斤
蒧	十卜七卜口
醊	梄寸又又又
軘	梄曲一添巛
轠	梄曲曲曲曲
轞	梄曲七竹目
桝	梄一儿言十
奲	大寸二曲一
蜨	口巛一又卜
遉	之一卜寸目
喣	口一儿口米
礨	曲卜曲曲大
矘	目一曲二米
岪	目目乙巛川
骾	目之一曲人
矲	竹大目儿儿
穋	竹梄乙人斤
鳰	人寸儿巛
歈	人寸一曲儿
艑	斤乙之目十
狫	月竹二竹儿
猈	月竹川口十
腏	月一又又又
爢	广大梄曲米
麖	广又言口曲
粁	米梄竹十
慛	米卜目目川
燗	米人又寸月
漋	添添乙一竹
禠	二曲斤寸卜
襛	之广曲曲大
裺	之广大寸曲
剭	又竹七二曲
媕	巛竹人口十
搤	寸添米人目
膵	月一十人十
癠	广一言儿川
碆	添添又卜大
駥	三米七竹大
驉	三米卜七曲
摠	寸添川儿之
勩	十一巛目乙
臡	十一口人人
酳	梄寸巛巛月
樧	梄一人言月
礧	大一曲曲曲
卼	一儿儿大乙
磍	大一之三口
顣	七大卜曲大
朁	七寸儿儿曲
蠸	口巛十口川
蠨	口巛十川巛
跿	口卜二人
躆	口卜卜七大
喭	口一言竹斤
酅	目目川口乙
缹	竹一十巛米
鯬	竹梄儿竹儿
鬾	川口十寸又
臲	川目梄大乙
欱	人寸一口儿
韱	人寸人曲一
犿	月竹言一卜
鶀	儿巛十三
庮	广大梄寸
煣	米人又川梄
閜	又寸一卜口
楘	又言又竹梄
翂	乙广乙人乙
邿	二一寸言乙
撋	寸添又寸三
蚇	口巛又竹言
郘	口一口一乙
蹸	口卜米儿十
覛	斤寸儿七目
膢	月一曲口巛
歍	儿川儿人
迒	之一言一月
瘣	广一川口
汱	添添大言
汦	添添儿七
阤	乙口乙卜
趡	二人川卜
堩	二一米二曲
聝	三十七口一
琡	三一卜曲又
璅	三一巛曲梄
抭	寸添之寸月
頍	十寸又言大
蔮	十卜口口一
薎	十卜目川七
蕍	十卜添月曲
芵	十卜又添大
轗	梄曲七口之
軞	梄曲竹七
檍	梄一言曲之
鵸	大寸一口儿
鬳	卜七一米一
蝯	口巛斤大又
蛫	口巛儿大乙
蜛	口巛又十口
蠾	口巛又儿口
跍	口卜十寸口
蹝	口卜人卜卜
朄	曲梄梄一目
晜	曲一米乙川
瞫	目一梄曲十
篭	竹言言米曲
饁	人又二巛目
鑕	斤一斤斤目
覶	斤添又又目
獿	月竹一人儿
腛	月一又竹七
鯲	儿一言人广
譺	言寸儿又卜
廧	广大二口口
鄁	广卜儿月乙
憢	米卜二二一
逤	之一添曲竹
襣	之广川一川
覭	之之曲人目
鼏	之之目巛川
鱀	又人七儿儿
娙	巛竹一巛二
鴽	巛竹口一儿
趍	二人儿言儿
蕦	十卜斤三大
碄	大一梄一梄
螁	口巛之一又
虭	口巛乙寸
蛁	口巛乙寸口
罺	目曲巛曲梄
鈆	斤一人一巛
縏	斤乙月又巛
鵔	儿巛巛人儿
訿	言寸卜卜儿
衵	之广曲一
郠	一添曲人乙
壴	二二口一米
髠	三七斤三月
挬	寸添十之乙
兙	十寸口儿十
莥	十卜月又卜
欶	梄一口一儿
欝	人言人又寸
砐	大一乙添人
蟖	口巛十三斤
瓽	曲人之口一
嵺	目目乙人斤
嵾	目目巛人斤
骴	目之卜卜儿
箚	竹言人口曲
笐	竹言言一月
顖	川口人之大
傰	川添目月月
錻	斤一一七卜
胘	月一言一巛
鴥	儿巛之人
斖	言人川口目
齍	言一米川目
癵	广一言人人
懥	米卜十又卜
爟	米人十口川
炾	米人口一儿
悷	米卜之竹大
瀄	添添竹又乙
澓	添添人曲儿
襢	之广言曲一
堾	二一三人
扨	寸添乙寸言
蛓	十寸七竹口
栂	梄一巛乙
蛣	口巛二二口
蠉	口巛目口儿
鋄	斤一一米又
譝	言寸之又
翍	乙广乙广又
鶝	一添口曲儿
瑓	三一梄一目
髺	三七斤三竹
駬	三米三十
瑵	三一又言口
擖	寸添十人巛
攭	寸添巛口口
剒	十一曲一曲
葴	十卜七一口
芚	十卜一添巛
蓚	十卜川儿斤
醓	梄寸之儿目
櫹	梄一十川巛
輘	梄曲二人儿
杁	梄一人寸
桹	梄一言添又
鷞	大寸人人儿
贙	卜七卜七目
蹞	口卜儿儿大
咉	口一目寸大
巏	目目十口川
嵲	目目川目梄
崷	目目米寸梄
矉	目一之曲目
犐	竹二竹广十
篎	竹言目曲竹
鵅	儿卜口一儿
鰜	儿一米曲人
螤	言人口曲人
漮	添添广又添
漅	添添巛曲梄
縰	巛一人卜卜
盭	巛巛二竹目
藄	十卜十三巛
朼	梄一儿儿
磈	大一川口
跈	口卜人寸斤
巑	目目竹儿目
誻	言寸曲添曲
鴐	乙竹口一儿
陫	乙口曲三
耾	三十大寸巛
抪	寸添大寸目
藲	十卜梄口口
臷	十寸七竹七
藈	十卜目一大
蘬	十卜竹之目
鵏	梄二儿巛
楕	梄一大二月
椣	梄一目十人
梴	梄一乙竹卜
麷	梄一人口米
蠠	又添口口口
鵄	七二儿巛
蟟	口巛一曲曲
蠦	口巛卜曲目
齖	卜人七卜
瞡	目一二言目
稑	竹梄二人二
傂	川添斤寸卜
偯	川添言儿口
蠫	斤月曲口口
舼	斤乙十一人
艐	斤乙人人儿
鱵	儿一竹一口
欿	儿添川二儿
諔	言寸卜曲又
譈	言寸言乙竹
廦	广大又口言
鶊	广大又人儿
渜	添添大目大
溠	添添米三二
寁	之寸一又卜
刔	又添大寸曲
鵖	又人儿巛
翪	乙广乙人儿
縓	巛一大川曲
絋	巛一广大巛
葟	十卜川曲三
釱	斤一大寸
凩	月寸梄一
諓	言寸七竹七
豏	一添口曲人
瓀	三一梄添大
蓻	十卜二米月
雗	十寸曲竹川
苲	十卜竹一卜
蓎	十卜广又口
醶	梄寸人人人
輲	梄曲目目大
梻	梄一川乙川
砄	大一又添大
貣	七言目人
齝	卜人巛言口
蹅	口卜梄曲一
嵅	目目七一口
甀	竹十十二一
篞	竹言添曲二
伜	川添月乙十
顩	人寸一人大
鎺	斤一二曲目
舩	斤乙人一巛
膙	月一乙口口
鵤	儿添月二儿
袌	言儿儿乙乙
怢	米卜竹二人
怋	米卜乙二七
懘	添添十目之
湨	添添目一大
阸	乙口之竹乙
婘	巛竹米二乙
諅	十三言寸
梜	梄一大人人
砅	大一曲添
硉	大一又大二
嵽	目目十之目
穨	竹梄月一目
泧	添添七竹巛
溾	添添川口
邧	一添一儿乙
镻	三七竹二人
鬄	三七斤儿斤
駪	三米竹二儿
騉	三米曲儿儿
薞	十卜一儿人
蘡	十卜目目巛
釂	梄寸斤又寸
檕	梄曲巛月梄
橅	梄一竹十米
豥	大月言巛人
尳	大儿目之
齾	卜七一大卜
躟	口卜言口十
踤	口卜言人十
鷕	口一川卜儿
嚪	口一又儿川
啒	口一又巛巛
峞	目目儿大乙
秠	竹梄大卜一
轝	川二一人梄
鵀	川添竹二儿
酓	人寸言又梄
忀	人卜言口十
狾	月竹寸添斤
魳	儿一一添目
鰋	儿一七曲巛
蝱	言七口巛口
謪	言寸言人口
廅	广大二巛目
羛	米三乙巛川
粭	米梄人一口
熰	米人七口口
焍	米人米乙川
襒	之广目添竹
隺	之之川卜
緅	巛一三十又
螿	巛大儿寸口
牄	巛大人之口
緪	巛一米儿广
坥	二一目三
馵	三米十卜
搳	寸添之三口
蘴	十卜三口米
蔜	十卜三乙竹
芇	十卜目卜
萴	十卜目人曲
枺	梄一一添梄
杝	梄一乙卜
蛅	口巛卜寸口
蝝	口巛巛又大
暡	曲一人乙乙
狊	目一大言
罼	目曲曲十二
籗	竹言梄添川
饎	人又二米口
鈌	斤一又添大
臄	月一卜七大
謰	言寸之一梄
詙	言寸大言又
謱	言寸曲口巛
愅	米卜十十
怴	米卜七竹巛
渨	添添曲一儿
淭	添添之竹梄
顤	二一二一大
剺	二寸梄大乙
趬	二人二二一
豰	二二之大月
驔	三米梄曲十
騱	三米斤巛大
珕	三一乙乙乙
兝	十寸口人乙
鞈	十十人一口
飌	十卜口川月
蒭	十卜儿儿巛
豵	大月人人卜
蟦	口巛十十目
蚞	口巛梄一
蛦	口巛大寸乙
蜪	口巛儿十巛
蟉	口巛乙人斤
蹎	口卜十目人
噮	口一目口儿
嗺	口一目目川
曮	曲一口三竹
罭	目曲七口一
岏	目目一添一
崵	目目曲儿斤
睮	目一人月曲
籈	竹言梄二一
鄅	竹添口巛乙
笰	竹言乙巛川
籊	竹言乙乙川
佒	川添目寸大
貆	斤月二寸曲
媻	斤乙月又巛
鄐	言一巛曲乙
鶶	广大又口儿
廥	广大人目曲
糂	米梄十三巛
愃	米卜之二曲
慅	米卜又言口
澽	添添卜七大
淟	添添目十人
濵	添添之又目
鶣	之竹目十儿
禒	二曲巛又大
裶	之广曲三
袀	之广儿乙广
扻	寸添儿人
槥	梄一三三又
檥	梄一米竹七
蝍	口巛又人乙
哤	口一大儿斤
睊	目一口一月
矌	目一广曲人
筀	竹言二一二
鏙	斤一目目川
錎	斤一儿添川
腲	月一曲一儿
膲	月一川卜米
肒	月一月口
鄾	一添川儿乙
坱	二一目寸大
塯	二一儿竹曲
髶	三七斤三三
黈	十一曲言三
鞺	十十曲口二
蕇	十卜口曲一
菙	十卜竹十二
菕	十卜人目十
梂	梄一一曲言
梐	梄一儿儿二
雺	梄添又又川
蝿	口巛曲一曲
蚥	口巛人一人
昒	曲一儿乙斤
鄨	目卜添口乙
眃	目一二寸巛
幧	目卜口口梄
罻	目曲又二寸
鷽	川二人人儿
鄇	川添又竹乙
衠	人卜十目人
瓻	人言大目一
猳	月竹又又又
斒	言人之目十
麚	广又又又又
羬	米三七一口
燵	米人之二米
恌	米卜儿寸添
淊	添添儿添川
袉	之广之寸儿
褄	之广一又巛
隲	乙口曲竹三
睯	乙二七竹目
嫥	巛竹梄曲寸
妐	巛竹人一巛
撽	寸添川言竹
杶	梄一一添巛
椳	梄一曲一儿
樏	梄一曲卜巛
枆	梄一竹七
鷐	曲一大七儿
昈	曲一之竹
眓	目一七竹巛
罬	目曲又又又
胹	月一大目
鸃	儿巛米竹七
鱦	儿一之又
痑	广一儿言儿
鄳	之又乙口
塕	二一人乙乙
塉	二一添人月
嗀	二二之口月
憃	三人川二之
駴	三米七竹十
捵	寸添目十人
摿	寸添人言曲
蘁	十卜三口口
鞜	十十曲添曲
葧	十卜十乙乙
虌	十卜目竹之
藡	十卜之十口
鸏	十卜之大儿
輤	梄曲三卜月
軮	梄曲目寸大
楰	梄一川二人
鶆	梄一人人儿
奝	大寸月二口
鵊	大寸人人儿
礭	大一梄添川
蟨	大大米儿口
蟢	口巛二米口
蟃	口巛曲目又
齘	卜人人寸川
蝷	口巛广米巛
蠽	曲人川口口
幎	目卜之言人
峚	目目大寸二
峗	目目儿大乙
雟	巛曲川人口
箆	竹言目儿儿
筤	竹言言添又
簶	竹言二又曲
獂	月竹大川曲
糎	米梄大曲二
籾	米梄乙寸言
謍	米人米之言
寠	之寸曲口巛
穾	之人竹添大
祋	二曲月又
褼	之广梄大乙
裮	之广曲一曲
袡	之广目寸二
鄍	之之曲人乙
舝	又口巛巛十
勠	乙广乙斤乙
蛃	口巛一目人
踳	口卜三人
昤	曲一人寸之
麁	儿添广又
絭	米二巛一
懧	米卜之目一
邔	乙乙乙口
攕	寸添人曲一
拲	十一人一竹
蘦	十卜梄口口
蘻	十卜梄月巛
蘙	十卜七乙乙
蒏	十卜之之梄
酘	梄寸月又
罊	梄曲巛十巛
轐	梄曲曲米米
輆	梄曲言巛人
樴	梄一言曲七
霩	梄添言乙乙
厬	大大曲卜口
豜	大月一添十
跲	口卜人一口
踒	口卜竹梄巛
畖	曲卜斤言
冔	曲一口一寸
矂	目一口口梄
鴸	竹一梄一儿
穐	竹梄儿曲曲
籏	竹言言竹十
鶂	川二儿寸儿
甈	川目梄一一
觟	儿添月二二
凓	广寸梄口梄
湠	添添目大米
潝	添添人乙乙
韛	又口口竹月
鶸	乙巛广广儿
綧	巛一言口乙
圢	二一一卜
茙	十卜七竹大
碫	大一川三月
唒	口一梄寸
徲	人卜又曲竹
鑮	斤一十梄寸
釸	斤一儿言
獑	月竹梄曲斤
悐	月竹米人之
鄡	儿巛梄一乙
觬	儿添月川儿
怚	米卜目三
垒	巛言巛巛二
鳱	一十儿巛
趭	二人川卜米
擶	寸添竹月曲
韅	十十曲巛米
蔈	十卜梄口二
蕛	十卜竹乙川
毄	梄曲口一月
柹	梄一竹巛川
梌	梄一人寸竹
麬	梄一人人又
砿	大一广大巛
蠮	口巛七乙乙
剻	目目月月曲
骫	目之月口
睕	目一之儿乙
篕	竹言二巛目
鵹	竹梄儿竹儿
敿	竹添大口竹
毨	竹七竹二儿
簓	竹言月口斤
伻	川添一米十
儢	川添卜曲之
豻	斤月一十
褹	之广二二月
膉	月一米人目
詄	言寸竹二人
袲	言儿儿言儿
庪	广大寸十又
廏	广大川儿月
麆	广又目三
烰	米人斤添乙
懫	米卜斤斤目
懻	米卜广十人
瀫	添添二巛月
滱	添添之卜又
寙	之寸斤言斤
襩	之广二目目
皹	又卜之之梄
螱	又竹二寸口
鶋	又竹十口儿
隓	乙口大大二
頨	乙广乙广大
鶨	巛又大月儿
醙	梄寸川卜又
蠳	口巛目目巛
螰	口巛广又
眲	目一三十
簝	竹言一曲曲
餟	人又又又又
鯺	儿一二竹
湱	添添三卜大
赨	二一米人口
埓	二一斤添寸
壛	二一又儿川
郰	三十又言乙
刌	寸言曲寸
撜	寸添又口米
蓲	十卜七口口
醳	梄寸目二米
醷	梄寸言曲之
檡	梄一目二米
楺	梄一又川梄
碅	大一口寸竹
韰	卜寸儿曲一
蝺	口巛竹目巛
螑	口巛川目大
黤	目曲二大曲
峬	目目梄二
剬	目目大目曲
瞲	目一又人口
垼	人卜月又二
鋺	斤一之儿乙
峱	月竹又卜目
獽	月竹言口十
魧	儿一言一月
譠	言寸言曲一
韏	米二又口十
煃	米人大二二
煁	米人十三巛
濣	添添十广十
溰	添添目口米
宎	之寸竹添大
祑	二曲竹二人
裖	之广大七
襭	之广二口大
堲	又人乙目二
嬽	巛竹目巛大
琟	三一川卜
撊	寸添又寸月
硱	大一口寸梄
幩	目卜十十目
觕	竹二儿添月
鯦	儿一儿卜口
譀	言寸又三竹
恲	米卜米一十
阺	乙口儿七言
螜	二二之月口
墱	二一又口米
髬	三七斤大一
鬎	三七斤口曲
鬖	三七斤人斤
摦	寸添大一斤
蘵	十卜三曲七
樝	梄一卜七目
轙	梄曲米竹七
甝	卜七十二
蝚	口巛又川梄
嚾	口一十口川
躩	口卜目川又
躈	口卜川言竹
嚃	口一之目曲
哅	口一儿人巛
獘	目卜添竹大
瞚	目一之曲人
劗	竹二儿目曲
篧	竹言之之川
狜	月竹十寸口
顈	儿儿巛一大
蠯	广大川口口
熿	米人十曲人
忰	米卜月乙十
漊	添添曲口巛
汳	添添斤寸又
灛	添添又曲一
甂	之竹目十一
窢	之人七口一
飁	乙广乙川月
羾	乙广乙广二
鄛	巛寸曲梄乙
縪	巛一曲十二
纗	巛一目人口
妵	巛竹言添三
嬥	巛竹乙乙川
瓵	巛言口一一
硩	寸添斤寸大
硈	大一二二口
磼	大一川卜梄
咠	口一三十
噆	口一七儿曲
鳻	人一乙寸儿
臅	月一目儿口
鞷	一添口一十
赮	二一米又又
鬫	三三又三竹
鬕	三七斤曲大
攡	寸添言巛川
鷏	十寸目人儿
鞆	十十一目人
茣	十卜口一大
蘥	十卜人目十
蕧	十卜人曲儿
藭	十卜之川乙
櫡	梄一竹言二
棜	梄一言人广
檖	梄一之米大
蚹	口巛川添寸
趷	口卜竹一乙
甹	曲二一乙
鸓	曲卜曲曲儿
毟	曲人竹添竹
歂	目目大目儿
犈	竹二米二乙
傽	川添言曲十
徿	人卜言卜
鷭	斤梄曲卜儿
狋	月竹二曲
肐	月一竹一乙
鯏	儿一竹梄曲
鰝	儿一言目口
甋	言一米口一
庴	广大十一曲
麎	广又大七
憉	米卜二米斤
潀	添添目曲大
溌	添添又二儿
裋	之广一口米
隇	乙口七一巛
隑	乙口目口米
緆	巛一曲儿斤
嫷	巛竹乙二月
縃	巛一又卜月
玿	三一乙寸口
捼	寸添竹梄巛
挩	寸添人口儿
砎	大一人寸川
齫	卜人口寸梄
穧	竹梄言儿川
鸔	儿巛曲人曲
鮹	儿一曲人月
渹	添添儿乙言
鳺	二言儿巛
鼜	二二口言口
趜	二人儿乙米
駤	三米七二
駽	三米口一月
薽	十卜梄二一
荾	十卜巛人儿
榙	梄一十一口
軵	梄曲川添寸
椶	梄一人人儿
鶠	七添曲巛儿
黳	七添竹二米
蜌	口巛儿儿二
曋	曲一梄曲十
矐	目一梄添川
幝	目卜口曲一
帗	目卜大言又
嶀	目目梄一一
馧	竹梄曲曲目
齀	川目曲川一
鰴	人卜目儿竹
饡	人又竹儿目
艓	斤乙十巛梄
羭	米三人月曲
覮	米人米之目
澅	添添又曲一
窱	之人川儿梄
禭	二曲之米大
闑	又寸川目梄
褽	又竹二寸言
鵽	又言又又儿
鄪	乙巛川目乙
嬐	巛竹人人人
櫋	梄一川之言
蛌	口巛斤言
蟂	口巛儿巛梄
螏	口巛广一竹
徾	人卜目言竹
豍	一添口川十
鴶	二二口一儿
駓	三米大卜一
鞹	十十言乙乙
蒪	十卜梄二寸
薧	十卜言儿儿
蕄	十卜又寸之
枎	梄一二言
醼	梄寸十儿米
輚	梄曲七竹七
轑	梄曲一曲曲
霋	梄添一又巛
礣	大一十七言
豤	大月又人
嚔	口一十巛卜
跰	口卜米一十
啽	口一人口十
晪	曲一目十人
黖	目曲二七儿
篶	竹言一巛米
鄋	川二卜又乙
鸄	川曲言竹儿
鵆	人卜儿巛
艕	斤乙言之言
鱏	儿一梄曲十
庬	广大大儿斤
癪	广一竹三目
翷	米梄儿乙乙
煝	米人又竹目
澞	添添卜一大
襫	之广大一川
顐	之之梄曲大
敪	又言又又竹
翑	乙广乙儿口
緰	巛一人月曲
坁	二一儿七
嚍	口一又米目
杗	言七梄一
懭	米卜广曲人
鄑	二巛曲一乙
璬	三一川言竹
馲	三米竹添七
駖	三米人寸之
憼	十卜儿竹之
檪	梄一川添梄
椔	梄一巛寸曲
磃	大一斤寸卜
碯	大一巛川人
畭	曲卜人寸竹
譻	目人目人言
髐	目之二二一
髊	目之米三二
稘	竹梄十三
秎	竹梄人一乙
鷑	竹言言米儿
錣	斤一又又又
狑	月竹人寸之
甔	儿添大言一
斪	儿乙口一斤
諈	言寸竹十二
憛	米卜梄曲十
顲	米人米口大
憰	米卜又人口
滜	添添川大十
祳	二曲大七
襹	之广一言广
鸐	乙广乙川儿
軬	巛言大寸梄
蜤	梄一斤寸口
蝐	口巛曲一目
鴅	月添言一儿
鱐	儿一又川巛
翜	乙广乙人人
殟	一添儿曲目
鼘	二二口川巛
鼀	二一人一之
瞉	二二之目月
鬠	三七斤目曲
髼	三七斤儿三
蛪	三卜乙寸口
撠	寸添十十七
蓩	十卜又儿乙
葌	十卜巛巛巛
磩	大一七卜曲
鬵	七寸儿米一
隿	七言川卜
齞	卜人口一人
蠩	口巛言寸二
螛	口巛之三口
跙	口卜目三
嚵	口一儿儿言
晇	曲一大一一
睅	目一曲一一
奰	目曲目目大
穛	竹梄川卜米
稯	竹梄人人儿
餝	人又十卜言
鏏	斤一三三又
鵃	斤乙儿巛
劖	儿添口言曲
鸗	言卜儿巛
羠	米三大寸乙
糷	米梄十梄目
燖	米人又口寸
焆	米人口一月
烑	米人儿寸添
惼	米卜之目十
糪	又竹口言米
陭	乙口大一口
繉	巛一目儿添
媆	巛竹大目大
挏	寸添目一口
鵛	一添巛二儿
胉	月一川曲
鮅	儿一之巛竹
墆	二一十之目
趏	二人竹卜
鞻	十十曲口巛
荅	十卜人一口
橭	十卜十口言
桋	梄一大寸乙
軶	梄曲之竹乙
蜳	口巛言口乙
跮	口卜七二
遻	之一口米巛
畽	曲卜竹曲二
黕	目曲二之儿
峌	目目七二
崺	目目言乙乙
眝	目一之寸一
篏	竹言十二儿
秅	竹梄竹添七
簔	竹言言儿曲
篣	竹言言之言
鼮	川二巛竹二
皫	川曲广又米
鄎	川目之巛乙
餢	人又言米口
鎭	斤一儿巛人
鶢	斤添一又儿
艛	斤乙曲口巛
衁	言七竹添目
帣	米二目卜
羜	米三之寸一
瀴	添添目目巛
翐	乙广乙竹人
刜	乙巛川寸曲
圲	二一竹十
耴	三十巛添
揘	寸添川曲三
掽	寸添米一曲
磛	梄曲斤寸大
楎	梄一之之梄
蚼	口巛儿乙口
号	口一一乙
簂	竹言口口一
馣	竹梄曲大曲
仜	川添二卜
鮿	儿一三十巛
邟	言一月寸乙
矕	言寸巛巛目
颪	一添卜寸月
殦	一添儿言儿
鼛	二二口卜口
墋	二一巛人斤
蛬	十一人一口
酀	十一口米乙
蔧	十卜三三又
靪	十十一卜
莌	十卜米口儿
蒮	十卜之之川
榬	梄一二口儿
橲	梄一二米口
櫼	梄一人一七
栚	梄一米一大
蝡	口巛大目大
豦	卜七大月
齱	卜人三十又
螪	口巛言人口
欭	口寸大寸儿
躖	口卜巛巛卜
噞	口一人人人
毼	曲一儿巛竹
籉	竹言二之七
簼	竹言寸目二
鑓	斤一之一乙
豽	斤月目寸人
飉	月卜一曲曲
獀	月竹川卜又
觰	儿添月二二
觩	儿添月曲言
譑	言寸竹目口
艵	米一十儿乙
慔	米卜十曲大
熕	米人二卜目
熚	米人曲十二
鴬	添寸之之儿
寉	之寸川卜
裧	之广米人米
弣	乙巛川添寸
扑	寸添卜寸
霮	梄添添十巛
蚻	梄一巛添口
蛖	口巛大儿斤
蛢	口巛米一十
膹	月一十十目
鰿	儿一三卜目
魾	儿一大卜一
誫	言寸大七
聈	三十巛巛乙
鬊	三七斤三三
鬤	三七斤口十
抏	寸添一添一
攍	寸添言巛月
藀	十卜米之米
櫰	梄一言目曲
厒	大大竹十巛
蛚	口巛一儿曲
辴	口一口一大
稒	竹梄口十口
鼳	川二巛目大
齃	川目曲人巛
貛	斤月十口川
謥	言寸川儿之
痸	广一竹目曲
郱	米一十卜乙
羵	米三十十目
麊	米梄广又
窙	之人二竹乙
陎	乙口竹一梄
嬎	巛竹儿儿竹
摍	寸添之一川
鏬	斤一卜米寸
涾	添添曲添曲
騺	二一米月三
鼁	二一巛言之
鬌	三七斤二月
驖	三米十口三
捘	寸添巛人儿
荳	十卜一口米
兣	十寸口曲二
蘉	十卜目之又
藫	十卜添曲十
藬	十卜乙一目
梬	梄一曲二一
礥	大一七又目
螐	口巛儿川
蜧	口巛之竹大
踸	口卜十三巛
跜	口卜又竹儿
唈	口一口一乙
喢	口一竹十川
斀	目曲儿卜又
嶚	目目一曲曲
躽	川三七曲巛
軈	川三广川之
偋	川添又米十
舮	斤乙之竹
浲	添添儿卜三
竁	之人竹竹竹
氄	又言又口竹
彋	乙巛目口儿
媰	巛竹儿儿巛
纐	巛一言人大
葞	十卜乙巛三
鷒	梄曲寸言儿
朻	梄一巛卜
覝	一十米人目
坅	二一人言又
擉	寸添目儿口
郣	十寸之乙乙
蘣	十卜十言三
櫅	梄一言儿川
樔	梄一巛曲梄
蠝	口巛曲曲曲
蚢	口巛言一月
毾	曲一乙乙竹
崨	目目一又卜
舕	竹卜米人米
僓	川添口一目
譥	川曲言竹言
敆	人寸一卜又
銲	斤一曲一一
鋊	斤一人人口
臕	月一广又米
訰	言寸一添巛
怲	米卜一目人
烻	米人乙竹卜
袕	之广之人
蟴	十三斤寸口
篻	竹言梄口二
鮛	儿一卜一曲
觻	儿添月巛梄
濜	添添又米目
紖	巛一乙巛卜
麉	一十一十广
虣	一添七卜卜
鬁	三七斤竹曲
駾	三米米口儿
騢	三米又又又
蘜	十卜十儿米
蔖	十卜卜七目
藑	十卜儿目儿
蔒	十卜又口米
蒘	十卜巛口竹
磤	大一斤乙月
蛂	口巛大言又
螇	口巛斤巛大
嚊	口一川一川
巆	目目米口口
巀	目目曲川七
嵣	目目广又口
嶭	目目竹乙言
眣	目一竹二人
儥	川添二目目
狘	月竹七竹巛
獧	月竹目口儿
竘	言米儿乙口
黂	广大梄十目
羺	米三梄添大
烓	米人二一二
灟	添添又儿口
阠	乙口乙七十
虋	十卜川人乙
杢	梄一二卜
蚫	口巛儿乙乙
嵱	目目之人口
刱	二寸川乙人
槷	二一人月梄
搹	寸添一米一
攇	寸添之目之
麶	梄一人目巛
磪	大一目目川
蜠	口巛口寸竹
蜁	口巛竹又卜
馦	竹梄曲曲人
筡	竹言人寸竹
觡	儿添月儿口
駂	儿儿十寸三
濴	添添米之曲
鳵	乙七十寸儿
螴	乙口梄曲口
葋	三一十儿口
柖	梄一乙寸口
趹	口卜又添大
嶜	目目七儿曲
矏	目一川之言
顉	斤一大人
鮴	儿一川添梄
謯	言寸卜七目
熉	米人口一目
蟗	一添口巛口
趪	二人十曲人
髱	三七斤儿乙
揨	寸添言之一
鼖	十寸十十又
蕵	十卜儿言人
萒	十卜言巛儿
醗	梄寸又二儿
蜲	口巛竹梄巛
蟤	口巛乙十人
嘾	口一梄曲十
踃	口卜曲人月
稫	竹梄一口曲
觷	川二人儿月
鼥	川二巛大又
鼤	川二巛寸言
跾	川添卜竹口
鳹	人寸言又儿
瓫	人一乙寸一
逓	之一斤二目
胅	月一竹二人
庰	广大米一十
炌	米人人寸川
灗	添添口曲一
鶌	又竹巛巛儿
橉	梄一米儿十
飺	卜卜儿儿人
鱁	儿一之一大
鰫	儿一之人口
圫	二一竹添七
鵱	二一人二儿
鬗	三七斤人人
觢	三卜乙儿月
兞	十寸口儿竹
鞊	十十二二口
榰	梄一二儿曲
栜	梄一梄一目
螹	口巛梄曲斤
齥	卜人曲梄竹
囆	口一十巛口
躨	口卜米人儿
嗋	口一乙乙月
嶱	目目十人巛
睔	目一人目十
聟	竹大口一三
鷮	竹添大口儿
鼣	川二巛寸大
傮	川添一曲曲
皏	川曲米一十
鵗	人言大目儿
瞂	斤寸十大又
瓝	斤言儿乙言
猏	月竹之竹月
臇	月一川目巛
鷷	米寸梄寸儿
恞	米卜大寸乙
涆	添添曲一一
褅	之广言之目
顄	又添曲巛大
鳭	乙寸儿巛
翨	乙广乙一卜
跇	口卜十一巛
甖	目人目人一
嶬	目目米竹七
鼲	川二巛之梄
飶	人又之巛竹
鱞	儿一目口儿
痯	广一之寸乙
趓	二人月寸梄
驨	三米目人口
摏	寸添三人川
韇	十十二目目
茦	十卜梄一目
鷋	十卜人竹儿
萲	十卜斤大又
醥	梄寸梄口二
軯	梄曲一米十
輷	梄曲儿乙言
蜬	口巛又曲巛
踥	口卜言米巛
鄵	口一口梄乙
睼	目一曲一卜
嶟	目目米梄寸
眑	目一巛巛乙
揫	竹梄米人竹
筄	竹言儿寸添
僁	川添斤梄之
貜	斤月目川又
猣	月竹人人儿
鱢	儿一口口梄
頯	儿言十卜大
謞	言寸言目口
竏	言米竹十
麜	广又梄口梄
麔	广又儿卜口
顅	之竹月一大
裷	之广米二乙
鵋	乙乙之巛儿
婟	巛竹口十口
茥	十卜二一二
矹	大一一儿
汆	人寸曲添
膆	月一三卜巛
憴	米卜之又
欯	二二口一儿
塓	二一之言人
聇	三十一添卜
馽	三米口口
醹	梄寸梄添大
蚲	口巛一米十
蜐	口巛二巛乙
蟘	口巛川七目
蜦	口巛人目十
矔	目一十口川
幭	目卜十七言
嵷	目目人人卜
峉	目目儿卜口
嶡	目目大巛儿
毰	竹七言米口
傚	川添言人竹
屔	斤二又竹儿
朡	月一人人儿
鷛	广大又月儿
瀔	添添二竹月
渳	添添乙巛三
覕	之巛竹添目
嬓	巛竹川言竹
垘	二一川添大
蝁	二巛口巛
梇	梄一三一十
鄟	梄曲寸言乙
痝	广一大儿斤
殱	一添儿曲一
鶈	一添又巛儿
邞	二言乙口
趥	二人米寸梄
镺	三七竹添大
駍	三米一米十
驠	三米十儿米
搚	寸添乙乙月
歕	十寸十目儿
蒬	十卜之儿言
鷘	梄一口竹儿
楾	梄一川曲曲
槉	梄一广一竹
齴	卜人言竹斤
蝬	口巛人人儿
蝑	口巛又卜月
嘕	口一一巛米
謈	曲一十人言
鷜	曲口巛竹儿
嵑	目目曲人巛
岤	目目之人
峐	目目言巛人
鴔	竹添之一儿
鎒	斤一大七寸
觤	儿添月大乙
觙	儿添月乙人
誙	言寸一巛二
鶙	言一米目儿
塺	广大梄梄二
庱	广大二人儿
懤	米卜二口寸
糔	米梄又言口
煔	米人米卜口
瀖	添添梄添川
祒	二曲乙寸口
蠿	巛巛巛口口
隤	乙口口一目
糱	巛曲竹言米
玤	三一三卜
枦	梄一之竹
蜙	口巛梄人巛
釼	斤一乙寸言
颬	月卜七卜
戃	米卜曲二米
寋	之寸十人乙
轖	梄曲二口口
檹	梄一言一口
鴮	大寸一一儿
矺	大一竹添七
匷	七添目目川
刞	目三曲寸
眱	目一大寸乙
龤	人寸一儿川
艪	斤乙儿一曲
臐	月一竹二米
膱	月一言曲七
惾	米卜人人儿
灖	添添广梄曲
鼊	又竹口言之
弴	乙巛言口乙
彏	乙巛目川又
蜄	口巛大七
鴩	竹二人寸儿
蛗	竹添乙又口
兛	十寸口儿竹
韄	十十十川又
蒫	十卜米三二
轈	梄曲巛曲梄
裻	卜一曲又言
螔	口巛斤寸卜
噊	口一又人口
雂	人寸言又川
躗	人卜又十口
鐀	斤一口一目
鵌	儿巛人寸竹
殶	言添三一月
麡	广又言儿川
醟	米人米之梄
濭	添添十巛目
濦	添添斤又之
襷	之广川人竹
朾	梄一一卜
餪	人又大目大
怬	米卜目曲
蒆	十卜二月巛
鞃	十十乙巛巛
菣	十卜七一又
蔩	十卜之曲人
葈	十卜巛口梄
蛷	口巛一曲言
蚙	口巛人言又
嘝	口一儿广十
岯	目目大卜一
缿	竹一十一口
斔	言人口川人
剆	言添又人曲
旞	言乙竹米大
熐	米人之言人
郼	又口口十乙
憵	又竹口言之
顟	乙广乙斤大
縜	巛一口一目
鴢	巛巛乙竹儿
攗	寸添广又米
柫	梄一乙巛川
踕	口卜一又卜
嘳	口一口一目
趀	二人竹巛川
珱	三一添寸巛
藣	十卜目儿儿
欘	梄一又儿口
袃	七寸乙寸言
螶	七添又口口
顪	卜卜七曲大
齺	卜人儿儿巛
翢	月添二乙乙
峷	目目言十
岮	目目之寸儿
爂	川二目口米
豼	斤月儿儿儿
鰖	儿一大二月
毈	儿竹言三月
觓	儿添月二巛
鷾	言米曲之儿
罋	言一巛十巛
觠	米二儿添月
襳	之广人曲一
赶	二人一十
蜸	七一又言口
饙	人又十十目
鎎	斤一竹乙米
獛	月竹曲米米
謕	言寸斤寸卜
鞂	十十竹梄
藗	十卜之口儿
鷣	梄口曲十儿
鷢	大大米儿儿
蝛	口巛七一巛
蝹	口巛曲一目
鷤	口一口一儿
揱	曲人月曲竹
昲	曲一乙巛川
遾	之一竹人人
筺	竹言七三言
鼺	川二巛曲曲
斞	川二人广十
谾	人一人之二
膟	月一言添十
烶	米人乙竹二
韟	又口口大十
瞇	目一之一米
槃	斤乙月又梄
蓾	十卜卜口人
藃	十卜言口儿
鷅	梄口梄一儿
霵	梄添口三七
蟔	口巛目二米
蠷	口巛目目川
齻	卜人十目人
贆	目人大大大
髍	目之广梄梄
顝	目之大人
刉	竹一乙七曲
衈	竹添目梄三
譇	言寸大寸二
黀	广大梄三又
麠	广又三曲曲
瀢	添添之一目
漇	添添人卜卜
鶟	之人大言儿
屖	又竹言十
苬	十卜口寸人
駷	三米梄一口
裚	寸添斤寸言
轛	梄曲曲米寸
蠜	人言人大口
礝	大一梄添大
豟	大月之竹乙
砨	大一之竹乙
欳	卜寸目十儿
顋	曲卜之巛大
峅	目目巛言十
鼭	川二巛二寸
倇	川添之儿乙
鵵	儿添口言儿
螷	广大川十口
襓	之广二二一
幦	又竹口言目
鶅	巛寸曲卜儿
鴘	巛言十卜儿
蝫	口巛二竹
曭	曲一曲二米
簢	竹言又寸言
艀	斤乙斤添乙
瀩	添添竹月大
祐	二曲大寸口
馯	三米一十
騥	三米又川梄
揯	寸添米儿广
薂	十卜川言竹
遳	之一十人二
轚	梄曲巛月梄
欈	梄一目人口
橳	梄一月米乙
虪	卜七川二米
蝭	口巛曲一卜
蝖	口巛之二曲
躤	口卜十十曲
氁	竹七十曲大
貏	斤月川口十
魻	儿一曲乙
浶	添添之寸竹
祪	二曲儿大乙
鉹	斤一儿言儿
譋	言寸又寸月
雈	卜寸卜寸川
燅	二一人米米
騹	三米十口三
攌	寸添口口儿
菞	十卜竹儿竹
橨	梄一十十目
榽	梄一斤巛大
骿	目之米一十
齂	川目曲又添
鶞	斤寸十目儿
貗	斤月曲口巛
讄	言寸曲曲曲
旝	言乙竹目曲
瀱	添添目米曲
鄈	又米一大乙
蝞	口巛又竹目
饇	人又七口口
戄	米卜目川又
孷	二寸梄大乙
焣	三十又言米
驈	三米又人口
蘳	十卜十二二
蕱	十卜竹曲月
楈	梄一又卜月
跠	口卜大寸乙
暆	曲一言竹乙
黭	目曲二口十
螸	人一人儿口
貄	斤月又大二
貀	斤月巛曲巛
鱹	儿一十口川
觲	儿添月米竹
頝	言一人人大
廜	广大又竹二
窑	之人竹十巛
弤	乙巛儿七言
鉠	斤一目寸大
鮵	儿一米口儿
騴	三米曲之巛
擨	寸添斤卜儿
攐	寸添之人言
橶	梄一十十七
鵫	卜寸曲十儿
岟	目目目寸大
犣	竹二巛人巛
穙	竹梄曲米米
鵴	儿乙米梄儿
謒	言寸人之口
麙	广又七一口
毲	又言又又竹
蚸	口巛斤寸言
殥	一添儿曲人
皾	二二目目又
镽	三七一曲曲
驆	三米曲十二
萰	十卜梄一目
蓌	十卜人二儿
榹	梄一斤寸卜
蹥	口卜之一梄
簎	竹言寸十曲
謘	言寸又竹言
袬	言儿巛言口
糫	米梄目口儿
籸	米梄乙七十
韕	又口口口乙
縚	巛一斤添川
鳿	三一儿巛
歋	斤寸卜七儿
諚	言寸之一卜
紎	巛一大言
絼	巛一斤月
螼	口巛十口三
歶	卜卜儿目巛
蠌	口巛目二米
嚽	口一三竹目
踓	口卜川卜
簅	竹言言竹竹
鼨	川二巛儿广
衒	人卜言一巛
鱶	儿一米言又
譣	言寸人人人
韲	言一米曲一
鵧	米一十卜儿
甐	米梄儿十一
裍	之广口寸梄
緧	巛一米寸梄
蜵	口巛川又巛
鸍	一添人人儿
瓋	三一之十口
豱	大月曲一目
顊	竹添乙十大
鷎	川曲大十儿
鸙	人寸一十儿
餯	人又巛又大
鮬	儿一大一一
譨	言寸曲曲大
濻	添添乙一目
鴾	巛言竹二儿
听	口一斤寸
柠	梄一之寸一
賟	目人目十人
猬	月竹曲卜月
猎	月竹十一曲
疴	广一一卜口
凄	广寸一又巛
疱	广一儿乙乙
遡	之一米巛月
糇	米梄川又竹
攳	十寸又口寸
蘌	十卜人乙二
虃	十卜添曲一
椁	梄一言口乙
蟙	口巛言曲七
郹	目一大言乙
毤	人一巛儿竹
貁	斤月之人
猑	月竹曲儿儿
鶛	儿儿儿川儿
竀	之人一卜目
蛝	口巛又人
貕	斤月斤巛大
魱	儿一一添巛
鮤	一添儿曲儿
鬞	三七斤曲大
蕮	十卜川儿米
蹗	口卜广又
貾	目人儿七言
痚	广一二竹乙
溛	添添之人斤
疀	巛寸曲又卜
榩	梄一卜七言
笻	竹言二卜乙
靗	三卜月曲一
攓	寸添之人口
靲	十十人言又
麧	梄一人竹乙
瞝	目一言目巛
犥	竹二广又米
瓾	竹梄巛竹一
觾	儿添月儿米
羳	米三斤梄曲
韗	又口口之梄
鷵	又竹二竹儿
鞪	又言又竹十
桏	梄一二卜乙
胊	月一儿乙口
藆	十卜之人竹
豯	大月斤巛大
箈	竹言添巛口
郺	儿言儿口乙
涄	添添曲二一
鵳	之竹月一儿
鶔	又言又梄儿
蔰	十卜之口乙
迺	之一梄口
鶐	之一梄言儿
蝆	口巛卜卜二
蜭	口巛儿添川
賌	言一巛人目
瘱	广一大人之
蠤	米寸梄口口
軝	梄曲儿七
蹪	口卜口一目
郻	目一巛巛乙
欨	儿乙口一儿
覢	米人米人目
窲	之人米广十
翇	乙广乙大又
孈	巛竹目人口
鼰	川二巛寸目
蘮	十卜目米曲
毻	大寸二月竹
蝔	口巛儿儿川
蠗	口巛乙乙川
銔	斤一大卜十
旚	言乙竹梄二
虇	十卜乙口川
鶜	十卜又川儿
蟡	口巛斤米
襺	之广十卜口
鰬	儿一卜七言
蘛	十卜十巛月
桙	梄一巛言竹
雓	人寸竹梄川
讂	言寸儿目儿
轏	梄曲又乙乙
蛵	口巛一巛二
齤	米二卜人
酟	梄寸卜寸口
嶩	目目曲曲大
鱋	儿一卜七曲
痻	广一儿七曲
瓲	一巛一添巛
霤	梄添儿竹曲
祼	二曲曲卜梄
踍	口卜二竹乙
蹳	口卜又乙月
矎	目一儿人儿
餰	人又人卜添
痺	广一川口十
蛶	口巛斤添寸
踙	口卜三十又
羷	米三人人人
窏	之人添一寸
縯	巛一之曲人
証	言寸一添卜
晋	二巛曲一
騣	三米人人儿
惷	三人之巛
藱	十卜广一川
踂	口卜三十巛
酁	儿添口言乙
冮	广寸二卜
羦	米三之一一
壾	二二口七又
殔	一添儿又添
臙	月一十儿米
篲	竹言三三又
鴈	大大川添儿
藚	十卜二目目
鷻	儿巛言乙竹
眦	目一卜卜儿
亘	二寸曲一
甪	竹添月二
蔆	十卜添人儿
姪	巛竹七二
壼	二二之之二
踫	口卜米一曲
痴	广一竹大口
砲	大一儿乙乙
珮	三一月一目
駮	三米言人人
鄻	二言二梄乙
舗	人寸二口梄
﨑	目目言一口
叙	人寸竹梄又
离	言一人目巛
痲	广一十十儿
綉	巛一竹乙竹
虱	乙七竹添口
籥	竹言人目十
繙	巛一斤梄曲
揹	寸添广儿月
滚	添添言人巛
玅	言一巛曲竹
玆	言一巛言巛
攷	一乙竹人
査	梄一目三
昵	曲一又竹儿
屉	又竹十一巛
倣	川添言乙竹
觝	儿添月儿言
蜺	口巛川二儿
釬	斤一一十
嬭	巛竹一人人
无	一添大儿
与	一添巛添一
样	梄一米三
国	口寸三一言
吨	口一一添巛
户	之竹
巩	二卜月言
却	二一巛言乙
担	寸添曲一一
撑	寸添曲口竹
携	寸添川乙竹
抬	寸添巛言口
栀	寸添斤一乙
构	梄一儿乙巛
贋	大大川川目
医	七添竹大
蝎	口巛曲人巛
虮	口巛月寸
咏	口一言添曲
踪	口卜之寸二
叹	口一又言
网	目寸人言人
冈	目寸人言
岭	目目人寸之
复	竹一曲一儿
笋	竹言又大
偬	川添儿言之
众	人寸人寸人
脚	月一二巛乙
胆	月一曲一一
庄	广大二一
凉	广寸言口曲
决	广寸又添大
恒	米卜二寸曲
潜	添添二二曲
汹	添添人言巛
袜	之广一添梄
宫	之寸口一口
幂	之之曲大目
卺	又添曲一乙
异	乙二十卜
壜	二一曲二巛
韆	十十之大乙
苁	十卜人寸人
栅	梄一月月一
虬	口巛巛添
吕	口一口一
咤	口一之竹七
罎	竹一十二巛
秆	竹梄一十
鼹	川二巛之巛
隽	川卜乙添竹
腭	月一口一一
删	月添月一曲
胶	月一言人人
鰌	儿一米寸梄
籼	米梄目目
泞	添添之寸一
姗	巛竹月月一
耤	三卜梄十曲
耑	目目大目
苺	十卜巛乙
崳	目目人月曲
譆	言寸二米口
扰	寸添大儿
芜	十卜一添大
芦	十卜之竹
碱	大一七一口
奋	大寸曲卜
厩	大大又七儿
邮	曲二乙口
毁	川二二卜月
体	川添梄一一
优	川添大儿
犹	月竹大儿
肮	月一言一月
凑	广寸三一大
痒	广一米三
烛	米人口巛
怜	米卜人寸之
惊	米卜言口曲
羡	米三广寸儿
洁	添添二二口
垦	又人二一
竪	七一又言言
篱	竹言言目巛
胇	月一乙巛川
灯	米人一卜
粧	米梄广大二
鑵	斤一十口川
媮	巛竹人月曲
舋	川二目口目
橱	梄一大米寸
减	广寸七一口
耻	三十卜卜
忾	米卜竹乙
厨	大大一米寸
蹰	口卜大米寸
凛	广寸言口二
奬	巛大儿寸大
搥	寸添之竹乙
薴	十卜之目一
叡	卜寸之目又
耡	三卜梄目乙
饟	人又言口十
欸	巛言竹大儿
厦	大大一川儿
厮	大大十三斤
亲	言米梄一
届	又竹曲二
瑯	三一言又乙
鶏	斤添二言儿
瘉	广一人月曲
鱫	儿一斤之儿
袪	之广二一巛
餬	人又十口月
煖	米人斤大又
埼	二一大一口
楄	梄一之目十
殽	人言大月月
珐	三一二一巛
徬	人卜言之言
鉆	斤一卜寸口
琎	三一之二川
蹠	口卜广十米
腘	月一口三言
釆	斤梄
摀	寸添儿川
碶	大一三乙大
厢	大大梄一目
厠	大大目人曲
籴	人寸米梄
忧	米卜大儿
伕	川添二言
禀	言一口口二
幵	一十一十
眞	儿儿目巛人
繈	巛一乙巛口
埜	梄一梄一二
疍	又添卜曲一
説	言寸米口儿
詻	言寸儿卜口
鼇	三卜乙竹之
嵒	口一口口目
餽	人又川口
粏	米梄大寸言
叠	又言又之目
湣	添添乙七曲
俵	川添三卜儿
开	一添十卜
录	又二曲添
献	十寸目米大
园	口寸一添一
杀	人言梄一
卬	川添一添乙
寻	又二寸言
邓	又言乙口
茍	卜寸卜儿口
吓	口一一添卜
彔	巛又曲添
瓖	三一言口十
挶	寸添又乙口
菫	十卜一口三
偪	川添一口曲
僣	川添二二曲
沨	添添月卜
栒	梄一儿乙曲
鐎	斤一川卜米
萹	十卜之目十
嘡	口一曲口二
譔	言寸乙十人
殰	一添儿目目
撦	寸添大寸二
箄	竹言川口十
鎯	斤一言又乙
餈	广寸儿人人
溇	添添米梄巛
缐	巛一川曲曲
触	儿添月二口
梽	梄一二二之
媭	斤三大人巛
敩	添寸之乙竹
峃	添寸之之目
栐	梄一言添曲
訢	言寸斤寸
勣	三卜目人乙
拃	寸添竹一卜
櫂	梄一乙乙川
閲	又寸米口儿
偽	川添斤米
鎷	斤一三米
搾	寸添之竹卜
槜	梄一川乙竹
蹾	口卜言乙竹
鐏	斤一米梄寸
顔	言米竹斤大
权	梄一又言
杂	月乙梄一
丽	一添目目言
垯	二一之一大
币	竹添目卜
仅	川添又言
澛	添添儿一曲
沟	添添儿乙巛
灵	又二米人
叇	二寸巛又添
萚	十卜寸又二
翙	目目儿乙乙
箓	竹言又二曲
偺	川添儿卜曲
鏆	斤一巛乙目
浕	添添又言广
媿	巛竹川口
茧	十卜口巛
杧	梄一言七
鰙	儿一十大口
鯎	儿一七大乙
怀	米卜大卜
濬	添添卜人目
汈	添添乙添一
塆	二一言曲乙
摃	寸添二卜目
蒅	十卜添月梄
蟺	口巛言曲一
洟	添添大寸乙
睍	目一目儿
佪	川添口寸口
澂	添添目三竹
彊	乙巛三曲曲
﨟	十卜月人巛
蓢	十卜言又月
酛	梄寸一添一
䶮	言卜一添大
圙	口寸人口目
蹽	口卜一曲曲
峧	目目言人人
箠	竹言竹十二
儸	川添目巛川
剉	人寸人二曲
鳤	儿一竹之乙
魞	儿一人寸
褎	言儿斤添竹
濹	添添曲米二
婫	巛竹曲儿儿
絺	巛一人大目
袰	巛乙言儿
扺	寸添儿七
茓	十卜之人
㭎	梄一目寸人
柽	梄一又言二
硔	大一十一人
蹻	口卜竹目口
啗	口一儿添川
昙	曲一二寸巛
崠	目目梄一曲
积	竹梄口一人
敌	竹卜竹人
侚	川添儿乙曲
鈇	斤一二言
銶	斤一一曲言
魹	儿一竹七
浬	添添曲卜二
絶	巛一儿添乙
鬶	二言目米一
壈	二一言口竹
块	二一又添大
毮	寸添曲竹竹
挘	寸添曲竹乙
薳	十卜之口儿
薭	十卜竹川十
桛	梄一卜一卜
橦	梄一言曲二
鶍	曲一儿斤儿
峂	目目儿卜广
籡	竹言寸人人
䅟	竹梄巛大斤
劄	竹言人口曲
卽	川曲儿儿乙
㑇	川添儿添又
鱪	儿一曲一二
鱛	儿一米目曲
匋	儿乙竹十巛
鱜	儿一巛又乙
庼	广大儿儿大
滧	添添言人竹
襅	之广曲十二
屝	又竹曲三
嗧	乙竹口目十
紬	巛一曲二
嚮	巛人言川口
殻	二二之月月
搆	寸添十目二
搯	寸添斤添川
挌	寸添儿卜口
棊	十三梄一
棡	梄一目米目
噚	口一又口寸
瞜	目一曲口巛
筴	竹言大人人
餔	人又梄二
餗	人又梄一口
舘	人寸竹之乙
鑪	斤一卜曲目
备	儿卜曲卜
謡	言寸斤十巛
詶	言寸添寸川
訑	言寸乙卜
痳	广一梄一梄
关	米一大寸
忏	米卜竹十
汍	添添月口
溈	添添斤米
队	乙口人寸
緑	巛一又二曲
墫	二一米梄寸
鶄	三卜月一儿
騧	三米目口
駃	三米又添大
撢	寸添梄曲十
撝	寸添斤米
㧐	寸添又言又
鷰	十一口儿儿
懃	十一口乙之
䓬	十卜卜曲十
䓖	十卜之人乙
蘗	十卜又言梄
鶒	梄一口乙儿
軏	梄曲一儿
輗	梄曲川二儿
軨	梄曲人寸之
㰀	梄一竹人曲
楙	梄一又川梄
碕	大一大一口
囓	口一三卜卜
啣	口一竹卜乙
㘎	口一又三竹
僊	川添梄大乙
㿠	川曲曲人一
儁	川添川目巛
鎗	斤一人之口
貙	斤月七口口
貍	斤月曲卜二
録	斤一又二曲
鐍	斤一又人口
䏝	月一二巛言
鱰	儿一目曲二
鮸	儿一儿口儿
鮟	儿一之寸巛
譊	言寸二二一
諰	言寸曲卜之
譅	言寸乙卜卜
旛	言乙竹斤曲
凅	广寸口十口
㤘	米卜儿添又
鸂	添添斤大儿
宪	之寸竹二儿
㮣	又人七儿梄
勦	巛寸曲梄乙
纁	巛一竹二米
婬	巛竹斤竹二
毌	巛乙十寸
现	三一目儿
个	人寸卜添
说	言寸米口儿
为	斤米
没	添添月又
这	之一言人
对	又言寸言
发	巛添竹又言
两	一添目人人
项	二卜大人
专	二寸巛添言
来	二寸曲添
动	二寸巛言乙
长	三七
联	三十米一大
帮	三卜乙口目
热	寸添月口米
拨	寸添巛又言
带	十卜之之目
节	十卜乙目
标	梄一二曲
横	梄一十曲人
龙	言卜
页	大人
顾	大大乙目大
车	梄曲
区	七添人言
暂	梄曲斤寸曲
轨	梄曲月乙
软	梄曲儿人
点	卜寸口一米
旧	卜添曲一
齿	卜人
别	口一乙竹曲
员	口一目人
吗	口一三米
时	曲一寸言
业	曲米
当	曲人又二
电	曲梄
贱	目人七竹
败	目人竹人
内	目寸人寸
贩	目人斤寸又
见	目儿
赔	目人言米口
县	目三巛言
税	竹梄米口儿
气	竹乙
传	川添二巛言
顺	川寸大人
们	川添又寸
伪	川添斤米
会	人寸二寸巛
领	人寸之一大
从	人寸人寸
镇	斤一十目人
须	斤三大人
钱	斤一七竹
钻	斤一卜寸口
钢	斤一目寸人
铁	斤一竹二人
铬	斤一儿卜口
胀	月一三七
腻	月一七二目
独	月竹口巛
肿	月一口口
风	月卜
脱	月一米口儿
鱼	儿一
条	儿卜梄一
乐	儿七曲人
争	儿添又大
鸟	儿巛
讲	言寸二寸川
让	言寸卜一
调	言寸月二口
齐	言人川寸
诉	言寸斤寸言
设	言寸月又
该	言寸言巛人
变	言曲又言
装	广卜二二言
闻	又寸三十
闭	又寸寸言竹
问	又寸口一
间	又寸曲一
门	又寸
将	广卜儿言寸
应	广大添寸一
疗	广一又乙
废	广大巛又言
类	米梄大寸
炼	米人七乙人
总	米寸口一之
单	米寸曲乙一
粮	米梄言添又
数	米梄巛竹竹
洒	添添梄口
滤	添添卜七之
测	添添目人曲
学	添寸之之乙
汉	添添又言
泼	添添巛又言
宽	之寸十卜目
军	之之梄曲
补	之广卜寸
审	之寸曲梄
实	之寸广寸大
马	三米
层	又竹二寸巛
颇	又卜大人
观	又言目儿
难	又言川卜
验	三米人二添
买	又添广寸大
骗	三米之目十
张	乙巛三七
阳	乙口曲一
费	乙巛川寸目
办	乙竹人一
阴	乙口月一
习	乙广
弹	乙巛米曲一
随	乙口之大月
红	巛一二卜
续	巛一十广大
纯	巛一一添巛
细	巛一曲卜
组	巛一目三
统	巛一言巛儿
断	米梄巛添斤
编	巛一之目十
经	巛一又言二
顸	一十大人
蚕	一添大寸口
顶	一卜大人
鹉	一添七卜儿
垩	二巛二一
严	二巛竹添
亚	二巛
恶	二巛之巛
画	一添曲卜巛
残	一添儿言七
殒	一添儿口目
歼	一添儿言竹
殓	儿言人二添
殁	一添儿言月
殡	一添儿斤人
灭	一添米人
虿	一添乙竹口
迈	之一一添乙
坛	二一二寸巛
墙	二一十口口
盐	二一卜寸目
韦	二卜乙添
颉	二二口一大
埘	二一曲一寸
坝	二一目人
趱	二人竹儿目
进	之一二寸川
辇	二言二言梄
规	二言目儿
赵	二人人言
顽	一添一儿大
远	之一一添一
趋	二人儿添又
坟	二一言人
圹	二一广大
颊	二寸米人大
夹	二寸米人
郏	二寸米人乙
壶	二二之之曲
壳	二二之之月
声	二二又竹
韫	二卜乙曲目
场	二一乙添斤
韬	二卜乙斤川
运	之一二寸巛
玮	三一二卜乙
寿	三卜寸言
焘	三卜寸言米
耢	三卜梄之乙
环	三一大卜
珑	三一言卜
顼	三一大人
琏	三一之一梄
职	三十口一人
璎	三一目目巛
责	三卜目人
瑶	三一斤十巛
玑	三一月寸
靓	三卜月一目
静	三卜月儿又
麸	三卜儿言二
𬍛	三一儿七曲
艳	三卜儿添乙
聪	三十米口之
耧	三卜梄米巛
聍	三十之寸一
鬓	三七斤斤人
玛	三一三米
聂	三十又言又
抚	寸添一添大
挟	寸添二寸米
摄	寸添三又又
挝	寸添之一寸
捞	寸添十之乙
抴	寸添十一巛
拢	寸添言卜
挞	寸添之一大
拣	寸添七乙人
抠	寸添七添人
摅	寸添卜七之
损	寸添口一目
挡	寸添曲人又
摆	寸添目二巛
拥	寸添月二
攒	寸添竹儿目
捡	寸添人二添
抡	寸添人寸儿
抢	寸添人寸乙
摇	寸添斤十巛
垫	寸添月口二
蛰	寸添月口口
挚	寸添月口竹
执	寸添月口
抛	寸添月乙乙
絷	寸添月口巛
撸	寸添儿一曲
换	寸添儿目大
搀	寸添儿儿广
挣	寸添儿添又
挤	寸添言人川
过	之一寸言
扩	寸添广大
扪	寸添又寸
搁	寸添又儿口
掷	寸添米大乙
搂	寸添米梄巛
㧟	寸添添添七
搅	寸添添之目
拧	寸添之寸一
挥	寸添之之梄
撺	寸添之口口
护	寸添之竹
摈	寸添之斤人
扫	寸添又二
摊	寸添又言川
扬	寸添乙添斤
报	寸添乙目又
掺	寸添巛大斤
拟	寸添巛言人
荚	十卜二寸米
苇	十卜二卜乙
苌	十卜三七
协	十寸乙竹人
鞯	十十十卜乙
蔷	十卜十口口
茏	十卜言卜
荙	十卜之一大
载	十寸七竹梄
莲	十卜之一梄
莴	十卜目口
颧	十卜口川大
𦭜	十卜口一人
莳	十卜曲一寸
蓝	十卜曲竹目
黄	十一曲二人
蓦	十卜曲大三
蔂	十卜曲卜巛
苘	十卜目寸口
贳	十一巛添目
颠	十寸目人大
苋	十卜目儿
荞	十卜竹大川
蔹	十卜人添竹
获	十卜月竹大
茑	十卜儿巛
藷	十卜言寸二
蔼	十卜言人巛
𬜬	十卜又寸口
蔺	十卜又寸川
蒋	十卜广儿寸
丧	二一米寸儿
啬	十寸米口口
蕲	十卜米一斤
荡	十卜添乙斤
苎	十卜之寸一
茔	十卜之之二
莹	十卜之三言
荣	十卜之之梄
荤	十卜之之梄
萤	十卜之之口
营	十卜之口口
荥	十卜之之曲
蓥	十卜之之斤
荧	十卜之之米
劳	十卜之之乙
萦	十卜之之巛
茎	十卜又言二
萧	十卜又川人
卖	十寸又广大
艺	十卜乙七
荪	十卜乙一曲
苏	十卜乙竹人
荫	十卜乙口月
萨	十卜乙言竹
蕴	十卜巛曲目
药	十卜巛儿言
飘	梄口二曲月
杇	梄一一添一
枨	梄一三七
樯	梄一十口口
栉	梄一十卜乙
梦	梄一梄一儿
颥	梄添大目大
桮	梄一大卜口
栊	梄一言卜
雳	梄添大大乙
栋	梄一七寸曲
栈	梄一七竹
枢	梄一七添人
梿	梄一之一梄
梱	梄一口寸梄
档	梄一曲人又
贾	梄口目人
枧	梄一目儿
枣	梄一目寸广
桥	梄一竹大川
酰	梄寸竹二儿
霉	梄添竹一巛
检	梄一人二添
枪	梄一人寸乙
枫	梄一月卜
橹	梄一儿一曲
赖	梄一口儿目
榇	梄一言米梄
霁	梄添言人川
术	梄一言添
酿	梄寸言添又
桩	梄一广大二
榈	梄一又口口
楼	梄一米梄巛
槟	梄一之斤人
树	梄一又言寸
棂	梄一又二米
椭	梄一乙大月
杨	梄一乙添斤
厅	大大一卜
厉	大大一添乙
压	大大二一言
硖	大一二寸米
砖	大一二巛言
夺	大寸寸言
硕	大一大人
厌	大大大言
砗	大一梄曲
奁	大寸七添人
𬒔	大一卜卜月
还	之一大卜
碍	大一曲一寸
厕	大大目人曲
砚	大一目儿
垄	言卜二一
砻	言卜大一
詟	言卜言寸
赝	大大川川目
矶	大一月寸
砜	大一月卜
飙	大言大大月
袭	言卜言儿
态	大寸言添之
矿	大一广大
牵	大寸之之竹
码	大一三米
历	大大乙竹
础	大一巛曲巛
轩	梄曲一十
辆	梄曲一人人
辕	梄曲二口儿
贰	七言二寸目
转	梄曲二巛言
辄	梄曲三十巛
连	之一梄曲
轰	梄曲又言又
轧	梄曲巛添
辅	梄曲梄二
颐	七一大人
尧	七竹一儿
翘	七竹一乙乙
轾	梄曲七二
卧	七一卜寸
轳	梄曲卜寸又
辑	梄曲口一三
匮	七添口一目
轵	梄曲口一人
轴	梄曲曲二
东	七寸曲人
辊	梄曲曲儿儿
辋	梄曲目米言
盏	七竹目梄
轿	梄曲竹大川
轷	梄曲竹米寸
输	梄曲人月曲
辁	梄曲人寸三
殴	七添人言月
轮	梄曲人寸儿
堑	梄曲斤寸二
錾	梄曲斤寸斤
鸦	七卜儿巛
较	梄曲言人人
辙	梄曲言月竹
辘	梄曲广又
辚	梄曲米儿十
辖	梄曲之三口
轻	梄曲又言二
辗	梄曲又十儿
轺	梄曲乙寸口
轫	梄曲乙寸言
顿	一添巛曲大
辎	梄曲巛寸曲
蛱	口巛二寸米
龉	卜人二又口
螨	口巛十人人
螮	口巛十之目
蛲	口巛七竹一
龇	卜人卜卜儿
战	卜寸口一七
蝇	口巛口一曲
蜗	口巛目口
卤	卜寸口寸人
蛳	口巛曲一目
频	卜卜曲人大
虚	卜七曲米
蛊	口巛目梄
贞	卜寸目人
蚬	口巛目儿
龄	卜人人寸之
赀	卜卜儿儿目
蜕	口巛米口儿
蝉	口巛米曲一
虑	卜七之巛
蛏	口巛又言二
颅	卜寸又竹大
龌	卜人又竹七
卢	卜寸又竹
蚂	口巛三米
虏	卜七乙竹
吴	口一一添大
哑	口一二巛
贵	口口一添目
围	口寸二卜乙
踌	口卜三卜寸
啧	口一三卜目
唛	口一三卜儿
蹑	口卜三又又
𠳐	口一三卜乙
团	口寸寸言竹
蹒	口卜十人人
喷	口一十十目
躏	口卜十又川
呓	口一十卜乙
嗹	口一之一梄
咙	口一言卜
哒	口一之一大
𠮟	口一七寸
跷	口卜七竹一
践	口卜七竹
呕	口一七添人
嘘	口一卜七曲
啮	口一卜人
虽	口一口巛
颚	口一口一大
圆	口寸口一目
骂	口一口一三
黾	口一曲梄
呗	口一目人
啰	口一目曲儿
郧	口一目人乙
跃	口卜竹添大
躜	口卜竹儿目
响	口一川目口
哗	口一川儿十
囵	口寸人寸儿
呛	口一人寸乙
嗳	口一斤大又
叽	口一月寸
鹃	口一月一儿
噜	口一儿一曲
唤	口一儿目大
图	口寸儿卜广
鸣	口一儿巛
跻	口卜言人川
踯	口卜米大乙
喽	口一米梄巛
咛	口一之寸一
蹿	口卜之口口
吣	口一之巛
嘱	口一又目巛
啸	口一又川人
哟	口一巛儿言
题	曲一一卜大
师	曲寸一添目
韪	曲一一二乙
𬀩	曲一二卜乙
畴	曲卜三卜寸
颗	曲卜梄一大
晒	曲一梄口
昽	曲一言卜
辉	曲人一之梄
辈	曲三梄曲
晓	曲一七竹一
鸭	曲乙儿巛
显	曲一曲米
帅	曲寸目卜
𬀪	曲一目儿
临	曲寸竹言曲
监	曲寸竹言目
览	曲寸竹言目
鉴	曲寸竹言斤
晔	曲一川儿十
尘	曲人二一
暧	曲一斤大又
鶗	曲一一卜儿
旷	曲一广大
邺	曲米乙口
凿	曲米米二巛
尝	曲人之二巛
晕	曲一之之梄
赏	曲人之口目
归	曲寸又二
贤	曲寸又言目
肾	曲寸又言月
竖	曲寸又言言
紧	曲寸又言巛
畅	曲梄乙添斤
赋	目人一七卜
赇	目人一曲言
屿	目目一巛一
峡	目目二寸米
罢	目曲二一巛
帱	目卜三卜寸
帐	目卜三七
账	目人三七
帻	目卜三卜目
财	目人寸言竹
瞒	目一十人人
巅	目目十人大
嵘	目目十之梄
赎	目人十广大
赙	目人梄二寸
颛	目目大目大
眬	目一言卜
贿	目人大寸月
鸯	目寸大寸儿
贼	目人七竹大
岽	目目七寸曲
岖	目目七添人
崭	目目梄曲斤
贴	目人卜寸口
帧	目卜卜寸目
帜	目卜口一人
贶	目人口一儿
刚	目寸人言曲
赐	目人曲儿斤
幞	目卜曲米米
岿	目目曲寸又
𪾢	目一目儿
婴	目人目人巛
峤	目目竹大川
贝	目人
赌	目人二竹
则	目人曲寸
赂	目人儿卜口
岚	目目月卜
岁	目目儿言
睁	目一儿添又
购	目人儿乙巛
罚	目曲言寸曲
赃	目人广大二
赠	目人米目曲
赕	目人米人米
赚	目人米曲人
髅	目之米梄巛
贮	目人之寸一
髋	目之之十目
髌	目之之斤人
峄	目目又言二
瞩	目一又目巛
赆	目人又言广
剀	目目乙乙曲
觊	目目乙乙目
凯	目目乙乙月
岂	目目乙乙
悬	目三巛言之
丢	竹添二一巛
筹	竹言三卜寸
箨	竹言寸又二
穑	竹梄十口口
迁	之一竹十
犊	竹二十广大
笼	竹言言卜
乔	竹添大寸川
箧	竹言七二米
笺	竹言七竹
毡	竹七卜寸口
乱	竹卜巛添
鹄	竹二口一儿
篮	竹言曲竹目
笕	竹言目儿
笔	竹言竹七
签	竹言人二添
秃	竹梄月寸
頽	竹梄月寸大
颓	竹梄月寸大
称	竹梄儿添曲
赞	竹二儿儿目
选	之一竹二儿
稳	竹梄儿又之
鹅	竹寸七竹儿
辞	竹卜言十
简	竹言又寸曲
篓	竹言米梄巛
氢	竹乙又言二
箫	竹言又川人
笃	竹言三米
笾	竹言之一乙
俩	川添一人人
粤	川口米梄一
侠	川添二寸米
伟	川添二卜乙
伥	川添三七
债	川添三卜目
偾	川添十十目
牍	川又十广大
鸺	川添梄一儿
侥	川添七竹一
贷	川添七言目
舆	川二梄曲人
躯	川三七添人
侦	川添卜寸目
俣	川添口一大
侣	川添口一口
侧	川添目人曲
伣	川添目儿
皑	川曲目目乙
侨	川添竹大川
赁	川添竹二目
伤	川添竹一乙
俭	川添人二添
伦	川添人寸儿
华	川添儿儿十
倾	川添儿儿大
货	川添儿儿目
储	川添言寸二
侪	川添言人川
奥	川目米梄大
鹪	川卜米言儿
偻	川添米梄巛
伫	川添之寸一
傧	川添之斤人
侬	川添之之儿
傩	川添又言川
亿	川添乙七
龛	人寸一口言
剑	人寸二添曲
敛	人寸二添竹
刽	人寸二巛曲
饵	人又三十
仓	人寸乙目
馕	人又一十儿
馍	人又十曲大
馓	人又十月竹
饽	人又十之乙
弑	人言梄七二
刹	人言梄一曲
饶	人又七竹一
饯	人又七竹
彻	人卜七寸乙
饨	人又一添巛
衔	人卜斤一
馈	人又口一目
馄	人又曲儿儿
饪	人又竹添二
饫	人又竹添大
饿	人又竹寸七
饰	人又竹一目
饬	人又竹一乙
饷	人又川目口
馊	人又川卜又
丛	人寸人寸一
耸	人寸人寸三
怂	人寸人寸之
爷	人一人言乙
饭	人又斤寸又
馁	人又斤添巛
饥	人又月寸
馋	人又儿儿广
馅	人又儿添川
饮	人又儿人
仑	人寸儿儿
馏	人又儿竹曲
饱	人又儿乙乙
颔	人寸言口大
贪	人寸言又目
伞	人寸米寸十
饼	人又米一十
馐	人又米又卜
邻	人寸之一乙
馆	人又之寸乙
蚀	人又口巛
饲	人又乙一口
颁	人一乙寸大
戗	人寸乙目七
创	人寸乙目曲
贫	人一乙寸目
饧	人又乙添斤
颂	人一巛言大
饴	人又巛言口
钘	斤一一添十
钉	斤一一卜
铐	斤一二竹一
𫓯	斤一二一二
铼	斤一二寸曲
锗	斤一二竹
铑	斤一二竹儿
铗	斤一二寸米
钍	斤一二一
铸	斤一三卜寸
铒	斤一三十
𬬮	斤一三七
锖	斤一三卜月
钰	斤一三一言
镊	斤一三又又
钳	斤一十二
𫓹	斤一十三
针	斤一十寸
锘	斤一十大口
钴	斤一十寸口
错	斤一十一曲
质	斤寸十寸目
镬	斤一十川又
𫟹	斤一十一人
钵	斤一梄一一
铺	斤一梄二
𬭊	斤一梄一二
镭	斤一梄添曲
𬬸	斤一梄一言
锛	斤一大十十
钚	斤一大卜
铕	斤一大寸月
钛	斤一大寸言
镣	斤一一曲曲
𫟼	斤一之一大
钹	斤一大言又
铚	斤一七二
铙	斤一七竹一
钷	斤一七添口
𬬩	斤一七言
铖	斤一七大乙
铽	斤一七言之
链	斤一之一梄
钜	斤一七添又
铘	斤一七卜乙
钺	斤一七竹巛
钋	斤一卜寸
舻	斤乙卜寸又
锃	斤一口一三
铟	斤一口寸大
锢	斤一口十口
钟	斤一口口
铝	斤一口一口
锅	斤一目口
𫓶	斤一口一月
钽	斤一曲一一
锂	斤一曲卜二
钊	斤一曲寸
锞	斤一曲卜梄
钿	斤一曲卜
锁	斤一曲人目
钞	斤一曲人竹
销	斤一曲人月
锡	斤一曲儿斤
镤	斤一曲米米
镗	斤一曲口二
铛	斤一曲人又
铜	斤一目一口
盘	斤乙目梄
钠	斤一目寸人
钡	斤一目人
舰	斤乙目儿
钼	斤一目一
锄	斤一目三乙
钎	斤一竹十
锇	斤一竹寸七
锆	斤一竹二口
锺	斤一竹曲二
锸	斤一竹十川
铣	斤一竹二儿
锹	斤一竹梄米
锈	斤一竹乙竹
锻	斤一川三月
锽	斤一川曲三
钏	斤一川寸
镍	斤一川目梄
锥	斤一川卜
铂	斤一川曲
锦	斤一川曲目
镌	斤一川乙竹
铨	斤一人寸三
𬬱	斤一斤寸
铩	斤一人言梄
锉	斤一人人二
钤	斤一人言又
铃	斤一人寸之
舱	斤乙人寸乙
锾	斤一斤大又
钐	斤一斤三
锨	斤一斤寸儿
钣	斤一斤寸又
钒	斤一月言
铅	斤一月寸口
钥	斤一月一
锋	斤一儿卜三
铭	斤一儿言口
镥	斤一儿一曲
铆	斤一儿竹
钦	斤一儿人
钓	斤一儿乙言
钧	斤一儿乙广
铮	斤一儿添又
钩	斤一儿乙巛
锌	斤一言十
锫	斤一言米口
镜	斤一言曲儿
铈	斤一言一目
铲	斤一言米竹
铱	斤一言儿
镑	斤一言之言
锒	斤一言添又
钫	斤一言乙
锎	斤一又一十
钭	斤一广寸十
镀	斤一广十又
镧	斤一又梄目
锏	斤一又寸曲
钔	斤一又寸
锵	斤一广儿寸
镰	斤一广曲人
镁	斤一米三大
鋭	斤一米口儿
锐	斤一米口儿
镨	斤一米曲曲
钬	斤一米人
锬	斤一米人米
锑	斤一米乙川
镂	斤一米梄巛
铫	斤一儿寸添
铴	斤一添乙斤
锭	斤一之一卜
爱	斤添之大又
镩	斤一之口口
铋	斤一之巛竹
镔	斤一之斤人
释	斤梄又言二
锯	斤一又十口
铍	斤一又卜
镅	斤一又竹目
银	斤一又人
铌	斤一又竹儿
钗	斤一又言言
𬬿	斤一乙寸口
锰	斤一乙一目
镄	斤一乙川目
钌	斤一又乙
键	斤一乙又二
铷	斤一巛竹口
锱	斤一巛寸曲
钕	斤一巛竹
钆	斤一巛添
𬭁	斤一巛乙
橥	月竹二竹梄
䏡	月一二曲
肤	月一二言
狭	月竹二寸米
𦙶	月一十寸口
胧	月一言卜
胨	月一七寸曲
胪	月一卜寸又
脶	月一目口
腽	月一曲一目
狈	月竹目人
猡	月竹目曲儿
犸	月竹三米
脸	月一人二添
飓	月卜目三人
飕	月卜川卜又
飑	月卜儿乙乙
鹏	月一月一儿
狰	月竹儿添又
鸠	月乙儿巛
狱	月竹言寸大
脐	月一言人川
脑	月一言人巛
脏	月一广大二
犷	月竹广大
䲢	月一米二儿
鰧	月一米二儿
腾	月一米二三
狞	月竹之寸一
膑	月一之斤人
脓	月一之之儿
胫	月一又言二
胁	月一乙竹人
猕	月竹乙儿曲
鲠	儿一一曲人
鲡	儿一一目言
鲆	儿一一米十
鲑	儿一二一二
鲒	儿一二二口
鲮	儿一二人儿
鳍	儿一二儿曲
䲠	儿一三人
鰆	儿一三人
鲭	儿一三卜月
鲰	儿一三十又
鲯	儿一十三
鲼	儿一十十目
鲽	儿一十巛梄
鹱	儿巛十川又
鸨	儿儿十寸儿
鳓	儿一十十乙
鯆	儿一梄二
鳕	儿一梄添又
鲕	儿一大目
顷	儿儿大人
鲔	儿一大寸月
鱿	儿一大儿
鳜	儿一大巛儿
鲅	儿一大言又
鲢	儿一之一梄
处	儿卜卜寸
鯱	儿一卜七
鲇	儿一卜寸口
鲈	儿一卜寸又
鲴	儿一口十口
鲤	儿一曲卜二
鲱	儿一曲三
鳂	儿一曲一儿
鲳	儿一曲一曲
鳗	儿一曲目又
尔	儿添曲人
鲲	儿一曲儿儿
鲁	儿一曲一
迩	之一儿添曲
鳃	儿一曲卜之
鲣	儿一曲又二
鳎	儿一曲乙乙
龟	儿添曲梄
鲷	儿一月二口
鲖	儿一目一口
奂	儿添目寸大
鳏	儿一目曲曲
岛	儿巛目目
负	儿添目人
觯	儿添月曲一
稣	儿一竹梄
颖	儿儿竹梄大
鳅	儿一竹梄米
鲧	儿一竹添巛
鱮	儿一川卜人
鳇	儿一川曲三
鲋	儿一川添寸
鲌	儿一川曲
鲵	儿一川二儿
燄	儿添川米米
鷈	儿巛斤寸卜
鳐	儿一斤十巛
凫	儿巛月寸
毕	儿儿儿儿十
鲦	儿一儿卜梄
𬶋	儿一儿乙口
鲍	儿一儿乙乙
贸	儿竹目人
鲚	儿一言人川
鲂	儿一言乙
鲜	儿一米三
鳟	儿一米梄寸
鳞	儿一米儿十
鳝	儿一米米口
鲩	儿一之一一
鳊	儿一之目十
鸵	儿巛之寸儿
刍	儿添又二
鲟	儿一又二寸
鴃	儿巛又添大
鲏	儿一又卜
鲪	儿一又大口
雏	儿添又二川
皱	儿添又二又
邹	儿添又二乙
鲫	儿一又人乙
鱽	儿一乙寸
务	儿卜乙竹
鸳	儿言乙目儿
匀	儿乙广寸
鱾	儿一乙乙
乌	儿川
枭	儿巛梄一
鲐	儿一巛言口
𬣙	言寸一添寸
订	言寸一卜
诃	言寸一卜口
评	言寸一米十
诖	言寸二一二
诗	言寸二一寸
讧	言寸二卜
诘	言寸二二口
诸	言寸二竹
诬	言寸二人人
諸	言寸二竹言
语	言寸二又口
讳	言寸二卜乙
诔	言寸三卜梄
请	言寸三卜月
诹	言寸三十又
亵	言儿寸添月
讨	言寸寸言
计	言寸十寸
谋	言寸十二梄
谍	言寸十巛梄
诺	言寸十大口
诂	言寸十寸口
谳	言寸十米大
谎	言寸十言川
读	言寸十广大
谌	言寸十三巛
𬤇	言寸梄口二
谭	言寸梄曲十
谏	言寸梄一目
斋	言人大目
诼	言寸大月
诙	言寸大寸米
试	言寸七言二
诓	言寸七添三
诫	言寸七竹十
讶	言寸七卜
𬣡	言寸七竹
讴	言寸七添人
谮	言寸七儿曲
诚	言寸七大乙
讵	言寸七添又
讣	言寸卜寸
谑	言寸卜七一
謼	言寸卜米寸
误	言寸口一大
颤	言一口一大
识	言寸口一人
赢	言七口目月
诽	言寸曲三
刘	言人曲寸
栾	言曲梄一
课	言寸曲卜梄
亩	言一曲卜
蛮	言曲口巛
谩	言寸曲目又
谡	言寸曲人儿
銮	言曲斤一
诮	言寸曲人月
谓	言寸曲卜月
弯	言曲乙巛
诅	言寸目三
诇	言寸目寸口
𫍣	言寸目一口
讪	言寸目目
讷	言寸目寸人
挛	言曲竹寸
许	言寸竹一十
话	言寸竹卜
诰	言寸竹二口
诛	言寸竹一梄
颜	言米竹斤大
诱	言寸竹乙竹
诲	言寸竹一巛
训	言寸川寸
谁	言寸川卜
剂	言人川寸曲
谯	言寸川卜米
謏	言寸川卜又
谕	言寸人月曲
诠	言寸人寸三
认	言寸人寸
谶	言寸人曲一
诊	言寸人寸斤
论	言寸人寸儿
义	言添人言
诟	言寸斤一口
䜣	言寸斤寸
谣	言寸斤十巛
诳	言寸月竹三
讥	言寸月寸
颃	言一月寸大
讽	言寸月卜
诡	言寸儿大乙
谗	言寸儿儿广
询	言寸儿乙曲
诣	言寸儿儿曲
谄	言寸儿添川
谐	言寸儿儿川
诋	言寸儿七言
诌	言寸儿添又
鴗	言米儿巛
鸾	言曲儿巛
谅	言寸言口曲
谙	言寸言米曲
谚	言寸言竹斤
议	言寸言添人
辩	言十言寸言
谛	言寸言之目
谤	言寸言之言
访	言寸言乙
斓	言人又梄目
详	言寸米三
产	言米竹添
谥	言寸米人目
谫	言寸米曲乙
谈	言寸米人米
谜	言寸之一米
谦	言寸米曲人
𬣞	言寸之寸一
諠	言寸之二曲
诨	言寸之之梄
谴	言寸之一乙
谊	言寸之寸目
诧	言寸之竹七
译	言寸又言二
诀	言寸又添大
诐	言寸又卜
诵	言寸又言月
𬣳	言寸又人
词	言寸乙一口
讯	言寸乙七十
诏	言寸乙寸口
诞	言寸乙竹卜
讱	言寸乙寸言
记	言寸乙乙
诒	言寸巛言口
娈	言曲巛竹
颏	言一巛人大
辫	言十巛一言
庑	广大一添大
疠	广一一添乙
闺	又寸二一二
瘗	广一二米二
闫	又寸三寸
冯	广寸三米
痨	广一十之乙
癞	广一梄儿目
阑	又寸梄一目
鹇	又寸梄一儿
头	广寸大寸
庆	广大大寸
库	广大梄曲
阉	又寸大寸曲
庞	广大言卜
状	广卜大言
邝	广大乙口
阈	又寸七口一
冻	广寸七寸曲
壮	广卜二二
阃	又寸口寸梄
闸	又寸曲乙
阊	又寸曲一曲
闩	又寸一添
闰	又寸三一
痈	广一月二
闲	又寸梄一
闽	又寸口巛
訚	又寸言寸
闯	又寸三米
阀	又寸川添七
鹰	广一川川儿
瘪	广一川人儿
阋	又寸川二儿
闪	又寸人寸
疮	广一人寸乙
阌	又寸斤之又
疯	广一月卜
桨	广卜儿言梄
奖	广卜儿言大
浆	广卜儿言曲
资	广寸儿人目
阎	又寸儿添川
癣	广一儿一米
净	广寸儿添又
闹	又寸言一目
闶	又寸言一月
阂	又寸言巛人
痫	广一又寸梄
阅	又寸米口儿
阐	又寸米曲一
瘘	广一米梄巛
阔	又寸添添竹
闼	又寸之一大
庐	广大之竹
闷	又寸之巛
阕	又寸又一大
阚	又寸又三竹
瘫	广一又言川
疡	广一乙添斤
瘾	广一乙又之
疖	广一乙目
妆	广卜巛竹
兰	米一二寸
鲞	米二儿一
誊	米二言寸
怅	米卜三七
鲝	米三儿一
慑	米卜三又又
愤	米卜十十目
懒	米卜梄儿目
娄	米梄巛竹
恹	米卜大大大
烦	米人大人
郑	米一大寸乙
烧	米人七竹一
怄	米卜七添人
惭	米卜梄曲斤
兑	米寸口一儿
兽	米寸曲一口
悭	米卜曲又二
灿	米人目目
惧	米卜目三人
恺	米卜目目乙
养	米三川寸
烨	米人川儿十
烃	米人又言二
烁	米人儿七曲
焕	米人儿目大
恼	米卜言人巛
悯	米卜又寸言
焖	米人又寸之
悦	米卜米口儿
惮	米卜米曲一
恽	米卜之之梄
烬	米人又言广
忆	米卜乙七
炀	米人乙添斤
鹈	米寸乙川儿
递	之一米乙川
惨	米卜巛大斤
惯	米卜巛乙目
兹	米一巛巛巛
举	添寸一人二
兴	添寸一添人
誉	添寸一人言
𬇕	添添一添乙
洼	添添二一二
鸿	添添二卜儿
浃	添添二寸米
𣲗	添添二卜乙
涛	添添三卜寸
沣	添添三卜
渍	添添三卜目
滟	添添三儿乙
滠	添添三又又
满	添添十人人
滞	添添十之目
潇	添添十川人
泷	添添言卜
沥	添添大大乙
浇	添添七竹一
浅	添添七竹
沤	添添七添人
渐	添添梄曲斤
㳚	添添七大言
汇	添添七添
涟	添添之一梄
浈	添添卜寸目
浊	添添口巛
泸	添添卜寸又
涠	添添口二乙
渑	添添口一曲
涡	添添目口
湿	添添曲一曲
温	添添曲一目
溅	添添目人七
𬇙	添添目人
滗	添添竹言竹
渊	添添川寸米
潋	添添人添竹
沦	添添人寸儿
潴	添添月竹二
鼗	儿寸添十又
涤	添添儿卜梄
涣	添添儿目大
渔	添添儿一
滦	添添言曲梄
浐	添添言米竹
润	添添又寸三
澜	添添又梄目
瀇	添添广曲人
涧	添添又寸曲
沩	添添斤米
黉	添寸之曲人
浑	添添之之梄
觉	添寸之之目
沪	添添之竹
滨	添添之斤人
浓	添添之之儿
泽	添添又言二
浔	添添又二寸
滩	添添又言川
涨	添添乙巛三
汤	添添乙添斤
涩	添添乙言卜
烫	添添乙斤米
渗	添添巛大斤
潍	添添巛一川
逦	之一一目言
写	之之一巛一
窍	之人二卜一
窥	之人二言目
违	之一二卜乙
祷	二曲三卜寸
宝	之寸三一言
赛	之寸十人目
骞	之寸十人三
宠	之寸言卜
窃	之人七寸乙
祯	二曲卜寸目
遗	之一口一目
祸	二曲目口
褴	之广曲竹目
裆	之广曲人又
视	二曲目儿
袄	之广竹添大
鹤	之之川卜儿
裣	之广人二添
穷	之人乙竹
遥	之一斤十巛
宾	之寸斤二人
额	之寸儿口大
农	之之儿之
祃	二曲三米
礼	二曲巛添
裤	之广广大梄
禅	二曲米曲一
迳	之一又言二
迟	之一又竹言
逊	之一乙一曲
边	之一乙竹
辽	之一又乙
骊	三米一目言
颈	又添言二大
巯	又添言巛川
劲	又添言二乙
𬴃	三米三卜大
骤	三米三又大
怼	又言寸言之
骐	三米十三
剧	又竹十口曲
骑	三米大一口
驮	三米大寸
戏	又言七竹
驱	三米七添人
骃	三米口寸大
驶	三米口一人
𬴂	三米曲三
骒	三米曲卜梄
剥	又二曲添曲
骡	三米曲卜巛
驵	三米目三
𬳶	三米目寸口
驷	三米目曲
骄	三米竹大川
属	又竹竹目巛
驯	三米川寸
骓	三米川卜
肃	又大川寸人
骅	三米川儿十
骢	三米川儿之
驳	三米人言人
屦	又竹人米巛
驹	三米儿乙口
骆	三米儿卜口
欢	又言儿人
骝	三米儿竹曲
鸡	又言儿巛
驻	三米言添三
骍	三米言十
骧	三米言口十
昼	又竹言曲一
𫘜	三米言人
尽	又竹言添广
骇	三米言巛人
骥	三米广十人
骈	三米米一十
屡	又竹米梄巛
驴	三米之竹
驼	三米之寸儿
骟	三米之乙乙
恳	又人之巛
驿	三米又言二
预	又言又卜大
艰	又言又人
驭	三米又言
骉	三米三米三
骣	三米又乙乙
驰	三米乙卜
劝	又言乙竹
骖	三米巛大斤
骀	三米巛言口
骏	三米巛人儿
卫	乙目一添
际	乙口二曲
陕	乙口二寸米
陆	乙口二寸目
陇	乙口言卜
陏	乙口大寸月
阵	乙口梄曲
陈	乙口七寸曲
贺	乙竹口一目
驾	乙竹口一三
陧	乙口曲一二
孙	乙一曲人
隄	乙口曲一卜
坠	乙口人寸二
阶	乙口人寸川
弥	乙巛儿添曲
隐	乙口儿又之
飞	乙七广寸
导	乙二寸言
𠙶	又乙巛卜
纡	巛一一添寸
妩	巛竹一添大
娅	巛竹二巛
结	巛一二二口
绪	巛一二竹
绫	巛一二人儿
纬	巛一二卜乙
纭	巛一二寸巛
绩	巛一三卜目
𬘬	巛一三卜月
绑	巛一三卜乙
纣	巛一寸言
绀	巛一十二
缂	巛一十十
绁	巛一十一巛
缚	巛一梄二寸
𬘭	巛一梄一梄
缃	巛一梄一目
绔	巛一大一一
叁	巛言大寸三
缛	巛一大七寸
缅	巛一又口目
参	巛言大寸斤
缄	巛一七一口
绖	巛一七二
绕	巛一七竹一
线	巛一七竹
妪	巛竹七添人
练	巛一七乙人
绰	巛一卜曲十
娱	巛竹口一大
缉	巛一口一三
𬘡	巛一口寸大
绳	巛一口一曲
娲	巛竹目口
织	巛一口一人
绢	巛一口一月
绯	巛一曲三
缦	巛一曲目又
纱	巛一曲人竹
绡	巛一曲人月
缇	巛一曲一卜
缧	巛一曲卜巛
绸	巛一月二口
䌹	巛一目寸口
絅	巛一目寸口
纲	巛一目寸人
缨	巛一目目巛
纳	巛一目寸人
纴	巛一竹添二
纤	巛一竹十
缵	巛一竹儿目
妫	巛竹斤米
妈	巛竹三米
绣	巛一竹乙竹
缎	巛一川三月
𬘓	巛一川寸
维	巛一川卜
绵	巛一川曲目
缴	巛一川言竹
给	巛一人一口
绘	巛一人二巛
绗	巛一人卜
纵	巛一人寸人
纶	巛一人寸儿
纷	巛一人一乙
缓	巛一斤大又
绥	巛一斤添巛
绷	巛一月一月
纨	巛一月口
绦	巛一儿卜梄
纸	巛一儿七
绺	巛一儿卜口
络	巛一儿卜口
绚	巛一儿乙曲
约	巛一儿乙言
终	巛一儿卜广
绉	巛一儿添又
绝	巛一儿添乙
纹	巛一言人
纺	巛一言乙
娴	巛竹又寸梄
纩	巛一广大
缠	巛一广曲二
绊	巛一米二
婵	巛竹米曲一
缯	巛一米目曲
缮	巛一米米口
继	巛一米梄巛
纻	巛一之寸一
综	巛一之寸二
绽	巛一之一卜
婶	巛竹之寸曲
缩	巛一之一川
缝	巛一之儿三
绾	巛一之寸乙
妇	巛竹又二
纽	巛一又二卜
绿	巛一又二曲
纾	巛一又又卜
纼	巛一乙巛卜
绍	巛一乙寸口
贯	巛乙目人
级	巛一乙添人
绋	巛一乙巛川
纫	巛一乙寸言
纪	巛一乙乙
丝	巛一巛一
缘	巛一巛又大
纠	巛一巛卜
绐	巛一巛言口
缫	巛一巛曲梄
乡	巛人
飨	巛人人又
芈	卜寸卜寸二
鹝	一添口一儿
戬	二巛曲一七
鹂	一添目言儿
郦	一添目言乙
䴓	一添目卜儿
殚	一添儿曲一
䴕	一添儿曲儿
鴷	一添儿曲儿
殀	一添儿竹大
殇	一添儿乙斤
趸	一添乙竹口
劢	一添乙竹乙
欤	一添巛一儿
𤭯	一巛川曲曲
垭	二一二巛
叆	二寸巛大又
福	二曲一口曲
神	二曲曲梄
赉	二寸曲添目
鼋	一添一口曲
祥	二曲米三
𫭼	二一十之乙
㙘	二一梄口巛
埯	二一大寸曲
坜	二一大大乙
𫭟	二一七添人
贡	二卜目人
觋	二卜人人目
鹀	二卜人人儿
垆	二一卜寸又
韨	二卜乙大又
韧	二卜乙乙言
击	二寸目目
埙	二一口一目
埚	二一目口
鼕	二二口儿广
垱	二一曲人又
垲	二一目目乙
都	二竹言添乙
赪	二一米卜目
𫭢	二一人寸儿
坵	二一斤二
坞	二一儿川
垴	二一言人巛
𡐓	二一广又添
𫮃	二一米曲一
𪣻	二一米梄巛
壸	二二之之二
毂	二二之梄月
𡎚	二一之目十
悫	二二之月之
㙍	二一又又又
𪤗	二一乙人斤
玙	三一一巛一
玨	三一三一
聩	三十口一目
𤩽	三一十米大
𫞩	三一十人人
颞	三十又又大
㻬	三一梄一一
麺	三卜儿口目
𪟝	三卜目人乙
赘	三卜乙竹目
鳌	三卜乙竹儿
骜	三卜乙竹三
䴖	三卜月一儿
麦	三卜儿卜
麹	三卜儿儿米
䂮	三卜乙寸大
㛃	三卜乙寸巛
琐	三一曲人目
珰	三一曲人又
瓒	三一竹儿目
瑽	三一人人卜
玱	三一人寸乙
瑷	三一斤大又
琼	三一言口曲
𤧛	三一言之目
駻	三米曲一一
騠	三米曲一卜
騝	三米乙又二
駎	三米曲二
騪	三米川卜又
駩	三米人寸三
騚	三米米月曲
𤫉	三一言米又
駶	三米又乙口
騃	三米巛言竹
珲	三一之之梄
𬍤	三一又二寸
玚	三一乙添斤
擣	寸添二口寸
撷	寸添二口大
撵	寸添二二梄
抟	寸添二巛言
搟	寸添梄曲一
挠	寸添七竹一
掳	寸添卜七乙
掴	寸添口三言
揽	寸添曲竹目
撄	寸添目目巛
揿	寸添斤一儿
贽	寸添月口目
鸷	寸添月口儿
势	寸添月口乙
捣	寸添儿巛目
拦	寸添米一二
掸	寸添米曲一
㧑	寸添斤米
擞	寸添米巛竹
择	寸添又言二
挦	寸添又二寸
掼	寸添巛乙目
觐	十一口三目
荆	十卜一十曲
鹊	十一曲一儿
𬟁	十卜一一儿
勚	十一巛目乙
颟	十卜一人大
𬜯	十卜一人人
䢼	十一人一乙
觏	十二目二目
莱	十卜二寸曲
韩	十寸曲二乙
贲	十寸十卜目
觌	十寸又大目
鸪	十寸口一儿
鹕	十寸口月儿
赍	十寸人之目
𫠆	十寸又言大
鳷	十寸又言儿
𨙸	十寸又言乙
鹁	十寸之乙儿
鞒	十十竹大川
鞑	十十之一大
鞲	十十十目二
䓫	十卜大一口
苈	十卜大大乙
荛	十卜七竹一
蒇	十卜七大目
𬞟	十卜卜曲大
蒉	十卜口一目
鹳	十卜口川儿
鹋	十卜曲卜儿
萝	十卜目曲儿
蘖	十卜竹言梄
莶	十卜人二添
荟	十卜人二巛
苍	十卜人寸乙
莸	十卜月竹大
蓟	十卜儿一曲
荜	十卜儿儿十
藓	十卜儿一米
蓠	十卜言目巛
荠	十卜言人川
𫇭	十卜斤米
蒌	十卜米梄巛
薮	十卜米巛竹
蕰	十卜添曲目
䓨	十卜之十巛
鹲	十卜之大儿
荦	十卜之之竹
莺	十卜之之儿
茕	十卜之乙十
荨	十卜又二寸
蓣	十卜又卜大
荩	十卜又言广
荬	十卜又广大
䓛	十卜又巛巛
𦰡	十卜乙二乙
荭	十卜巛一二
荮	十卜巛一寸
莼	十卜巛一巛
芗	十卜巛人
桠	梄一二巛
梾	梄一二寸曲
𬷕	梄二儿巛
𬂩	梄一二寸米
㭕	梄一二一巛
梼	梄一三卜寸
酝	梄寸二寸巛
醆	梄寸七竹七
酽	梄寸二巛竹
酾	梄寸一目言
𬪩	梄寸之之儿
酦	梄寸巛又言
椟	梄一十广大
槚	梄一梄口目
枥	梄一大大乙
桡	梄一七竹一
桢	梄一卜寸目
栌	梄一卜寸又
𣗋	梄一曲口儿
榅	梄一曲一目
輮	梄曲又川梄
榄	梄一曲竹目
槛	梄一曲竹目
軿	梄曲米一十
樱	梄一目目巛
椤	梄一目曲儿
桤	梄一目目乙
欅	梄一川人竹
桦	梄一川儿十
桧	梄一人二巛
麨	梄一人曲竹
枞	梄一人寸人
𬃊	梄一斤十目
栎	梄一儿七曲
槠	梄一言寸二
檩	梄一言口二
栏	梄一米一二
棁	梄一米口儿
霭	梄添言人巛
鹴	梄添梄目儿
榉	梄一添人二
雾	梄添儿卜乙
杩	梄一三米
橼	梄一巛巛大
碛	大一三卜目
鹩	一添米曲儿
鹌	大寸曲梄儿
𥕢	大一一曲曲
砺	大一大一乙
黡	大大大二米
厍	大大梄曲
靥	大大大口目
䃎	大一大儿儿
厣	大大大言曲
魇	大大大言川
餍	大大大言人
励	大大一乙乙
硗	大一七竹一
𥔲	大一口一一
𥖨	大一口口梄
𬒗	大一曲竹目
鸸	大目儿巛
硙	大一目目乙
聋	言卜三十
龚	言卜十一人
硚	大一竹大川
矾	大一月言
豮	大月十十目
砾	大一儿七曲
尴	大儿曲竹目
䃅	大一米曲一
硁	大一又言二
砀	大一乙添斤
碜	大一巛大斤
赜	七一三卜目
鸫	七寸曲人儿
辏	梄曲三一大
轲	梄曲一卜口
轱	梄曲十寸口
轪	梄曲大寸
𫐄	梄曲一儿
𫟦	梄曲之米大
轭	梄曲大大乙
轼	梄曲七竹二
辌	梄曲言口曲
辐	梄曲一口曲
𨐈	梄曲曲人一
辒	梄曲曲一目
𫐓	梄曲又川梄
轶	梄曲竹二人
𫐐	梄曲川二儿
轸	梄曲人寸斤
斩	梄曲斤寸
椠	梄曲斤寸梄
辀	梄曲斤乙
𬨂	梄曲儿七
辂	梄曲儿卜口
轹	梄曲儿七曲
𬨎	梄曲米寸梄
辍	梄曲又又又
匦	七添梄曲月
𬌗	七卜人一口
𬸘	七添曲巛儿
戋	七竹
刬	七竹曲寸
欧	七添人言儿
鸥	七添人言儿
瓯	七添人言一
鸢	七言儿巛
虾	口巛一添卜
觇	卜寸口一目
鹾	卜寸口米二
鸬	卜寸又竹儿
蟏	口巛十川人
蝾	口巛十之梄
䗖	口巛十之目
蛎	口巛大一乙
戯	卜七曲米七
觑	卜七曲米目
𬟽	口巛七寸曲
颦	卜卜曲川十
𫚖	卜卜儿儿儿
蝈	口巛口三言
䗴	口巛竹竹二
䗛	口巛川儿月
𬺈	卜人大一口
龋	卜人竹目巛
龊	卜人口卜
龃	卜人目三
龁	卜人竹一乙
𫠜	卜人川二儿
𬹼	卜人人寸川
龂	卜人斤寸
龀	卜人儿儿
龅	卜人儿乙乙
𬺓	卜人梄又卜
龈	卜人又人
龆	卜人乙寸口
蛴	口巛言人川
蚁	口巛言添人
蝼	口巛米梄巛
呒	口一一添大
𫫇	口一二巛之
鸮	口一一乙儿
唝	口一二卜目
嗫	口一三又又
圞	口寸言巛梄
囌	口一十儿竹
唠	口一十之乙
呖	口一大大乙
哓	口一七竹一
啭	口一梄巛言
踬	口卜斤十目
跶	口卜之一大
鹭	口卜儿口儿
蹧	口卜一曲曲
跹	口卜之一竹
跄	口卜人寸乙
跸	口卜儿儿十
跞	口卜儿七曲
𧿹	口卜巛乙
嚣	口一口大口
鼍	口一口口曲
鹗	口一口一儿
唢	口一曲人目
𫑡	口一曲梄乙
嘤	口一目目巛
呐	口一目寸人
呙	目口
剐	目口曲寸
哕	口一目目儿
勋	口一目人乙
哙	口一人二巛
㕮	口一人一人
哔	口一儿儿十
呜	口一儿川
啴	口一米曲一
咷	口一儿寸添
哝	口一之之儿
咝	口一巛一
坚	曲寸又言二
𬱖	曲二大人
櫐	曲卜曲曲梄
颙	曲一目巛大
䣘	曲人之二乙
㬊	曲一斤大又
鹍	曲一儿儿儿
鹖	曲一儿巛儿
颢	曲一言曲大
㬚	曲一言月竹
㫰	曲一言添又
鳖	目卜添竹儿
晖	曲一之之梄
旸	曲一乙添斤
㬎	曲一巛巛米
睐	目一二寸曲
䎃	目寸二乙乙
䴗	目一大言儿
鶪	目一大言儿
眍	目一七添人
帏	目卜二卜乙
帼	目卜口三言
羁	目曲十十三
黪	目曲二大斤
罦	目曲斤添乙
鹮	目曲一儿儿
罗	目曲儿言
逻	之一目曲儿
黩	目曲二广大
罴	目曲二巛米
㠓	目目十一大
㟃	目目乙一口
崃	目目二寸曲
崄	目目人二添
𪨶	目目大寸梄
𪩘	目目十米大
𫵷	目目大大乙
峣	目目七竹一
㠇	目目言曲大
𪨰	目目曲曲
岗	目目目寸人
岘	目目目儿
𨟠	目一目川乙
嵚	目目斤一儿
刿	目目儿言曲
峥	目目儿添又
嵝	目目米梄巛
𫶇	目目十之目
崂	目目十之乙
𫖮	目目乙乙大
赒	目人月二口
睑	目一人二添
罂	目人目十巛
赈	目人大七
赗	目人曲一目
赑	目人目人目
贬	目人竹添之
赊	目人人寸二
赡	目人儿人言
贻	目人巛言口
赅	目人言巛人
鹦	目人目巛儿
觃	目儿乙一
䁖	目一米梄巛
鹘	目之儿巛
矫	竹大竹大川
鳘	竹一巛竹儿
缾	竹一十米十
牺	竹二梄口
𬕂	竹言二卜目
酂	竹二儿目乙
颋	乙言竹二大
箦	竹言三卜目
稆	竹梄口一口
秽	竹梄目目儿
籁	竹言梄儿目
鹙	竹梄米人儿
秾	竹梄之之儿
𥝱	竹梄又又卜
岙	竹添大寸目
氇	竹七儿一曲
鸹	竹卜儿巛
篑	竹言口一目
筼	竹言口一目
筛	竹言曲一目
筜	竹言曲人又
箩	竹言目曲儿
衅	竹添目梄米
篯	竹言斤一七
筚	竹言儿儿十
筝	竹言儿添又
箪	竹言米曲一
簖	竹言米巛斤
氩	竹乙二巛
氲	竹乙曲一目
俨	川添二巛竹
俪	川添一目言
俫	川添二寸曲
俦	川添三卜寸
伛	川添七添人
雠	川卜言寸川
鹎	川口十寸儿
魉	川口一人人
囱	川口儿卜
偿	川添曲二巛
傥	川添曲口儿
侩	川添人二巛
伧	川添人寸乙
㑊	川添言曲
仪	川添言添人
𫢸	川添米曲一
佥	人寸二寸添
㙦	人寸竹十二
颌	人寸一口大
鸽	人寸一口儿
觎	人寸一曲目
鸰	人寸之一儿
鸧	人寸乙目儿
郐	人寸二巛乙
徕	人卜二寸曲
惩	人卜一卜之
衚	人卜十口月
鸻	人卜儿巛
径	人卜又言二
鹆	人一人口儿
饸	人又人一口
馔	人又乙十人
𫗧	人又梄一口
馑	人又十口三
饘	人又言曲一
馇	人又梄曲一
𫗴	人又言曲一
馃	人又曲卜梄
馉	人又目之
馒	人又曲目又
饩	人又竹乙
餭	人又川曲三
饺	人又言人人
饹	人又儿卜口
饻	人又言儿
馌	人又二巛目
饳	人又巛曲巛
鹟	人一巛乙儿
铏	斤一一十曲
钲	斤一一添卜
钙	斤一一卜巛
镉	斤一一米一
𫓧	斤一二言
𬭳	斤一二米口
铻	斤一二又口
𬭬	斤一三三又
锲	斤一三乙大
颀	斤寸大人
䴘	斤寸卜七儿
慇	斤寸又月之
𨱇	斤一一曲言
鎝	斤一十一口
𨱏	斤一十一口
䦃	斤一十卜二
镆	斤一十曲大
锚	斤一十卜曲
𨱑	斤一十曲人
锳	斤一十目大
铹	斤一十之乙
镖	斤一梄口二
镈	斤一梄二寸
镡	斤一梄曲十
𬸪	斤梄曲卜儿
锜	斤一大一口
镢	斤一大巛儿
钝	斤一一添巛
𬬻	斤一卜寸又
锷	斤一口一一
铞	斤一口一目
锝	斤一曲一寸
铀	斤一曲二
钾	斤一曲乙
𬬹	斤一曲梄
镋	斤一曲口儿
镘	斤一曲目又
𬭯	斤一目添竹
锟	斤一曲儿儿
锶	斤一曲卜之
铿	斤一曲又二
𬭶	斤一目二米
镮	斤一目口儿
铡	斤一目人曲
镚	斤一目月月
镯	斤一目儿口
锣	斤一目曲儿
铠	斤一目目乙
铤	斤一乙竹二
铥	斤一竹二巛
锤	斤一竹十二
铢	斤一竹一梄
釳	斤一竹一乙
𬭤	斤一川又竹
铧	斤一川儿十
锼	斤一川卜又
铪	斤一人一口
镎	斤一人口竹
鏦	斤一人人卜
鍮	斤一人月曲
𬬭	斤一人寸儿
𬭩	斤一人乙乙
锊	斤一斤添寸
锧	斤一斤十目
𫔍	斤一斤梄曲
䝙	斤月七添人
铄	斤一儿七曲
锪	斤一儿斤之
锴	斤一儿儿川
镵	斤一儿儿言
铯	斤一儿添乙
镏	斤一儿竹曲
钨	斤一儿川
镶	斤一言口十
镐	斤一言目口
锿	斤一言儿口
𬭚	斤一言口乙
镱	斤一言曲之
镞	斤一言竹竹
铰	斤一言人人
钪	斤一言一月
镝	斤一言十口
镦	斤一言乙竹
锍	斤一言巛川
铳	斤一言巛儿
铉	斤一言一巛
镳	斤一广又米
镛	斤一广又月
𨱔	斤一米梄寸
镒	斤一米人目
𬭸	斤一米儿十
锩	斤一米二乙
镃	斤一米巛巛
觅	斤添目儿
𬭛	斤一添添又
鹞	斤一竹巛儿
镓	斤一之寸大
𬭎	斤一之大巛
镕	斤一之人口
镲	斤一之又二
铊	斤一之寸儿
𬭼	斤一之米大
铵	斤一之寸巛
铎	斤一又言二
钮	斤一又二卜
镫	斤一又口米
𫔎	斤一又人口
锓	斤一又之又
锔	斤一又乙口
锕	斤一乙一口
钇	斤一乙七
钯	斤一乙曲
镪	斤一乙口口
钖	斤一乙添斤
镠	斤一乙人斤
鸼	斤乙儿巛
舣	斤乙言添人
镴	斤一巛人巛
䥽	斤一巛又言
飐	月卜卜寸口
飔	月卜曲卜之
凤	月寸又言
飗	月卜儿竹曲
飏	月卜乙添斤
腼	月一又口目
颾	月卜又言口
䐃	月一口寸竹
狮	月竹曲一目
猪	月竹二竹言
猃	月竹人二添
狯	月竹人二巛
𫛭	月竹三一儿
獱	月竹之曲目
㺄	月竹人月曲
狝	月竹儿添曲
獭	月竹梄儿目
臜	月一竹儿目
𬸚	月竹言大儿
狲	月竹乙一曲
脍	月一人二巛
䏲	月一米乙川
𦝼	月一米梄巛
肠	月一乙添斤
鲾	儿一一口曲
𬶮	儿一二米口
𩸽	儿一十川儿
鳠	儿一十川又
𩺊	儿一十言川
鳔	儿一梄口二
𬶟	儿一梄口曲
𬶠	儿一梄一目
𬱟	儿添大乙大
鳡	儿一七口之
鹠	儿竹曲卜儿
鸱	儿七言添儿
鲀	儿一一添巛
鳄	儿一口一一
鳀	儿一曲一卜
𫚕	儿一曲一目
鲿	儿一曲二巛
玺	儿添曲三言
鲥	儿一曲一寸
鲉	儿一曲二
鳢	儿一曲口米
鳁	儿一曲一目
鲗	儿一目人曲
觞	儿添月乙斤
鰤	儿一竹一目
鲊	儿一竹一卜
鳈	儿一川曲曲
鹐	儿添川二儿
鲙	儿一人二巛
鲘	儿一斤一口
䲟	儿一斤添乙
𬶭	儿一儿又二
𬶏	儿一儿大乙
𩾃	儿一儿口儿
颍	儿儿曲添大
毙	儿儿儿儿儿
颎	儿儿米人大
鲸	儿一言口曲
鳣	儿一言曲一
惫	儿卜曲卜之
鲛	儿一言人人
鳑	儿一言之言
鳉	儿一广儿寸
鱇	儿一广又添
𩾌	儿一广又添
鳙	儿一广又月
鳒	儿一米曲人
𬶐	儿一儿寸添
𬶍	儿一之寸儿
𩽾	儿一之寸巛
鳚	儿一又二寸
鲬	儿一又言月
鲃	儿一乙曲
鸲	儿乙口一儿
鲺	儿一乙竹口
鳛	儿一乙乙川
邬	儿川乙口
鲹	儿一巛大斤
鲻	儿一巛寸曲
𫚭	儿一巛人巛
袅	儿巛言儿
讦	言寸一十
证	言寸一添卜
谨	言寸十口三
谟	言寸十曲大
𬤝	言寸梄曲之
𫍯	言寸七一口
鹯	言一口一儿
谔	言寸口一一
鹫	言一口大儿
亸	言一口曲一
鹑	言一口乙儿
𬤊	言寸曲一卜
谠	言寸曲口儿
峦	言曲目目
脔	言曲目人人
谒	言寸曲人巛
恋	言曲之巛
𠅤	言一曲卜之
孪	言曲乙一
𫍽	言寸目口儿
诈	言寸竹一卜
诜	言寸竹二儿
讫	言寸竹一乙
诿	言寸竹梄巛
谢	言寸川三寸
谀	言寸川二人
讹	言寸川添儿
𫍲	言寸川卜又
赟	言人一卜目
𨭉	言人一卜斤
齑	言人川曲一
䴔	言一人人儿
鵁	言一人人儿
鳼	言人儿巛
谂	言寸人又之
讻	言寸人言巛
兖	言一人巛儿
衮	言儿人一巛
讼	言寸人一巛
谖	言寸斤大又
谵	言寸儿人言
诤	言寸儿添又
谆	言寸言口乙
谇	言寸言人十
谪	言寸言十口
谰	言寸又梄目
赣	言米曲二目
竞	言米口一儿
谱	言寸米曲曲
戆	言米曲目之
産	言米竹添竹
彦	言米竹添斤
飒	言米月卜
𦒍	言米曲乙乙
谝	言寸之目十
谧	言寸之竹目
谞	言寸又卜月
谲	言寸又人口
㮾	言添又月梄
𬸦	言乙竹竹儿
谬	言寸乙人斤
诩	言寸乙广乙
诎	言寸巛曲巛
盗	广寸儿人目
癫	广一十人大
廪	广大言口二
庙	广大曲二
麽	广大梄竹巛
庂	广大人寸
赓	广大又人目
鹒	广大又人儿
𫷷	广大斤一儿
䗪	广大十米口
鹧	广大十米儿
疬	广一大大乙
廱	广大巛乙川
疟	广一七添一
酱	广卜儿言梄
瘻	广一曲口巛
阇	又寸二竹
闱	又寸二卜乙
𬮱	又寸梄口二
阒	又寸目一大
闳	又寸大寸巛
闾	又寸口一口
阄	又寸儿添曲
阗	又寸十目人
闿	又寸目目乙
瘿	广一目目巛
𫔶	又寸川目梄
阏	又寸言人广
阁	又寸儿卜口
阍	又寸儿七曲
闵	又寸言人
阆	又寸言添又
阘	又寸曲乙乙
阖	又寸二巛目
阙	又寸米巛儿
疭	广一人寸人
痪	广一儿目大
瘅	广一米曲一
痉	广一又言二
瘆	广一巛大斤
怃	米卜一添大
鹢	米一人目儿
鹣	米一又人儿
鹚	米一巛巛儿
㥄	米卜二人儿
恸	米卜二巛乙
盖	米三目梄
羟	米三又言二
冁	米寸曲十儿
郸	米寸曲一乙
䎖	米寸目乙乙
粝	米梄大一乙
粪	米梄十一人
糁	米梄巛大斤
𥻗	米梄梄曲一
惬	米卜七二米
愦	米卜口一目
愠	米卜曲一目
恻	米卜目人曲
炜	米人二卜乙
烩	米人人二巛
㸌	米人梄添川
𬉼	米人七添人
炖	米人一添巛
㸆	米人竹口曲
炽	米人口一人
煴	米人曲一目
㶲	米人月二
炝	米人人寸乙
烂	米人米一二
𬊤	米人米曲一
炉	米人之竹
𬊈	米人又二寸
怆	米卜人寸乙
忷	米卜人言巛
恟	米卜儿人巛
懔	米卜言口二
怿	米卜又言二
𣲘	添添一添大
涞	添添二寸曲
沍	添添一添巛
喾	添寸之竹口
𬒈	添寸之之大
鲎	添寸之之儿
𣸣	添添十十目
懑	添添十人之
渎	添添十广大
滢	添添十三言
溁	添添十之梄
涝	添添十之乙
潆	添添十之巛
漤	添添梄梄巛
濑	添添梄儿目
㵐	添添大巛儿
濒	添添卜曲大
溃	添添口一目
𬇹	添添口三言
浉	添添曲一目
灏	添添曲曲大
滥	添添曲竹目
鲨	添添曲竹儿
浍	添添人二巛
㽏	添添人口十
溆	添添人竹又
㳇	添添人一人
鹡	添添人月儿
沧	添添人寸乙
𫖯	儿寸添添大
泺	添添儿七曲
㴔	添添儿又之
浏	添添言人曲
浒	添添言竹十
济	添添言人川
湾	添添言曲乙
㳘	添添言巛儿
瀁	添添米言又
泻	添添之巛一
泾	添添又言二
滪	添添又卜大
渌	添添又二曲
𬍡	添添乙三言
塚	二一之之大
鸋	之寸之一儿
𬸣	之寸十人儿
寝	之寸广之又
窜	之人口一口
窝	之人目口
窎	之人儿巛
窦	之人十广大
窭	之人米梄巛
祎	二曲二卜乙
祢	二曲儿添曲
禄	二曲又二曲
袆	之广二卜乙
𫌀	之广三卜目
衬	之广寸言
襕	之广又梄目
裢	之广之一梄
裥	之广又寸曲
褛	之广米梄巛
裈	之广之之梄
袯	之广巛又言
皲	之之梄曲又
郓	之之梄曲乙
鸩	之之儿寸儿
𬩽	又二寸言乙
彟	又二寸川又
鹔	又大川人儿
彞	又二米巛十
鷴	又寸梄一儿
閍	又寸言乙
骠	三米梄口二
骦	三米梄梄目
𬳵	三米大卜一
𫘪	三米大川曲
骁	三米七竹一
𫘨	三米曲一卜
骋	儿巛曲二一
驲	三米曲一
𫖳	又大口一大
屩	又竹人目口
屃	又竹目人
鹛	又竹目一儿
𬳽	三米竹二儿
鸤	又竹儿巛
䴙	又竹口言儿
鷿	又竹口言儿
驸	三米川添寸
𬳿	三米人寸竹
𬶨	又人七儿儿
𫘬	三米斤巛大
𫘦	三米儿十巛
驺	三米儿添又
刭	又添言二曲
颡	又言又梄大
鹬	又言又口儿
鹜	又言又竹儿
骛	又言又竹三
双	又言又言
𫠊	三米言一巛
𬴊	三米米儿十
骙	三米又一大
𫘝	三米又添大
𫘧	三米又二曲
骕	三米又川人
骚	三米又言口
骎	三米又之又
书	又添乙卜言
堕	乙口大月二
骘	乙口卜曲三
𬯎	乙口口一目
陨	乙口口一目
𬮿	乙口目目乙
𨺙	乙口川二儿
险	乙口人二添
𬯀	乙口言人川
鹨	乙广乙斤儿
翚	乙广乙之梄
陉	乙口又言二
𫸩	乙巛七添人
缙	巛一二巛曲
绠	巛一一曲人
缬	巛一二口大
缰	巛一三曲曲
缜	巛一十目人
缥	巛一梄口二
縳	巛一梄曲寸
𦈡	巛一梄添大
绮	巛一大一口
缭	巛一一曲曲
绂	巛一大言又
纮	巛一大寸巛
绒	巛一七竹大
辔	梄曲巛巛口
粜	巛曲巛卜米
䢺	巛曲巛卜乙
缲	巛一口口梄
缱	巛一之一乙
绅	巛一曲梄
绱	巛一曲目口
缊	巛一曲一目
缆	巛一曲竹目
绲	巛一曲儿儿
缌	巛一曲卜之
缳	巛一目口儿
缈	巛一目曲竹
𬙊	巛一目米二
𫄸	巛一竹二米
娇	巛竹竹大川
嫒	巛竹斤大又
娆	巛竹七竹一
𫄧	巛一乙竹卜
嫱	巛竹十口口
媪	巛竹曲一目
㛹	巛竹川曲人
婳	巛竹一曲巛
姹	巛竹之竹七
嬷	巛竹广竹巛
㚷	巛竹人寸曲
嫔	巛竹之斤人
嬝	巛竹儿巛言
𫰛	巛竹又言二
㛚	巛竹又言月
驽	巛竹又言三
纥	巛一竹一乙
缒	巛一之竹乙
缑	巛一川又竹
𫄨	巛一人大目
绤	巛一人人口
绶	巛一斤之又
绹	巛一儿十巛
绛	巛一儿卜十
纰	巛一儿儿儿
𬙋	巛一言口十
𨚕	巛言十卜乙
𫟅	巛一言口曲
缟	巛一言目口
𬘯	巛一言口乙
缞	巛一言儿曲
𫄷	巛一言曲之
缡	巛一言目巛
绞	巛一言人人
毵	巛言大斤竹
缔	巛一言之目
繸	巛一之米大
缢	巛一米人目
缣	巛一米曲人
绻	巛一米二乙
绨	巛一米乙川
缕	巛一米梄巛
𬘫	巛一之一一
𬙂	巛一之曲人
缤	巛一之斤人
𬘘	巛一之之儿
绎	巛一又言二
缀	巛一又又又
缗	巛一乙七曲
𬘩	巛一乙竹二
缪	巛一乙人斤
鸶	巛一巛一儿
缁	巛一巛寸曲
绌	巛一巛曲巛
𩹬	儿一梄十口
𥈴	目一卜七一
𣴛	添添七竹大
𡄍	口一竹言三
鉳	斤一广卜儿
𪷉	添添巛一曲
𢠩	米卜广梄梄
𢸛	寸添言二口
𢃱	目卜十二梄
揇	寸添十目米
𪞺	巛曲巛乙巛
𩲵	川口竹三
𦁹	巛一言儿言
𧓇	口巛又人月
𠴐	口一米又卜
𱽐	十卜月寸二
㨳	寸添之一口
𥴢	竹言竹梄川
𠿁	口一十三儿
𡔔	二一十梄目
𦄇	巛一添曲二
𡐙	二一人一寸
𢲔	寸添三曲三
𧚟	之广又竹竹
𫕰	梄添月三二
𢯡	寸添言巛月
𪧸	二一寸川二
𨆝	口卜人目曲
䱛	儿一七口一
𬹓	十一曲二之
𪆦	斤三大人儿
𧍴	口巛梄一目
𪟀	乙寸言乙
𬦪	口卜乙寸口
𠍤	川添十之乙
扙	寸添一添人
𤅜	添添梄二月
𠞺	一添儿言口
㔧	卜七曲目乙
𪄨	口一曲月儿
𥓵	大一广儿言
𤞨	月竹梄二
𪮫	寸添十曲竹
𬩭	之一竹米二
𪥘	言一米口大
𤙭	竹二梄二
𬄦	梄一曲竹目
𤊣	竹一梄大米
𢭲	寸添目人
𪢡	竹二口目口
𫼔	竹寸乙寸
𧑂	口巛又七儿
𤞫	月竹七竹十
𥛗	二曲斤添川
𠿂	口一寸竹川
𤢾	月竹人人曲
𠺷	口一二口儿
𥿗	巛一口一人
𬦼	二竹巛添口
𡑓	二一梄梄梄
𦀗	巛一二一米
𪦎	巛竹言大斤
䕼	十卜十二川
榪	梄一三米
𠁂	二竹一卜
𡢻	巛竹川三目
𰡚	月竹斤寸儿
𤄱	添添斤目人
嘫	口一儿大米
𨰺	斤一言巛竹
𥇺	目一巛大大
𬟛	之寸米卜曲
𥎁	又言又卜口
𨪞	斤一广又月
𢸟	寸添川人人
𢫚	寸添二卜一
𠞸	儿巛曲寸
炥	米人乙巛川
𬴕	言一口目乙
𬍎	月竹二曲大
挰	寸添口一三
𢬥	寸添添添二
㨕	寸添乙又目
𠧌	竹添十人人
𢲠	寸添三之儿
𨗠	之一梄二巛
侼	川添十之乙
𬅓	梄一口大大
𬎽	月二儿添卜
𫾄	寸添曲曲二
㳯	添添言十
𢸚	寸添十儿三
𦁺	巛一又寸
㩧	寸添曲人曲
𢐎	乙巛米曲人
𡀪	乙寸口寸曲
𢺺	十寸又人乙
𤈝	米人十卜人
𢟕	米卜巛目人
呠	口一梄一一
𫉅	十卜巛口之
䱸	儿一川卜又
靀	梄添十一大
䋎	巛一曲一一
鞸	十十曲十二
𧁷	十卜十广梄
脺	月一言人十
櫊	梄一又儿口
𨧢	斤一口乙曲
𧄲	十卜言曲大
𧝨	之广言乙口
𫵀	曲人米巛巛
𡫫	言人口曲人
卲	乙寸口一乙
𠴏	口一十卜言
𢭝	寸添乙言之
𤸒	广一曲目巛
𪉽	卜寸口目又
𥢃	竹梄之目一
𠼲	口一二一川
𣊌	曲一二一川
𧅫	十卜川人目
𬖗	米梄巛竹又
憦	米卜米之乙
𠰀	口一乙巛卜
𡌣	二一目曲七
𬜽	十卜大一十
𥊛	目一言月三
𥘪	二曲竹一十
𧽈	二人乙曲竹
𣛣	梄一又一十
𦣘	月一一十儿
𦸰	十卜言竹竹
𧜖	之广十目人
𥷧	竹言添乙川
𡎝	二一又一大
𢹈	寸添竹言曲
𪾤	目一七大
𬂙	言米曲竹二
𣷯	添添之一斤
𫽯	卜七言人竹
𣋁	曲一曲三又
𨒟	之一儿卜广
㘖	口一言斤大
𡓞	二一竹言三
𥯊	竹言言儿言
𬥯	人一乙人卜
𣜵	梄一口一卜
𫌒	之广巛巛儿
𫡍	竹大川口口
𬁑	曲一月竹二
𡁹	口一言乙竹
𪹟	米人巛寸目
𨐮	言十十巛人
𦵠	十卜川竹巛
𨁪	口卜梄寸
𣷲	添添之竹斤
𥌹	目一斤川目
𡠣	巛竹又七儿
𧹪	二一米目十
㗢	口一竹二乙
𫱤	竹梄又言巛
𡽾	目目七竹目
𦩰	斤乙竹曲二
𱐲	斤添又大乙
𤢥	月竹十目巛
㳪	添添大卜口
𫈘	十卜川言巛
𬴫	三七斤梄梄
挷	寸添三卜乙
𠊟	川添口一曲
𫡸	二寸梄巛二
𬁜	曲一十之儿
𤹙	广一二口儿
𫴸	曲人曲一
𤶑	广一口寸大
𫖽	月寸二人又
𦾠	十卜曲人竹
𬔗	一添卜寸言
𤭷	一巛人月曲
𬡰	之广曲口米
𡗅	儿言儿之米
䇄	言米竹一乙
𠊛	曲一一寸人
𢲧	寸添十巛人
𥺑	米梄又之又
𬺚	言米曲三月
𦫘	儿添乙又言
䇪	竹言七二
溋	添添乙又目
掆	寸添目米目
𣇠	曲一巛十又
𢵰	寸添巛一口
𬏱	广一添添月
𬠶	口巛之三巛
𤎒	米人二米月
𫼚	寸添言一人
𠸦	口一竹寸目
𱫻	米人又十儿
𥆟	目一米口儿
𫗻	米一川十月
𪂯	儿巛巛十口
𪢰	口寸口目月
蕽	十卜曲曲大
𡂓	口一之十口
𢯙	寸添竹大口
𧋅	口巛又言广
𣇡	曲一乙乙之
燰	米人斤之儿
𪜕	二竹巛添
𫼎	之竹米竹十
𢋬	广大梄目川
𧃽	十卜广川之
𩇆	梄添曲口竹
𧱺	大月川一口
芌	十卜一添一
𫬕	口一梄月二
𣘂	二一巛竹梄
𡳰	又竹曲十口
𤇩	米人之巛竹
𬋌	米人米三大
𡥌	乙一曲一
𩿠	儿巛七竹巛
䨙	梄添添竹二
𨄼	口卜竹儿儿
𠸾	口一月竹之
𧸝	二二目目米
𫵥	又竹米乙口
𧶄	目人斤添又
㩔	寸添又人月
𥹙	米梄乙寸口
𬪽	竹十曲儿卜
𧈣	口巛乙添竹
𥸄	竹言言儿曲
𦢵	月一广口竹
𣎢	月一十十月
𬮫	又寸一竹十
𠺩	口一添巛川
𫺫	米卜米大乙
𡮔	米三大寸曲
𡆂	口一三口口
𨇒	口卜大大大
𠠙	之寸一曲曲
𡗂	米三二儿儿
𥳃	竹言之口竹
𬗱	巛一曲一梄
𬁫	又大二曲目
𥱨	竹言三卜巛
𥳄	竹言之曲人
𡝕	巛竹乙曲三
𠝖	十一曲一乙
穉	竹梄又曲竹
𡳝	又竹竹人十
𥺊	米梄竹二口
𤎞	米人巛月二
𣙭	梄一竹乙口
𪉴	卜寸口十梄
𨀍	口卜月二
𢵨	二一米又竹
𬃻	曲卜梄口人
𪯯	大大卜广十
𤜠	月竹乙添竹
𡘯	言人口一大
𡃼	口一梄川米
稡	竹梄言人十
𧝩	之广人十目
𧛉	言儿梄一竹
𩷉	儿一言曲
𫧭	十寸曲口梄
蛒	口巛儿卜口
𡅯	口一竹又之
𣎦	月一曲十儿
𥦝	之人梄一梄
𥏿	竹大又寸口
𣅙	曲一一添一
𫎤	人一乙又目
𠻓	口一之之川
𡉿	二一梄一
𪬽	儿添又言口
㧅	寸添乙寸
𤠳	月竹二人乙
𫘲	目之月乙曲
𢣸	米卜言又口
𡳶	十卜卜米巛
𢭹	寸添言人口
𤖹	川又言米
𬘅	巛一曲米大
𪫼	言人寸言之
絸	巛一目儿
𨤰	儿添曲曲二
𦁅	巛一之广乙
𩟼	人又斤言又
𫎼	二人乙之巛
𩷆	儿一人二巛
𪇎	梄一梄二儿
𬔋	之人大一卜
𪱆	曲一曲十儿
𨄺	口卜二一川
𤽶	川曲又竹竹
𠲮	口一一巛二
𩯁	三七斤曲巛
𫙛	儿一三卜梄
𤇪	米人人寸斤
𨖩	之一米二目
𩹮	儿一十二梄
汓	添添乙一
𪟕	竹言十三曲
𡅉	口一竹又曲
𤈜	米人七二
𧸻	目人三又言
𫯆	目寸一二又
𨁫	口卜曲卜二
鱩	儿一梄添曲
𫯏	大寸乙儿卜
𥠮	竹梄十目米
𨅺	口卜又三竹
𠒥	曲人一广梄
𡃗	口一梄曲大
𦃮	巛一十巛人
𨫋	斤一二卜目
𬺙	言米曲儿言
𣕘	梄一巛口梄
𬧗	口卜巛斤巛
𩬆	三七斤卜巛
𬌽	月竹大七寸
𠹳	口一儿十梄
𢬦	寸添二曲巛
𤷰	广一三人二
𥖺	大一又米大
𫅜	人寸之米口
趶	口卜一添寸
𠃯	竹梄乙竹乙
𤁔	添添川广十
䱕	儿一竹一巛
𣹕	添添人又二
𦙀	月一斤寸又
𦟵	月一十斤乙
𤄍	添添梄儿曲
𧹦	二一米人目
𫺦	人一乙之十
𪮚	目寸米曲竹
𦷬	十卜竹之竹
𧊊	口巛月二
𤠲	月竹目口米
𥳐	竹言又一十
𬇚	添添巛巛乙
𦹯	十寸口曲十
𫆚	月一曲二
𣃲	言乙竹月二
𧑁	口巛巛人斤
𥜡	二曲儿曲二
𬎶	竹三又二米
鬦	三三广寸十
𫊚	十卜川梄口
𱏯	曲卜儿竹儿
㤕	米卜巛曲巛
𡁿	口一十儿巛
𧉻	口巛米二
𬗔	巛一言人寸
𬰠	一添梄口目
𠹖	口一又十儿
啛	口一一又巛
槏	梄一米曲人
𤵺	广一曲梄竹
𥇼	目一大一十
𬁮	米寸目大米
𤷶	广一三卜儿
𪦭	巛竹十口儿
𬧲	一卜口一梄
𫎑	目人儿添卜
𪝪	川添又儿卜
𪢷	二一言七
𩞝	人又川人儿
𥉪	目一添竹巛
𤏢	米人乙米大
𠑬	川添人二一
𣰙	竹七梄梄二
𣺻	添添目大目
𠶝	口一一口又
𬙞	目曲二巛七
𩭵	三七斤之乙
𬮶	又寸一大目
𦟎	米三二人人
𫁷	竹言又言又
𠹯	口一乙儿二
𪄅	人言梄月儿
𤬸	一巛竹三
𬤻	大月乙添竹
𫃹	巛一之儿添
㖗	口一目言又
𫏚	口卜川言口
𬇧	添添二卜口
𣔠	梄一十卜斤
𩻛	儿一七儿曲
𡊠	二一曲乙
𪇋	儿巛目目川
𬆎	卜卜七巛又
喠	口一竹曲二
𠲝	口一言人寸
𫦽	十一口乙竹
𠱆	口一乙竹乙
抳	寸添又竹儿
搮	寸添梄口梄
𩯹	三七巛大大
𬝉	十卜又又又
𡚡	十卜儿竹大
𠽚	一卜口曲二
𪇍	儿巛之一目
𧕭	口巛十竹目
𬉚	添添又曲竹
𠜬	川添曲一乙
𫸕	乙言又米二
𤕔	口一竹人人
𢯞	寸添一七卜
𤒲	米人广米二
𱜝	七添又儿目
𪱊	曲一竹一口
𪿒	大一卜寸又
𫭅	口寸寸添巛
𠶅	口一寸乙口
𧍇	口巛川口人
𢵔	寸添又乙乙
𡮊	曲人二乙言
𫨮	二一巛人竹
𫪿	口一添川竹
𦖇	三十口乙曲
𤜯	月竹乙添人
𡮤	又寸寸竹曲
𢷱	寸添广曲巛
𪰏	曲一一卜口
𫱗	巛竹人口竹
𫽝	寸添曲又目
𫻋	米卜川口又
𤎔	米人米言曲
𪴁	梄一口儿添
𣌵	曲曲乙添人
𦄌	巛一二二月
𧃌	十卜口曲曲
𠺮	口一曲二寸
𦝹	月一又人梄
𫁜	之人大儿儿
𣴜	添添寸竹七
𨆣	口卜十目巛
𣨕	一添儿口口
𢴗	寸添添米米
𥆀	目一添添二
𫭿	人寸人儿儿
𬟻	口巛言一人
㵢	添添梄添曲
儾	川添一十儿
蹆	口卜之一又
𧰗	一添口目一
𠝺	十二梄一曲
𤵪	广一乙寸口
𪡵	口一添口月
𧹻	二一米二二
𪵌	月又川儿儿
㺞	月竹川卜人
𩶟	儿一竹添之
𠺾	口一三竹梄
𬟎	十卜三儿斤
𫫗	口一大卜目
𨷑	米三大一十
𦓜	二竹儿大大
𩟵	人又竹言三
㺝	月竹七竹目
䈧	竹言斤米
𩺡	儿一三曲三
𦗞	三十之一口
𥿥	巛一川添二
襊	之广曲三又
𥣑	竹梄十曲二
𣱽	添添乙添竹
𧛈	之广人目十
𠶐	口一之一乙
媎	巛竹二竹
𩟻	人又曲口十
𩑰	曲一一添大
𥊡	目一梄曲儿
𢝘	米卜川二二
纙	巛一目巛川
𦝄	月一二人儿
鑧	斤一之目言
𡎭	二一巛巛儿
𫶸	乙曲川儿曲
𧊐	口巛又大二
𩗂	月卜一添梄
繓	巛一曲三又
𦣰	十寸目七卜
𫦢	大一言口曲
𩷈	儿一曲竹乙
𤊦	米人言乙竹
𪨛	又竹米十七
𥪝	言米曲梄口
𤀘	添添十卜月
𩃳	梄添三人二
𥯏	竹言川十人
𨮇	斤一十卜月
𣖧	梄一卜儿梄
𪬧	乙乙之口曲
𩺤	儿一梄口梄
𪔠	三一十十又
𢤛	米卜目儿儿
㷙	米人米月曲
𢢬	米卜人目巛
𨅿	口卜二七巛
𪽳	广一梄口巛
𧓯	口巛川添斤
𫄄	巛一又米巛
𪩁	目目乙口目
𡻔	目目添言又
𡓃	二一大大大
𫗒	人又之寸巛
𫛈	儿巛乙一斤
𬨻	之一梄儿卜
𪲍	梄一米一目
𩠵	米一川人梄
𪯞	言乙竹人十
𧦕	言寸十寸月
𠽅	口一三人川
𬡣	之广言米口
𪻉	月竹言人川
𡃹	口一口一七
𦟉	月一广一十
𢏢	曲曲乙巛
𪱯	言七月言曲
𩡜	竹梄曲又月
𡚎	目曲十一口
𡮌	曲人人卜又
𫹦	十寸目二寸
𢵺	寸添添十巛
𢁸	目卜言乙
𣌶	人一巛言曲
𡍢	二一乙一斤
𪳼	添添二二梄
𪦜	巛竹添添二
𤹚	广一三十七
𬗥	巛一米曲一
𫙂	三七斤米巛
𫷍	川曲目又儿
𦟷	月一二言口
𠠍	竹梄儿曲曲
𨆠	口卜十一大
𬚶	目寸人言三
𩸶	儿一目目大
𠌊	梄一人人乙
𫳵	之寸竹一口
𢶼	寸添目目川
㽳	广一一添寸
𫧜	七添口二乙
𥠬	竹梄三一大
𠰌	口一一添梄
𪅭	川添卜月儿
𡌿	二一言口曲
𣗪	梄一十人梄
𡮆	曲人又寸
𦷾	十卜十之目
𬑚	十寸目七目
𣴓	添添川添竹
𨀿	口卜二儿广
𩆾	梄添卜一一
𥍘	目一人二一
𠽄	口一寸人梄
𦍉	目曲巛一口
𬈚	添添三月又
𪥤	卜一巛竹
𠾓	口一言乙口
𤄌	寸添斤一米
𬜛	斤乙竹言又
𪥾	巛竹大儿卜
𡇸	口寸竹广儿
𪩔	目目米一七
𧔛	口巛又米乙
𠻥	口一巛曲梄
𡏣	二一川目大
𬏨	广一口竹七
𩆠	梄添十之儿
𥰆	竹言言之目
𦡠	三一十人月
𤍉	米人目目言
𥈹	目一之人七
𧔾	口巛竹月大
𠽎	口一添二二
𡎢	人寸人儿卜
𡢽	巛竹梄添曲
𤐓	米人添巛大
𪭩	竹寸川添七
𢸠	寸添言曲梄
𧛷	之广十七口
𤶾	广一言人口
噡	口一儿人言
𢏑	乙巛米二
𬋨	斤添又大一
𥚆	二曲乙言之
𢢄	米卜目目巛
𧹫	梄一梄二米
𠁺	口一口二米
𫣝	人寸一人三
𬆆	大卜一卜儿
𣖞	梄一言曲口
𬈺	添添曲三之
𫸶	乙巛乙二乙
𨆹	口卜言梄口
𥼖	米梄竹巛竹
𦤱	川目大又巛
𫎄	一添口目卜
𫵢	曲曲又巛巛
𪭽	寸添广二言
𨠲	梄寸川竹二
𢱜	寸添人二寸
𢵵	寸添十曲梄
𬎭	一巛竹目曲
鮻	儿一巛人儿
灲	米人曲寸
𧆄	梄一口巛梄
𨼚	乙口曲三之
𤋿	米人十巛巛
𪃱	大大曲乙儿
𡁜	口一二曲目
𢝚	米卜添竹儿
𨍄	梄曲目三人
𱜞	乙曲二人儿
𡑗	二一川之川
槒	梄一言巛曲
坧	二一大一
𣅅	曲一乙添竹
𪵟	竹七又竹目
𤻪	广一梄添大
𪭣	寸添又卜言
𥊝	目一二米月
𣎀	月一广卜口
𨲅	三七乙言之
撍	寸添七儿曲
𬚂	米三又七七
𥵾	竹言竹曲二
𢗷	米卜曲添
𤞪	月竹口一口
𫰅	十卜儿竹大
𱢽	之寸言月三
𡀥	口一十川乙
𫆲	月一十之乙
𪤄	二一目二巛
𡅎	口一竹儿曲
𬟖	一添米巛口
𥅦	目一三卜梄
𪸘	米人二一巛
𡌀	二一口乙曲
𢆭	巛寸口竹十
𥢬	竹梄斤米
𦟟	月一广梄梄
𢚲	米卜乙乙竹
𠲞	口一寸添二
㺯	三一大寸
𤹼	广一卜七斤
𥖸	梄一川口大
𪩪	七添又人儿
𡒬	二一竹言十
𤳽	曲卜言卜
𬑰	竹大米二
𡀳	口一又口米
𡕵	一添川人一
𪝄	川添一一一
𪺹	月竹巛竹又
袊	之广人寸之
𫠰	一添卜竹七
𥈭	目一口一一
𫔳	又寸言人二
𣼼	添添乙梄曲
𤀛	添添又人人
𪇨	儿巛十添梄
𠿚	口一十巛梄
𪝜	川添竹一目
𪪈	曲三之竹十
𦝂	月一川儿言
𢺜	寸添竹乙川
𬳜	竹梄曲一儿
𦄹	巛一寸曲十
𥹸	米梄十之乙
𨆒	口卜添川十
𩂕	梄添乙巛川
𪴻	大卜一乙口
𪱬	月一添竹二
𬞠	十卜人儿言
𥔦	大一大卜目
𬁶	二卜又添月
𥖒	大一米曲乙
𡺐	目目二竹
𦭧	十卜七添目
苚	十卜月二
𩚔	人又巛竹
炲	米人巛言口
𫆴	之寸之目月
𦽰	十卜又儿又
𫈅	十卜人人口
𠽓	口一言人口
𤉒	米人斤月
𢹿	寸添二口米
𤠱	月竹二巛竹
㩹	寸添曲之目
𧿺	口卜巛曲巛
𪹘	米人人人竹
㵒	添添乙川目
𤠆	月竹言儿口
𩨼	目之斤二
𥌬	目一广人二
𣻁	添添斤一十
𨄹	口卜之竹口
𦞹	月一大七寸
𣌒	曲一儿米寸
𡭜	又寸曲人
䳂	乙寸口一儿
𫰣	巛竹二曲巛
𬔦	言米添寸月
𨨨	斤一人一卜
𨉞	川三二人儿
𥈿	目一二卜目
𨢼	梄寸川人儿
𬦳	口卜斤月
𠿃	口一巛十梄
𫨎	大大人竹七
𪅥	川卜儿卜儿
𬕨	竹言言又月
捹	寸添大十十
𥗩	大一梄月竹
𫼢	寸添大大卜
𥱲	竹言卜七言
𩜪	人又大寸二
𪷰	添添言乙口
𤵶	广一卜寸乙
𫦨	米梄乙竹
𩨜	目之乙曲
𤑸	米人七竹目
𬏽	广一目曲目
𢵶	寸添斤一巛
𧼍	二人又二米
𫗹	米一川之月
𡋀	二一二曲巛
𪖠	川目曲乙口
雴	梄添言米
𬈼	添添川之川
泍	添添梄一一
嚋	口一二口寸
𬧕	口卜儿乙竹
𫤁	川添曲十目
𠶓	口一三卜儿
𡑰	二一口口儿
𤂩	添添竹儿二
𩸷	儿一大一十
𫡲	二卜又一卜
𣔦	梄一大二二
𩄳	梄添言米言
𪩵	人卜言一目
𤉖	米人梄曲
𧛆	之广曲添曲
𥈲	目一儿又之
𥻼	米梄儿川
𧃵	十卜十口米
𨃓	口卜十人梄
𦟐	月一三米
𫡦	人寸斤三月
𠺥	乙寸口之又
𢬢	寸添口一目
㨲	寸添十之梄
𥶃	竹言十之儿
𤽀	川曲又乙
𠴼	口一七二曲
𬴟	言一口又二
𨩖	斤一十人之
𬩌	之一曲口目
炶	米人卜寸口
𦞣	月一又言口
𨭍	斤一曲三之
𦼔	十卜一曲曲
笀	竹言言七
𠸫	口一三一大
𢅧	目卜巛川目
𤘓	七卜之目一
咹	口一之寸巛
𥓴	大一言乙竹
𫖦	川寸大目口
𱔂	口一言儿曲
𤺵	广一口言曲
𥶰	竹言又目曲
𡄀	口一口十巛
𦟾	月一七口口
𠁵	口口曲一人
𬏊	曲卜言添又
𥪞	言米曲目人
𦝌	月一添二巛
𬹰	川目曲言口
𫏻	米梄巛竹梄
𠵩	口一曲卜梄
𥒃	大一二二乙
揌	寸添曲卜之
𫧧	之一梄竹十
𫋟	口巛七又目
𥺒	米梄曲二一
𡀢	口一目目口
𠶠	口一添巛口
𢰺	寸添儿目人
𣙸	竹一梄巛巛
𠻽	口一梄竹巛
𫇍	川目大斤曲
𣠖	二寸梄言二
𠿰	口一人竹乙
𦜞	月一人十人
𪸝	米人口一乙
𣈔	曲一广卜口
𦟊	月一梄寸乙
𣾻	添添口一二
𢶺	寸添之儿川
𤳇	梄一人曲乙
𥪅	言米口一儿
𪽮	广一卜寸又
𧶯	儿添目十人
𱤪	梄一竹川言
𦀽	巛一竹二口
𢬭	寸添言人寸
𫧟	米二乙二
𠝗	乙寸米曲一
𪣽	又言二之乙
𢆘	竹一十口儿
𨅇	口一言十口
𪵸	添添二一乙
𣛯	梄一广儿目
𢜞	米卜梄人人
䣷	梄寸竹一梄
𬄱	梄一十又目
𫠺	卜一又人之
𪭚	之竹曲人二
眜	目一一添梄
𦲿	十卜目十巛
𬹯	川目曲十人
𢇱	广大人一一
𡊳	二一竹三
𱏃	川添言又月
𣷭	添添人卜又
𪧱	之寸十二口
𥺔	口一儿人米
𬩉	之一梄乙川
𤙮	竹二二一米
𫆝	月一又寸竹
𫾐	寸添大梄卜
𫏍	口卜乙乙竹
𪇏	三寸曲曲儿
𤞐	月竹大卜乙
𫯝	卜一一添大
𨱾	三七大寸乙
𤄭	添添曲卜大
𤃤	添添之二一
𪜒	乙七二二口
𫑆	之一十言又
𠀖	十一言添
𨦭	斤一之寸竹
𣘃	梄一十巛人
𨮉	斤一又口米
𫷇	川目口言目
𥬨	竹言斤二
𢈖	广大一目二
𤋷	米人三一大
𬎷	目曲十巛竹
釯	斤一言七
𪣮	二一添又儿
磮	大一目目十
𦰦	十卜乙乙竹
𥊥	目一乙儿川
𪩱	乙曲又梄目
㖡	口一言儿言
𬗵	巛一二米月
𠺨	口一三十之
𧹼	二一米二乙
鮋	儿一曲二
𪽯	广一乙卜曲
𫢖	川添乙儿卜
𥆁	目一一儿曲
樳	梄一又口寸
鴼	儿巛儿卜口
𥽍	米梄梄梄二
汿	添添又又卜
𦎍	米三言寸
𫲴	乙一十梄目
𬅧	广寸儿人目
𤷖	广一二人儿
𤌀	米人儿又之
𠻋	口一十竹月
𪮻	寸添梄斤曲
𦄆	巛一二曲二
𡭧	巛曲巛卜曲
𦲼	十卜巛竹大
𨥿	斤一二卜一
𣼍	添添目目十
𬨳	之一梄巛乙
𨄸	口卜曲寸斤
𫪄	口一曲又二
繮	巛一三曲曲
𠺿	口一大川曲
𬧜	口卜七之三
𤹒	广大之二巛
𣗾	人寸一竹梄
𪿣	大一乙二乙
𬏝	广一卜寸又
𩹫	儿一口一三
𣡹	梄一广一之
𤁓	添添三十巛
𢭱	寸添川曲一
𬲇	人寸一月二
艔	斤乙广十又
𩄎	梄添又竹目
𫲼	之寸乙添人
𥄯	目一人言又
𥍎	目一曲巛大
𫽶	寸添乙曲一
𤍆	米人梄曲一
𬥪	二二口又目
𠑢	川添十二巛
𤊬	米人曲三
𡮳	目曲目曲竹
𤢈	月竹又口米
𩂏	梄添十寸又
𫮲	二一十大二
𣭯	竹七大寸乙
𣵶	添添口一儿
𣼭	添添二一川
𨨷	斤一之人大
𥳉	竹言二竹乙
厛	大大口一斤
𧒋	口巛曲竹目
𤿭	又卜梄二
𬇒	竹乙大川曲
𤇨	米人大卜一
𦡥	月一添乙广
𬌔	川又之巛
𫅩	乙广乙曲人
吿	竹二口一
𫘿	三七斤又口
𪞍	米一又一口
𪟶	米二曲目口
𬔕	之人七巛儿
𡮾	之一二一曲
䊼	巛一卜卜
𨅹	口卜十十月
𤑫	米人十儿三
𦰤	十卜之寸竹
𩫛	言一口人十
𫥖	广寸人儿卜
𫈺	十卜梄巛人
𢈱	广大竹梄曲
𥏋	竹二儿寸竹
𪨃	曲人寸人十
𧟀	之广口一七
䋦	巛一竹一巛
劸	二一二一乙
𢹉	寸添竹竹大
𦼜	十卜二儿曲
𱕔	口一七口之
𡏤	二一之米巛
𱻥	之竹乙巛儿
𪸄	添添七儿卜
𫡠	儿添言目目
𩷹	儿一卜曲十
𠴖	口一川添言
𢴏	寸添添竹二
𬩀	之一大口口
𫪎	口一米又大
𢶟	竹寸目目川
𣗌	梄一之一米
𡭉	米二川三寸
𪣰	二一目十巛
𢢋	米卜目竹斤
埩	二一儿添又
祱	二曲米口儿
𬕓	竹言竹曲竹
𫸋	广大十竹卜
曥	曲一卜曲目
恜	米卜七言二
𢬤	寸添七添三
㤡	米卜一儿曲
𡥴	乙一川曲二
𫒨	斤一二一曲
𰴂	之广巛大斤
𥵛	竹言曲曲大
𧯶	目目一一口
𫷓	曲人之目十
𠲤	口一添添巛
𠹼	口一之寸言
𫅠	米三大巛梄
鎇	斤一又竹目
𧍎	口巛儿七曲
𦹰	十卜川人儿
𠍭	川添言乙人
𨤻	一添人曲二
𬙚	目曲十一巛
𫵈	又寸之巛曲
𪪆	一添米又之
𠬖	二一巛之梄
𧎷	口巛儿儿巛
𬞨	十卜米卜曲
𠷤	口一月儿乙
蓃	十卜川卜又
𠺻	口一巛乙人
𣖛	言一人一梄
𠜯	竹二口一曲
𩬪	三七斤竹之
𤇤	米人二卜一
𧚢	之广言口儿
𬥓	目人米二
𬎵	竹三又寸竹
𦡟	广卜儿人儿
𪟆	言一巛月曲
𩺪	儿一斤乙月
𪟙	又人乙竹
𬏑	曲卜言米曲
𪮒	竹寸竹寸目
㳥	添添三一十
𬕩	竹言寸曲十
𡒪	人寸人人目
𠇕	川添乙曲
𪪄	一添米言之
𤊢	米人曲一寸
𪱁	曲一儿曲二
𢀱	七添又儿竹
𫫥	口一添之二
𫮦	二一曲三之
𡼹	目目梄人儿
𣏒	梄一月口
𤠃	月竹一二乙
𠜮	竹一巛乙曲
𤻳	广一大大大
𩺦	儿一大七口
𤏬	米人人口曲
𫱅	巛竹一一口
𬜑	斤乙乙竹
𬟗	十卜卜米巛
𡬼	目寸米曲寸
𨬋	斤一曲口儿
𢗽	米卜儿儿儿
𬴝	言一口二一
𫄉	巛一口儿口
𪂠	曲卜梄一儿
𪶛	梄一目一曲
𫏈	口卜曲人一
𬡬	之广竹二乙
唹	口一言人广
𥾋	巛一乙添竹
𨎞	梄曲三乙竹
捛	寸添口一口
𢝛	米卜三乙大
𣋜	曲一梄梄二
𫮡	二一添米米
𢺝	寸添十人目
𣠶	竹一梄二目
𧌎	口巛目十人
𬃤	梄一川卜一
𨂗	口卜乙一斤
𫭐	口寸口口口
𫘖	巛一儿七三
椊	梄一言人十
𬞮	十卜之儿卜
𣕬	梄一三卜巛
𬚊	二竹儿儿又
𧍐	口巛言儿曲
𡮇	言一人十曲
𣥱	卜卜一口人
𪝬	川添大人十
𠶡	口一大一十
𠇼	川添竹米寸
𡀲	口一言巛人
𠱜	口一大卜乙
𥭏	竹言巛言竹
暏	曲一二竹
𬈈	添添二一卜
𡓠	二一斤十曲
𨁦	口卜三一十
㷝	米人之人大
𨯸	斤一竹月大
㳶	添添斤乙巛
𬗀	米梄一口大
𦄣	巛一言人口
𦮴	十卜竹一十
𧄈	十卜巛曲曲
𢯦	寸添梄人人
𨨠	斤一儿乙米
𠟲	川目斤一曲
𫤾	广寸乙七
𢠿	米卜斤米
𨤧	曲卜二儿曲
𲄱	川三七口口
㓟	又卜曲寸
𢶂	寸添之之梄
𥖖	大一又寸乙
𪞼	言一人广儿
𩩿	目之言米曲
𤲂	曲卜人一卜
𥍖	目一七目目
𢫄	寸添梄一巛
𪇫	儿巛川广十
𪲂	梄一曲一乙
𫯗	儿言儿口月
𨸈	又寸米三大
𧞊	之广儿乙竹
𩓛	又竹乙口大
𠶦	口一广大曲
𡂮	口一三目巛
𢴿	寸添十十月
𬖾	米梄又卜大
𬈿	添添之目一
𤼕	广一三曲七
𢀨	七添又又乙
𬡢	之广川人大
𠶢	口一添添曲
𫴮	曲一一川二
𠑋	人寸人三十
𪬤	川目之之竹
𪿐	竹大梄月曲
𣠳	又言又人言
𡂂	口一言又口
莯	十卜添添梄
檊	梄一十人一
𥡗	竹梄三米
𪫦	米卜大寸二
𫶺	十寸十大乙
𦷮	十卜米又口
𡓁	二一目儿儿
𬛑	月一川七儿
銙	斤一大一一
𨅄	口卜梄曲儿
𩆴	梄添卜曲目
𬈎	添添竹广十
𭉆	口一米卜又
𠶋	口一十人川
𫃒	米梄十十巛
𨆿	口卜又儿口
𫯙	儿言儿曲人
𣵴	添添口言又
𪭀	言十曲言之
𨡼	梄寸曲又目
𩻺	儿一曲三之
𠽋	口一七大口
𫤋	言寸二一乙
𢂎	目卜曲二
𫜍	广又儿卜口
𠱍	口一月竹乙
𤒘	米人竹言三
𫗀	月寸二竹巛
𬌖	十卜川梄川
𥘂	大一言巛竹
洃	添添大寸米
伩	川添言人
𥬊	竹言斤寸
𪺃	米人儿口二
𬕫	竹言曲竹目
𫿐	乙乙竹之斤
𤂭	添添梄人十
𬋗	米人儿十目
𣳔	添添月二
𢪭	寸添竹添二
𨦽	斤一言人口
𡅒	口一寸之儿
𡓂	二一又米乙
𢩽	寸添乙二
𢢁	米卜又乙乙
𫃼	巛一米广十
㨔	寸添七一口
𤉗	米人二竹乙
𤶽	广一十之乙
厙	大大梄曲
𡄭	口一人卜三
𬛗	月一又寸之
𫕡	梄添广卜儿
𫨅	大大一添川
𪤷	儿言目卜
𤹽	广一言目人
𢬐	寸添月乙曲
𠥤	七添十口梄
𬪁	儿竹言口乙
㲸	添添乙七
𡅋	口一梄竹目
𠳚	口一乙乙竹
𦟜	月一三卜目
𫌕	之广大梄卜
𡙧	大寸乙十言
𨄻	口卜之曲人
𫎚	目曲目儿卜
𣄬	言一米竹卜
𡀬	口一大人十
𢠥	米卜十竹乙
𢥈	米卜卜曲目
𫽠	寸添斤添曲
𦵜	十卜添添梄
𠠉	又卜大人曲
𬚱	目寸人人竹
𧔜	口巛梄斤曲
𠓐	曲人一之梄
𩘣	月卜三卜巛
𥑠	大一十二
𪱜	巛言口一月
𦃯	巛一曲卜又
菻	十卜梄一梄
𦁻	巛一川曲二
𠄩	巛言口一二
伮	川添巛竹又
𫽟	寸添月乙口
𡦮	乙一十口米
𦅮	巛一人人十
𨈒	川三卜寸
𡶁	目目一添巛
𠫆	大大曲巛口
𪳨	之之人曲梄
𬨱	之一乙口目
𲉯	言人川目米
㯝	梄一口儿口
𪇪	寸添言口儿
𪫆	添添又二
𪜛	斤添乙大目
㗕	口一十目二
𪶟	添添月竹人
𫶮	二卜十二巛
𣔝	梄一之一巛
𨆂	口卜一曲一
𠰃	口一竹添二
𠗤	广寸人言三
𠙅	月寸言米
𧌂	口巛卜卜曲
𠁄	人寸一一卜
𡑳	二一又口米
𦜘	月一斤乙巛
𠸣	口一巛一二
𢭿	寸添添一目
𡼇	目目川人儿
𫫫	口一一之儿
𢙩	米卜三卜梄
𪯫	广寸十寸斤
𦙣	月一梄一
𪡯	口一目人又
䚂	二一米人目
葻	十卜月卜
𤴵	广一七言
𥵕	竹言曲口米
𬕰	竹言竹儿口
𪪻	乙巛一目人
𤎶	米人斤米
𨗛	之一十十月
𪒳	目曲二川曲
𣛧	梄一梄梄梄
啩	口一二二卜
哬	口一川一口
𩖫	月卜言乙
𡥙	乙一乙寸口
𠼖	口一梄梄巛
𤠂	月竹十巛口
𨇛	口卜二竹目
𩝇	人又十二梄
䁠	目一米曲人
𪦍	言七巛曲一
𦝋	月一又寸
𥱯	竹言曲二寸
𬗢	巛一目十巛
𢺎	寸添月人巛
𥈺	目一斤卜曲
𡳥	又竹大人十
𠶌	口一之一斤
㮧	梄一儿川
𬖉	竹言言月三
𧋍	口巛寸添斤
𥽵	米梄巛二一
䐠	月一十言川
𠁹	口口川卜人
𣫷	竹一巛乙米
𥉮	目一米巛月
𫹰	之巛又寸
𠅜	言一川儿曲
𥞵	竹梄大人人
𤮄	一巛一米一
𨄽	口卜乙儿川
𥭵	竹言乙二乙
𪢃	口一言人儿
𪵧	竹乙三乙竹
𧒇	口巛月竹二
𫗄	月寸二曲之
𠯾	口一川添月
𪠭	斤寸又乙目
𫥿	言一人人乙
𠲣	口一竹添目
𢤠	米卜二二梄
𢣇	米卜言曲儿
𬇓	竹乙之二米
𣎖	月一二米月
𫅮	乙广乙言曲
𦒵	二竹儿儿口
𡖡	卜寸口儿儿
𢱨	寸添言人巛
𣖜	梄一曲卜月
㮔	梄一竹曲二
𣉳	曲一目二巛
𢹦	寸添人人儿
𫏪	川三口巛
𡚄	大寸卜十七
𫵨	又竹米目曲
㴥	添添目曲月
𥆺	目一梄寸
𪪏	广大卜寸又
𥯇	竹言斤乙巛
𧳇	斤月人一口
𦢢	人寸人又七
𢫅	寸添竹七七
𤾷	川曲寸曲米
𤭶	儿乙人月一
𬍆	月竹二竹言
𥉭	目一寸斤口
𡦅	乙一儿儿巛
𫲃	巛竹言口二
𣄥	言一米川又
𣔤	梄一川口人
𠖤	之之一曲之
𥢅	竹梄巛卜目
𤀞	添添十卜二
𡏧	二一川言口
耚	三卜梄一又
㝵	曲一一添寸
𩦓	三米又一十
𡨌	之寸寸言口
𨃶	口卜梄儿口
𥓅	大一口一口
𢸡	寸添卜人
𫐴	之一大月人
𠼿	口一言口之
拁	寸添乙竹口
䱚	儿一又二曲
籚	竹言卜曲目
鮽	儿一人寸竹
𠁟	米一曲曲人
𧀞	十卜曲口人
𪅴	二巛之巛儿
㦡	米卜川巛梄
𥹯	米梄三卜梄
𧫼	言寸广梄梄
𡌡	二一米乙川
𬒊	大一人二巛
𪯾	言乙口一目
𠞟	言一口口曲
𠆳	人寸卜一
𠻇	口一梄曲竹
𧤂	二一人儿月
𧜙	之广二卜目
𦤠	川目大大米
𠯦	口一七寸乙
𬫀	曲卜二二二
𣿌	添添之人巛
𫺱	川目之卜又
𠟹	乙寸又卜大
𠖈	之之一一卜
𧑅	口巛二七巛
𫧂	竹二口儿言
䀨	目一竹卜
𤴥	广一乙七
𣐄	梄一口口
𢟹	米卜大七寸
𧰦	乙七大月
𫑑	之一目竹十
㨴	寸添十竹乙
𢢊	米卜乙米大
𢷃	寸添又言目
𥱴	竹言寸添梄
𥸍	竹言又曲一
𡙵	大寸目一又
𥺐	米梄口一斤
𬑉	一添梄一目
𤢇	月竹竹又二
𫔹	又寸言曲目
𢭗	寸添言添又
𤴬	广一乙寸
𨦦	斤一之一寸
𫇊	川目之寸乙
𨁲	口卜口一乙
浽	添添斤添巛
噽	二二口大一
𢘾	米卜巛竹口
𱿈	又竹曲卜曲
𢷴	寸添七一目
𩆍	梄添添十巛
𤯩	三一十卜竹
𤞽	月竹十卜言
㨘	寸添曲竹目
𣔧	梄一巛竹大
𬕷	竹言人曲之
𡂹	口一之斤曲
𣋻	曲一十七言
𦞎	月一言竹斤
𥶁	竹言言梄口
磢	大一大人人
𤔾	十卜之大斤
𫘑	三米米三大
𨃽	口卜大七寸
𥼲	米梄又三竹
𠵚	口一目大一
𢅆	目卜十曲月
𥗜	大一口一七
𡞗	巛竹三人二
𪡽	口一曲人二
𣉕	曲一又又梄
𨄾	口卜之一口
𢷰	寸添梄巛二
𢲢	寸添乙人竹
𡄮	口一斤梄目
㖣	口一言米口
𤮑	一巛曲三之
懓	米卜斤之儿
𤇌	米人十寸口
𡈩	口寸言曲二
𠠭	之广乙儿曲
𪩜	目目人人川
㦉	米卜二口米
𬏩	广一曲竹乙
𣞪	梄一目米二
𪥀	广大言儿儿
𣻀	添添巛目人
𤹓	广一又口乙
𩢦	三米儿卜广
𧊉	口巛竹添之
𡃌	口一大川儿
𠊜	川添巛竹大
𪝅	川添梄一竹
𢵹	寸添广竹巛
𪮞	寸添竹竹人
𤺳	广一又曲竹
𬙽	米三米人之
𫑱	言添又十月
𬧘	口卜米之梄
𨪀	斤一十二梄
𫇡	斤乙十梄目
𱑮	之广梄二巛
㖸	口一卜七一
𨒺	之一曲人一
𣟩	梄一竹月大
𫳹	之寸之目一
𡝔	二一巛乙巛
𬃪	梄一言一口
𢋠	言一米儿言
𥄭	目一竹一十
𡎛	二一人乙目
𡳪	又竹竹二川
𪓇	目曲二人大
𩇍	梄添三曲巛
𫬪	言人口儿十
䗲	口巛米儿十
𡓔	二一广口竹
𫃵	巛一米梄巛
𫢠	川添十卜又
𢳁	广大曲三竹
𥷺	竹言言曲大
𨉑	川三口一三
𪳋	梄一一又之
𬜕	斤乙月竹月
沲	添添竹一乙
䕯	十卜梄二斤
𦄈	巛一斤一曲
𠲜	口一斤添又
𣙧	梄一目一又
𪽠	川曲添儿曲
𢴎	寸添月口儿
𪭘	之竹七添又
𪀅	斤言儿巛
𣦮	言一人一曲
𥗐	大一大大大
𬗲	巛一川儿斤
𢚼	米卜目乙人
𤢽	月竹斤斤目
𪶎	添添寸乙口
𡳺	又竹竹川川
𢤫	米卜川人二
𥿺	巛一言七巛
𬊐	卜寸又大米
呌	口一广寸十
𪅦	儿巛口口一
䈒	竹言十目米
𪲇	梄一曲曲
𤻽	广一卜人
𬊬	米人卜口米
𥟼	竹梄十卜大
姂	巛竹竹添之
抷	寸添大卜一
𨀎	口卜言米
𢺍	寸添十人巛
𪵰	添添乙巛卜
𡃔	口一寸曲曲
𪆥	儿巛之竹口
𬦋	二人曲添言
𬲂	月寸二月曲
𤬀	斤言人寸竹
𡃒	口一寸曲米
𫀵	竹梄之卜巛
𢲱	竹寸十目二
挕	寸添三十
𫔬	一添乙竹又
𣅗	曲一乙乙
𣻂	添添寸斤口
𥋽	目一目曲十
𢲩	寸添巛乙人
𧒊	口巛竹口曲
𨐷	言十言竹卜
𣻕	添添广梄梄
𧘇	儿之
𫭻	二一乙乙之
𢹌	寸添之曲竹
𠼽	口一斤添目
𬑫	目一一曲一
𫹄	又卜又二
𬩛	言人寸之大
𩷳	儿一又竹竹
𤃡	添添儿竹大
𫕲	梄添之月曲
𤷵	广一二一又
𦞢	月一口寸大
𠸢	口一一口曲
𧸰	目人梄巛二
𡮲	曲人言二寸
𡳀	又竹竹大乙
𨄊	口卜儿又二
𪿽	大一竹目十
𢰳	寸添梄口巛
𱚹	又竹言添目
𫕨	梄添巛大斤
𤷍	广一十三
𡂯	言人口又月
𪬼	人一乙又目
𢂌	目卜川添七
𨘱	之一梄儿又
尙	曲人目寸口
𢺀	寸添言曲大
䘹	之广言人十
𤠚	月竹三卜巛
𦄶	巛一口人川
𠻵	口一十大十
𠹗	口一寸斤口
嘑	口一卜米寸
𬔒	之人添人梄
𥓶	大一儿卜曲
𣼬	添添曲寸斤
疿	广一乙巛川
𥔧	大一竹曲二
𬫤	斤一目十巛
𫻅	米卜川乙人
𤶎	广一竹一梄
𤉔	米人川竹卜
𬍏	言一巛一卜
𡂡	口一曲巛竹
胒	月一又竹儿
𫼻	寸添川添川
𢫆	寸添梄一一
㙮	二一竹一口
𨥧	斤一竹添之
𣇫	曲一曲卜梄
堛	二一一口曲
𫘴	目之又竹七
𩠱	米一川竹乙
𧀜	十卜米斤川
𥢂	竹梄广梄梄
𢳞	寸添三目二
𬓓	二曲巛梄又
𠀴	巛曲巛一卜
𬠄	口巛口寸目
𣦍	之寸目一卜
𩐛	言米曲一一
𠲦	口一七竹大
𥽩	米梄之曲竹
𡋃	二一三卜梄
𣞄	一添梄目曲
𠧍	梄添大竹十
𫇂	又竹七人巛
㹠	月竹一添巛
𫂮	竹言十言乙
𣵰	添添言人口
𪤾	儿言十十月
𩄐	梄添乙儿十
𫵃	曲人又二又
𤍶	米人曲卜巛
𦵚	十卜巛又之
𧍉	口巛广儿言
𠋥	川添又竹目
𠶄	口一乙一口
䅘	竹梄梄人人
𬎳	竹三梄一
𥐐	竹大一人口
𨁰	口卜口一儿
𠾼	口一巛儿乙
𤑯	米人人人曲
𠿒	口一曲巛儿
𠦿	竹梄儿竹十
𨗵	之一竹二米
䃣	大一斤米
㤝	米卜言巛儿
粡	米梄目一口
𬢞	言寸儿添卜
𫵛	又竹言广寸
𡓎	二一人口十
𦧷	竹卜广曲人
𩙳	人寸之乙广
𦬑	十卜巛竹
𨁨	口卜月竹三
𡛔	巛竹一卜巛
𠄦	二寸乙添人
𨇷	口卜竹巛川
𥫟	竹言乙乙
䘆	口巛之目之
𬹷	卜人之一寸
𡁼	口一添梄二
𨁯	口卜二一米
𣌝	曲一曲口十
㦆	米卜卜米寸
𠐞	川添大大大
忇	米卜乙竹
𪷞	添添十又目
䤵	斤一曲三
𣡙	曲卜梄儿目
𨙖	之一又添十
𡫡	之寸竹又口
𪡗	口一斤寸儿
𠝫	米三大寸曲
衴	之广之之儿
𢆕	一添米斤又
𠀫	十三竹添
𠝔	巛竹巛口乙
𠶈	口一之广二
䕱	十卜一米大
𠹾	斤添之乙口
𤉛	米人人人二
𪄌	二卜目人儿
𩼁	儿一二竹乙
搩	寸添儿十梄
𫺒	米卜又寸曲
𪩥	七添又言口
𢮑	寸添巛又曲
𤆷	米人川添儿
𧺕	二人儿乙言
𨀈	口卜广卜儿
𱓕	口一巛又乙
湈	添添十二梄
喡	口一又口十
𥊦	目一又儿乙
槯	梄一目目川
𣙺	梄一川人儿
𭋙	口一二巛曲
𣾃	添添七口一
𠛤	卜寸口一乙
𨇶	口卜之言竹
𨆞	口卜曲曲大
𠁪	竹添二二口
𤹔	广一言之言
𠗸	广寸二卜目
𤓆	米人十竹目
𫌗	之广言川寸
𪩮	乙曲二人儿
𦏒	米三大十曲
𠸗	之广乙十口
𠺶	口一巛目人
𪧡	十寸目之寸
𠫏	大大竹人十
𥓹	大一十竹人
𥊙	目一川人儿
𡑩	二一儿巛言
苝	十卜广卜儿
𡳹	又竹竹儿儿
𠲔	口一言曲
𧶫	目人三卜儿
𦽔	十卜梄梄二
𬬐	斤一竹二言
昛	曲一七添又
橊	梄一梄寸曲
𤷭	广一川儿言
喎	口一目口
𣑷	梄一曲人大
𤀙	添添口一儿
𫖼	月寸二一梄
𤾯	川曲添人人
𫽘	寸添梄口乙
𠚢	目曲巛巛巛
𨉓	川三人目人
𣒲	梄一之寸竹
𫆢	二一人儿月
𪛇	儿添之口口
𬁖	曲一竹之竹
槈	梄一大七寸
𦀌	巛一巛竹口
𤽵	川曲寸月乙
𦆚	巛一儿巛言
𪳌	梄一二目乙
𥆡	目一人又口
𡎞	二一卜寸目
𢵱	寸添又一十
𩸱	儿一斤一
𨼋	乙口卜七曲
𬂆	言添又儿卜
𠺽	口一人梄月
𬃈	梄一人人竹
𠱋	口一曲二
𢹧	寸添梄寸川
𫕾	目曲十目曲
𫶼	乙曲言梄口
䌑	巛一七又二
䕺	十卜曲三又
𩛷	人又大卜口
𫯍	儿言儿言一
𣨰	寸添竹儿儿
𥀪	又卜言巛川
𦨻	斤乙曲人一
𣀟	乙曲曲巛竹
𦆙	巛一梄添曲
𪨀	曲人巛曲巛
𬊨	米人巛又乙
𬔙	乙寸二寸言
睸	目一又竹目
𠊚	川添曲一寸
鯜	儿一言米巛
𨎟	梄曲曲儿口
𢥉	米卜十儿斤
㗶	口一又乙月
𡮹	曲人竹一大
𣠑	梄一竹儿三
揞	寸添言米曲
𧯄	竹梄曲人口
𡮛	曲人添曲二
𠟤	米三米口曲
𦲵	十卜人一卜
𫫞	竹卜人又之
搙	寸添大七寸
𩆬	梄添曲一大
𠶞	口一米卜竹
𡅠	口一巛一之
𥺓	米梄口一口
妸	巛竹一卜口
𨅸	口卜竹二寸
𠯼	口一川添一
𦘹	月一目目
𨮶	斤一添梄二
𧍏	口巛巛十口
𨦩	斤一言七巛
𧟁	之广三米十
䀡	目一卜寸口
𧚭	之广米一十
𤝹	月竹竹一梄
𠺸	口一添之又
𫤒	川添儿之梄
𩛂	人又巛竹又
𡃏	口一乙月二
𦟒	一添巛大乙
𩈂	曲三口曲之
𦄞	巛一又寸口
咘	口一大寸目
㧾	寸添儿斤之
𡂱	口一又米乙
𣜴	梄一人曲之
𤹖	广一梄曲一
𫸐	广大十之大
㩇	寸添又曲一
𨑻	之一之之儿
𦵘	十卜大目巛
𪢠	口一十梄目
𣘄	梄一言竹七
𪶼	添添曲二口
𥿠	巛一大寸目
𫅕	米三大大儿
㹦	月竹乙寸口
𢯰	寸添人又二
𠴊	口一口一口
𡛤	米二巛竹
𣿅	添添十曲二
𪘬	卜人大二二
𫅸	二竹儿曲人
𫥕	广寸人之十
𬞑	十卜口目米
𤍋	言寸竹乙米
𪄞	儿巛儿儿巛
𪟒	言乙竹竹曲
𫣪	川添之曲竹
𬅉	梄一十梄目
鮧	儿一大寸乙
喐	口一大月乙
𤎓	三卜月又米
𬹙	十寸目二米
𢲛	寸添人卜二
箻	竹言人又二
𤵡	广一竹米寸
𦖑	三十之寸目
𡗊	儿言儿二一
𦼠	十卜又一十
𬠥	口巛三十之
𬲢	人又二儿儿
𤊠	米人大一十
𣇞	曲一人寸竹
𢵧	寸添又寸曲
𤑈	米人人三竹
𥿤	巛一斤二
𫷝	一添米三月
啨	口一三卜月
𬨿	之一米二巛
𤾱	川曲之目一
𬄯	梄一十三大
𤇦	米人七大
𩓜	十卜言七大
杺	梄一之巛
𪜀	十寸巛添
𥖑	又竹竹大又
菷	十卜又之目
𡓅	二一十二巛
𥹞	米梄曲梄竹
鐱	斤一人人人
𤶻	广一目儿
𡎠	二一乙又目
𬒜	大一卜又目
𪬌	米卜曲又目
𫄺	竹一十竹二
㦃	米卜言竹竹
𡙦	儿乙巛巛大
𪨞	又竹米七目
絬	巛一竹卜
𣌺	曲曲口一巛
𡀨	口一之广梄
𢩭	寸添寸言
𡄥	口一人人儿
𬐂	又米一巛二
𨪝	斤一卜七言
𱤔	梄一十又又
𡚝	大寸目目川
𫁚	之人儿广十
𥾵	巛一斤寸又
𥵙	竹言目曲十
𤲌	三一十卜曲
𠰳	口一一目人
𪃲	儿巛二竹
𪧺	曲一一卜寸
𫸎	广大十三月
𫢋	川添一添大
𡌠	二一川儿言
𬌌	巛大斤梄曲
𫽰	寸添人口曲
䐥	月一人乙乙
𤵹	广一二二口
𡡇	巛竹米三目
𧀓	十卜又曲巛
𧓭	口巛巛川目
𪫢	米卜卜寸又
𢵸	寸添川卜梄
𪭄	米卜之口大
𡪦	之寸添添二
𬚿	目寸人又梄
𪺦	川又月十曲
𫦑	米三米言乙
𥋕	目一儿人目
𠝻	十三巛添曲
䁲	目一目曲目
𡎜	二一十目米
𣼫	添添曲又卜
𠓀	竹二儿儿口
㜮	巛竹七竹目
㦓	米卜儿大米
𨓡	之一三一十
𤠄	月竹斤一口
繏	巛一乙十人
𫔦	竹一十一十
𧾿	口卜又乙
𦁼	巛一梄一竹
𪮀	竹寸乙一一
𢤽	米卜川口人
𤎍	米人口口一
𫤕	川添儿梄二
㾄	广一曲二
𢢆	米卜米米口
𧑒	口巛言乙竹
𫏄	口卜十二
斍	言人目儿
𣑎	二寸曲一卜
𬘏	巛一米二一
𨅂	口卜大卜目
𪴽	大卜一曲竹
𨅷	口卜乙米大
樶	梄一曲三又
𢢇	米卜曲三又
𩩩	目之三卜儿
𨇸	口卜竹儿曲
𬆸	巛乙言口二
𡨸	之寸一之乙
𨆸	口卜大曲之
𠏦	川添儿之一
𤏫	米人竹又二
𣾸	添添寸一卜
𫸍	广大十曲十
𧉙	口巛一添巛
𬨺	之一梄曲卜
𨼼	乙口一乙巛
𪹏	米人米三大
㴷	添添三之儿
𥯓	竹言十三巛
𪰛	二一寸言曲
𫹭	乙添竹添之
柉	梄一竹添之
𪐢	目曲二米二
𣞾	梄一十曲巛
𫕸	三卜月儿卜
𢜡	米卜言米巛
𫩓	口一竹添月
𨫇	斤一月米大
𦹻	十卜添竹二
𢘽	米卜曲梄竹
𢶒	寸添人目曲
㤥	米卜言巛人
𢠯	米卜言又月
𡍜	二一又寸
𫃡	巛一言米
𨃌	口卜寸二寸
𡂄	口一又卜大
𣻽	添添月巛二
𤶹	广一又乙口
𦠱	月一竹川七
𩍓	十十言巛川
𡻖	目目口一目
唩	口一竹梄巛
𫦘	儿添目儿乙
𢗖	米卜竹添二
䋖	巛一又大二
𢙫	米卜口寸大
𥻙	米梄米三大
𫲬	乙添竹乙二
𥋼	目一人目巛
𥙒	二曲巛二巛
㗂	口一曲竹目
𠱇	口一之人
𪝩	川添米口目
𠅳	言七口一目
㘓	口一又梄目
𨧠	斤一月一一
𢞆	米卜言竹斤
𪮏	竹寸曲卜之
𥋔	目一目三竹
𪷧	添添又口米
𫭚	二一曲人
𬦹	口卜儿卜梄
𫆶	卜寸曲之月
𤇣	米人竹三
䁐	目一十目大
𦝬	月一之人大
𦞓	月一添斤儿
䰼	儿一人言又
𨮻	斤一广人二
𬍉	月竹儿人竹
𠿮	口一人又儿
𫭕	人寸一口目
𫛕	之人竹口儿
𠹵	口一曲之巛
𥛭	二曲巛川又
𧙼	之广大大卜
𣑺	梄一口巛
𥼕	米梄竹言言
𡡅	巛竹儿巛
㳝	添添川竹二
𡅩	口一曲儿乙
𢞂	米卜人乙目
𬨟	之一人一乙
𥽇	米梄七口之
栣	梄一川竹二
𩅛	梄添之儿三
𧁹	广大梄十口
𡂒	口一斤斤目
𪷗	添添月川十
𥆻	目一口一口
眪	目一一目人
𤊩	米人梄一梄
萻	十卜言米曲
𬂻	梄一又一十
𧿑	口卜七言
𬞁	十卜曲口儿
𡉾	二一之巛
𡹟	目目梄之儿
𠝓	川添儿儿曲
𪩼	目卜斤米
槶	梄一口口一
𬆘	一添儿之巛
𧙻	之广又大二
𢭼	寸添巛曲竹
䗔	口巛川又竹
𩸴	儿一竹大口
𤺰	广一斤一儿
𫰄	斤添巛一口
䐏	月一三人
𧥔	乙曲儿儿口
𪟚	儿言口一乙
𣛱	梄一之儿川
𨎆	儿乙巛巛梄
𠿈	口一竹米之
𠥈	七添二一儿
𫉱	十卜米言又
𢭭	寸添米人二
𢭂	寸添之寸竹
𥿡	巛一又竹儿
嘺	口一竹目口
藞	十卜大大大
𲌀	三米巛儿广
𫿟	寸添曲人竹
𡎟	二一竹梄曲
𪦼	乙一川儿言
𫣸	川添米曲二
𢁋	乙曲乙人儿
𪗀	川目曲巛儿
𫰤	巛竹米梄
𧒉	大大一寸口
𪟽	卜寸又乙
𢙬	米卜川添又
𪽐	竹添曲人川
𡁤	口一又儿口
𫃈	米梄川卜一
鋾	斤一儿十巛
𡮘	十二梄曲竹
㖻	口一又川梄
𬱶	月寸二巛乙
𧕬	口巛二口米
𠸤	口一人二寸
𡂈	口一川曲米
𪢈	斤寸一米巛
𱚫	曲人竹竹川
𤌋	米人川口
𢭬	寸添川添米
𦛽	月一口言又
𡃳	口一川口人
𬌣	竹二二儿卜
𠉟	川添梄一竹
𫽖	寸添乙口目
𡜤	巛竹二一乙
𥯝	竹言之人大
𢴕	寸添之目一
侱	川添口一三
𣢹	三卜梄一儿
𠀳	巛言人一卜
𫫹	一添大竹斤
𤔯	斤添竹又二
𣻉	添添十之目
𫆻	月一儿一一
𢫙	寸添川添七
𩼷	儿一曲米寸
𣷱	添添川口人
𢘬	米卜竹一乙
𡋿	二一口一口
𫶻	乙曲七竹目
𡀫	口一言口竹
𡀤	口一竹三寸
𡚚	大寸梄儿目
𫽅	寸添二乙言
𢵫	寸添米梄大
𢬅	寸添曲人大
𥫭	竹言巛竹
𬙾	米三大巛梄
𧸓	目人添添二
𡰏	一儿添口曲
煏	米人一口曲
𣛪	梄一斤三大
𤾓	一添川梄梄
𡵺	目目儿乙巛
𫸽	米寸乙大曲
𪓈	目曲二言乙
𠾺	口一米米口
𩘫	月卜添竹巛
𪧍	之寸一一卜
𪬮	米卜三口三
𦟹	月一目目十
䢦	之一言添十
𬛡	月一曲梄二
𠶉	口一川二月
𨅍	口卜又寸曲
趂	二人儿添曲
𡐮	二一斤米
𫧇	儿儿儿儿
𢪀	寸添卜寸乙
𩄏	梄添月卜
𬧾	梄添曲卜梄
𦟼	月一又寸竹
𧏷	口巛言巛曲
𪀚	儿巛七竹大
𤚆	竹二乙口又
抩	寸添目寸二
𫮢	二一之又月
𢮿	寸添竹广儿
𤉚	米人口一儿
𪮣	寸添十寸斤
𣋩	曲一言梄口
𨑗	之一卜一
𫲰	乙寸口竹巛
𫴐	之寸十广十
𣼳	添添二米月
𧀨	十卜巛人巛
𥍒	目一竹口之
𪞧	广寸人一儿
𡁚	口一添口二
𧒌	口巛口儿口
𪡊	口一斤月
䒜	十卜竹二
𪥌	川目人寸大
𠲓	口一儿卜十
𫠹	卜一巛儿儿
𬧺	梄曲儿儿巛
𠸙	十寸口三十
𬅽	添添卜又卜
㥥	米卜曲目巛
𣜳	梄一十卜月
𦀋	巛一广寸曲
㭨	梄一七卜乙
𱕷	口一儿口儿
𠸂	口一之人大
𠱊	口一川添二
𣳪	添添一口人
𬆜	一添儿人十
䊟	米梄十人人
𨁼	口卜大十十
𪧄	乙一斤目川
𢩾	寸添月口
𤤰	三一大寸目
槺	梄一广又添
𦵗	十卜言寸十
𬰹	言米曲一曲
㟴	目目川口
𥆹	目一目乙人
咾	口一二竹儿
𫥨	目曲大巛巛
𫺙	米卜曲一人
𬨸	之一乙又目
𠰷	口一卜寸又
𬄪	梄一巛十梄
𬮌	言人二卜又
𢬣	竹寸梄口
𨃰	口卜米曲人
𠞠	乙寸竹竹人
𩸰	儿一乙一斤
𢖱	米卜乙添竹
𫄑	巛一人斤巛
𫡇	人一乙寸口
﨤	之一乙添人
𡮩	又寸寸曲竹
𬃂	梄一梄二又
𧋶	口巛添添月
𦝺	月一米三大
鸜	目一目川儿
𨶛	又寸二卜目
𩭶	三七斤添曲
𫊶	口巛曲人一
𣮇	口一一大竹
𫣽	人寸一一十
𫢱	川添目十巛
𥯎	竹言广卜口
𠴗	口一梄一二
𤻬	广一言梄口
𫹣	人卜一曲曲
鍄	斤一言口曲
𦓿	三卜梄一十
𠍵	川添米言曲
𡾬	目目竹言三
𦢞	月一儿一曲
𫑐	之一梄之大
𤹾	广一曲竹巛
慃	米卜人乙乙
𤓇	米人三目儿
𫡾	言七米口月
𬳤	竹梄曲大口
𡪜	之寸添人梄
𩙕	曲一十曲月
𧞿	之广大竹卜
𠻛	口一之竹口
𬠌	口巛乙二乙
𪫚	添添二又二
㙤	二一卜米寸
𥄬	目一二卜又
𤉠	添添之儿米
𧤭	乙曲儿乙竹
𫩒	口一目卜
𥋲	目一广曲人
𨤔	又竹竹斤梄
𬥮	十一口乙目
𨙝	梄添曲之又
摪	寸添巛儿寸
㥬	米卜言之言
𤍑	米人巛儿广
𩸵	儿一人一卜
𨁮	口卜言人口
𠹰	口一目竹之
𥆿	目一一曲言
𪯝	十一月添梄
鈂	斤一之之儿
𫵫	又竹米儿儿
𨬉	斤一二一川
𢄩	目卜十之目
𬳖	米一川一乙
𫁎	之人二乙巛
𥈢	目一米三大
𨃺	口卜巛目人
𬷨	大七寸言儿
㩱	寸添斤又寸
𬨙	言十乙巛川
槩	又人七儿梄
𫽕	寸添言曲又
𠋦	川添十二梄
𬐒	乙曲又卜
𡾭	目目广口竹
𤵢	广一斤二
𢳥	寸添之竹口
𪡝	口一十人乙
𬋲	斤添乙人人
𫣏	川添言米曲
𠴒	口一川人之
𥟈	竹梄梄一口
𩺧	儿一米人七
𠪸	大大十巛梄
𣋇	曲一儿言寸
𪘌	卜人一口人
𬣌	言寸十梄儿
𣦆	大大卜口人
𦂁	巛一米寸大
𩸲	儿一川口人
𪰰	曲一二儿卜
𪟸	米二言之言
𢴾	寸添曲三之
錩	斤一曲一曲
𦡯	月一之二米
𡖼	米一曲儿儿
𠤧	儿儿寸一卜
𨒹	之一一添川
𧍅	川添一人口
抺	寸添二寸梄
𠺕	口一儿竹曲
𫒂	儿添曲曲二
𨰇	斤一人人儿
𫽹	寸添曲又二
𫜶	月一言乙竹
𠱶	口一之一寸
𫿿	人一人曲曲
𫠳	一添卜目十
𣱿	添添人寸
𫴭	又二寸言之
𤍌	二二又又米
𪲣	十二梄儿卜
𪿗	大一又竹儿
𬌱	月竹又寸竹
𧊋	口巛曲梄
𫻤	米卜言斤大
夣	言一巛之儿
㹫	月竹大寸乙
𧹥	二一米梄二
𬐾	十三巛儿目
𱻛	十三乙广乙
𫡪	十二梄一乙
𠵴	口一人口乙
𥐇	竹大一米又
𫼰	寸添巛竹口
𣷴	添添三卜儿
𥑃	大一言一卜
𦪏	斤乙之又月
𠶂	口一人人竹
𢱎	寸添竹一三
𢱔	寸添人乙目
𢏠	乙巛添添二
𫁞	言米儿添卜
𪱅	曲一添添二
㳉	添添月一
𬐉	曲人又二川
𱔪	口一言人川
𥅞	目一七言二
𫡮	之一米梄乙
㯖	梄一十一之
𨏧	卜七曲目梄
𡏥	二一寸斤口
𧐺	口巛之又月
𬥠	七言二乙人
𦀾	巛一广大梄
𨅥	口卜曲三之
𪨠	又竹米川米
𬌴	月竹又二米
𨆟	口卜十曲二
𦤮	之一又川大
𡔖	二一言巛竹
𪯊	巛卜竹儿卜
𬋙	米人川口人
𩸄	儿一曲卜梄
𦙏	月一目目乙
𨔾	之一二竹
𪀐	儿巛竹添之
𬀺	乙二曲儿斤
䑅	月一十之儿
𬩢	之一之十言
𠸡	口一添竹目
䕝	十卜竹目二
𧓮	三一川大口
𨃎	口卜曲又目
𨰴	斤一曲口十
𤃟	添添言川二
鑅	斤一米之梄
𤭸	又竹米十一
𬞲	十卜卜一一
𡔍	二一之目目
𪿏	竹大一目十
𫻐	二卜月口又
𫓟	斤一口口三
哣	口一一口米
𥃛	斤乙月言曲
捈	寸添人寸竹
𪾯	目一斤寸儿
𱢯	十卜十梄曲
𨤯	竹十曲一口
𬂸	梄一竹曲竹
𦡋	月一一巛大
𠃩	月乙人寸斤
𢭯	寸添添又大
𤻻	广一十七言
𥵚	竹言十三乙
𢜏	曲一月一之
㗁	口一口一一
𫑹	梄寸梄人人
拞	寸添斤二
𣍊	曲一儿言广
𠓁	曲人一言曲
𪢤	口一竹目口
𦂺	巛一言米曲
𪽗	又竹言曲巛
𫼜	竹寸卜寸口
𣼪	人一添一口
𨻮	乙口之一竹
𥌷	目一之目之
𪦸	乙一言一人
𣱶	添添卜寸
𧏰	口巛三之儿
𪥑	大寸二乙竹
𨃕	口卜言巛曲
𡮜	竹言竹大曲
𡃙	口一十七言
𦪻	斤乙之目言
𧓅	口巛曲曲大
𥸝	竹言言二目
𬸼	又竹儿儿广
𫋻	之广人二巛
𡅫	口一梄目口
𡳵	又竹米卜曲
𫀢	二曲目目川
𠽮	口一寸一卜
㨐	寸添川口梄
㘨	二一目寸人
𣙯	梄一二一川
䶞	卜人十三
漨	添添之儿三
𪷹	言米曲一口
𣙷	梄一十大十
𪺓	斤添又川一
扲	寸添人言又
𤸧	广一之二曲
𫅷	十卜人二儿
𫜧	卜人之目一
𤁖	添添之曲梄
𬱎	一卜大言口
𫒥	斤一言七之
𢵬	竹寸乙十人
𪰮	曲一竹目曲
𫀅	二曲卜寸口
𠉜	川添又竹竹
𨧣	斤一二之月
𡀧	口一广一儿
𤂫	添添口十目
𣆮	曲一广大二
𠽞	口一添儿儿
𣞅	曲卜梄米大
𨦙	斤一一儿曲
𢴛	寸添斤十又
𠏟	川添言口竹
𠻁	米三儿一口
𥇽	斤添乙巛目
㶤	米人儿言
𬏥	广一斤添乙
𢢂	米卜巛二口
𫽤	寸添米卜又
畱	梄寸曲卜
𤿤	竹言又卜
𦉱	目曲七寸
𥟊	竹梄二又口
𨂚	口卜米十人
𨰧	斤一之寸言
𪜘	大一又卜乙
燫	米人广曲人
𠘃	广寸竹二乙
𪯕	言乙竹竹卜
𣌁	曲一大月二
𣔢	梄一川儿儿
鸌	儿巛十川又
𢬇	寸添之寸寸
𨫉	斤一曲二寸
𪜯	川添口一乙
𦘧	又竹竹曲一
𫬎	竹卜言目巛
𱜗	口一口七又
𥩯	言米乙竹乙
𨄳	口卜十卜梄
𬇋	之竹儿七
𥊤	目一人一寸
𪱎	曲一竹月曲
𠽆	口一言目人
𬈉	添添二一口
㮠	梄一十之梄
𠶙	口一十卜大
𱕫	口一言川一
𥊢	十寸目目口
𠲠	口一巛卜竹
𭉷	口一二曲目
𣋛	曲一十儿口
𥗍	大一竹人曲
𤹑	广一川又之
㩒	寸添梄梄二
䓡	十卜竹大口
𧿭	口卜曲一
𪡻	十卜卜十口
𢴓	寸添大卜目
攑	寸添川人二
𠿶	口一添川十
𠴙	口一寸添乙
緓	巛一十目大
𫏖	口卜斤大又
𨭒	斤一月之二
㾑	广一人一口
𧀑	十卜竹曲二
𩲥	川口巛言口
䱾	儿一曲口巛
𢬹	寸添二二巛
𠸔	口一十言目
𢫛	寸添三一言
𦡮	月一米曲曲
𪁃	川添竹二儿
𨻬	乙口川目大
𣞍	梄一目曲二
𣃺	言乙人人口
𤒙	人寸斤月米
𦄷	巛一之又月
𪺬	竹二月乙曲
𧁶	十卜广人二
𡦂	之寸乙之乙
𧹋	川添七目斤
𫄁	巛一十曲月
𫉕	十卜人乙口
𬕺	竹言言儿卜
𲌬	川口曲三
𥺹	米梄之儿乙
𥹰	米梄巛儿言
聀	三十七竹
𢱚	寸添月卜
𠶣	口一梄一竹
𢝳	添添十人之
𠴋	口一寸月乙
𫇈	七一言人十
𫻣	米卜川人十
𡍘	二一竹目曲
𥨨	之人二二目
𥚥	二曲巛竹曲
𫴶	广大二二寸
𡀭	口一川曲乙
𫄃	巛一言乙竹
𩵝	儿一寸言竹
㦖	米卜又寸之
𣨮	一添儿竹二
𪫶	人寸言儿卜
𠳙	巛言口川七
𤮥	一巛七口儿
𦙦	月一之巛
𬗁	梄口米梄目
𣑶	梄一二曲巛
𢟙	米卜斤一十
𤊡	米人三人二
𥏌	竹大竹二儿
𤢔	月竹曲巛儿
唭	口一十三
𤛠	竹二曲口巛
𫃋	米梄斤一十
𤎕	米人斤梄之
𦀨	巛一乙二乙
𪝎	川添梄人之
𬚇	之竹乙又大
𡄐	口一言川二
𥉰	目一斤添川
𢴊	寸添之一大
𥒥	大一儿言儿
𩄰	梄添一曲米
𩼈	儿一川斤大
㖧	口一儿七曲
𡁽	口一梄人梄
𪡱	口一三梄竹
𡀩	口一十儿口
𥅲	目一竹一梄
𠦯	米二又人
𥭎	竹言添添言
𢩉	之竹十一人
𫨯	二一巛曲之
槹	梄一川添十
𤮘	儿言又米一
𦛌	月一又大二
𣖠	梄一十巛巛
𬌘	七卜目竹七
𢴩	寸添竹又二
䴈	川目米大儿
𢥣	米卜竹又月
𨫪	斤一十口二
𪢜	口一斤一梄
𡈈	口寸竹曲二
𣻇	添添之一又
𩩇	言一巛儿目
𣜶	梄一之人巛
𤎑	米人川人儿
𬷶	言一口竹儿
𫆜	目寸人又儿
𦛺	月一口乙曲
𥈱	目一乙又目
𬯜	乙口一目人
䳱	又言又乙儿
𫼳	寸添十卜言
𫤯	巛言大斤人
𫡯	十寸曲月乙
猉	月竹十三
𭉑	口一乙口又
榡	梄一三卜巛
鑨	斤一言卜
𠁸	口一口人十
𫲳	大寸卜口米
𦭪	十卜儿人巛
𡋥	二一二二口
𡃍	口一人人曲
𪃿	一卜口口儿
𫰮	巛竹十卜之
𤷿	广一之人大
𦪂	斤乙人卜二
𦀪	巛一川添川
𫅖	米三大寸口
𣠱	梄一竹儿曲
𬓐	二曲巛口之
𠭤	口一口斤又
𣉷	曲一儿二巛
𣝀	梄一十三乙
㦗	米卜梄梄二
𨭏	斤一月之二
𬜉	竹卜曲卜之
𱓱	十寸口之乙
𧐸	口巛月口斤
𬑑	目一二竹儿
𬇆	竹七二二一
𩠳	米一川梄川
𬮙	又寸一添乙
𤡚	月竹又七儿
𢵷	寸添之口曲
𫰸	巛竹一十儿
𠶚	口一巛一口
𡁙	口一米七儿
𫮱	十三二竹十
㑫	川添人又之
𪺛	人一人十巛
𪬙	米卜添口月
𬏧	广一寸添月
𬚴	目寸人七目
𡑱	二一又口米
𦢡	又竹七人月
𣠺	梄一竹人人
𫣰	川添曲大又
𬥔	斤寸目人儿
𨔿	之一大月十
𫬣	口一口曲竹
𠯇	口一乙乙
𠦹	十寸之一大
𠨪	儿添大二一
𣿃	添添乙目巛
𬲠	人又人曲之
𠸕	口一儿巛月
𫡽	言一人口口
𣵯	口一儿人曲
𥳂	竹言曲儿口
萫	十卜竹梄曲
𫸿	乙巛米竹之
𬉰	添添七曲大
𤯭	米一曲米竹
𫑓	之一竹儿口
𤣡	月竹目十目
𣼺	添添川人儿
𢯏	寸添人卜又
𫑒	之一梄言口
𩻐	儿一川人儿
𬠇	口巛添一人
𥵗	竹言言曲儿
𥘶	二曲巛人乙
𧕃	口巛儿儿言
𥆄	目一曲人一
𧎠	口巛儿巛月
𠀗	十一竹添
𪽃	竹三三人二
𠻤	口一之曲人
𢪯	寸添大寸言
炐	米人三卜
㡴	广大言米
𥯋	竹言曲一月
𦬶	十卜竹一十
𥑭	大一七添又
𥊟	又竹目言之
𣡯	目曲二七人
㩢	寸添十七言
𣝉	寸添曲米寸
𬲊	曲三之乙广
𢱛	寸添添添梄
𣙹	梄一口儿儿
熷	米人米目曲
堒	二一曲儿儿
𧉝	口巛一卜巛
𩆐	梄添言口竹
𬦮	口卜三十
𣏾	梄一七竹
𬀫	言人曲一
𠺴	口一十儿口
𦝉	月一广儿言
𪽡	乙曲斤梄曲
𦩚	斤乙梄一竹
㒙	川添巛川目
熑	米人米曲人
𧏴	口巛之竹乙
𪮯	寸添口儿卜
𫋙	口巛乙巛口
𢫗	竹寸川曲
𥐨	大一乙卜
𠿱	口一之米川
𪺵	竹二曲三之
𣞂	梄一竹之目
𧺁	之寸斤二米
𢯷	寸添又口十
𫢧	川添言人口
𩘄	月卜梄一竹
唫	口一斤一
𡊱	二一乙寸口
𣉴	曲一梄一七
𫊍	十卜十言又
𤂧	添添十儿三
𪂮	乙一斤言儿
𪞻	言一人巛大
𨔉	之一言人三
㵊	添添曲三又
𥋟	目一米竹七
𥖐	大一乙米大
𡃎	口一人梄大
踭	口卜儿添又
𡑴	二一又人月
𪨝	又竹竹竹曲
㐻	川添目寸人
𦧃	又竹米川川
𨔌	之一乙一斤
𬟥	梄一口添梄
𪮽	竹寸斤斤目
𩹪	儿一又竹目
𫵇	又竹目儿曲
𩠠	米一川二巛
㭲	梄一人人口
胋	月一卜寸口
𬏗	斤梄曲广儿
𡳎	又竹竹口口
𡆍	口一言竹儿
怑	米卜米二
𡬈	之寸言一卜
𢅄	目曲二大目
恑	米卜儿大乙
𬟴	口巛目目
𱔩	口一米一七
𪝯	川添言一寸
𠬕	二一巛之梄
恄	米卜二二口
𧜗	之广三米
𦤭	川目大曲米
𫆃	巛卜竹人三
𡀂	口一梄添曲
𬐼	添添儿巛乙
𬞺	米梄巛卜曲
𪟞	曲卜乙寸竹
𣈝	曲一言人三
𩆢	梄添曲言曲
𢏣	乙巛曲曲
𪽵	广一乙一斤
磾	大一口曲一
𠉞	人寸言又儿
𠽁	口一卜儿月
𡅑	口一曲巛大
𡆘	口一曲米大
𥢫	竹梄之口曲
𠴉	口一乙一一
𧃋	十卜人人竹
𠶁	口一曲一人
鈘	斤一十寸又
𡴢	一添巛米曲
𤢿	月竹大大大
𥽤	十寸又十人
㶥	米人一十
𫼠	竹寸言添三
𦙥	月一乙一巛
鑟	斤一二目目
𥢐	竹梄川添十
𩅜	梄添言又月
𨇀	口卜之一乙
𥀌	又卜十巛口
𬗝	巛一又言月
𬛀	之竹月一二
𫿸	人寸卜广十
𦄵	巛一斤梄之
𧦿	言寸一目人
𪬔	米卜一竹梄
𫨰	曲三之二巛
𦞑	月一大卜目
𫡱	又言又言二
𫾖	竹寸一口目
𧤥	儿添月卜言
𧀏	十卜斤巛儿
𠧆	米一十人十
𥷓	竹言人斤巛
𫳭	之寸言米曲
𥿣	巛一二卜一
𧋀	口巛添寸川
𠊫	川添儿曲乙
𤶼	广一十卜言
𫵄	十卜目大曲
𬒩	大一一之言
𡓟	二一梄一卜
𬷸	儿巛人斤巛
𥐦	大一乙乙
𥺖	米梄大卜口
𬡮	之广斤米
搝	寸添川目大
𬳠	竹梄米竹曲
𣌹	曲曲大卜一
𦁢	巛一三七
挸	寸添目儿
𬟣	十卜添乙目
㗱	口一川卜梄
𬁒	曲一又儿乙
𢴍	寸添之曲人
𢗸	米卜广寸十
𠲿	口一梄一口
𩂀	梄添一十
洅	添添一目二
䗀	口巛二人儿
爉	米人巛人巛
𢊑	广大十竹月
𣘽	梄一曲口儿
𦰠	十卜人巛十
𤵴	广一川添二
𢥶	米卜曲巛儿
𠻦	口一川人儿
𬓟	言一人儿儿
𱪁	添添十曲曲
𥏍	竹大儿言口
𬕾	竹言言曲目
𡭬	曲人又寸竹
𢯚	寸添斤乙巛
劕	斤寸斤目曲
𪇩	斤一又人儿
𨅽	口卜又寸梄
㾯	广一曲一儿
𫏽	言米曲梄梄
𪫊	一添十三二
𤜬	月竹目目
𬇉	儿七言添乙
捇	寸添二一米
㧶	寸添川三
𨓐	之一口一口
𫴇	之寸卜言曲
𤋾	米人言米曲
𠽙	口一川又又
𥈁	目一之一乙
𨀌	口卜口一乙
𫭵	二一米又卜
𣔨	梄一卜卜月
𪃴	儿巛斤一口
𤍊	米人三卜巛
𨅮	口卜二竹乙
𬊁	米人目寸二
𣜾	二寸梄添二
𢖮	乙七之巛竹
𡎣	二一曲乙口
𬁐	曲一月人竹
𣓋	梄一十儿儿
𦣕	月一梄二月
𫷆	目卜目米目
𠸟	口一大卜目
𫱑	巛竹大竹之
𱢱	曲一卜一一
𥅃	目一曲一一
𣌴	曲曲月一
僘	川添曲口竹
𣍀	曲曲口一梄
𧯵	一添口三二
𪽨	广一一添儿
𡄰	米三米人十
𦗏	三十言又乙
𨫈	斤一广人二
𠄧	乙曲二寸
𤃝	添添大竹曲
𢮪	寸添米十人
鎶	斤一一一口
𢇡	广大一添一
𫦻	曲卜乙儿川
𬎹	竹三月二口
𥸓	竹言寸三三
𪄦	儿巛十人梄
𦹴	十卜巛竹之
𥭌	竹言之竹七
𡂑	口一斤月目
𢵪	寸添曲三言
蚽	口巛大卜一
𣽀	添添一大川
𧋷	口巛乙乙之
𫕹	三卜月一竹
𪂲	乙一斤言儿
𬈽	添添斤米十
𧥃	儿添月米大
𣒵	梄一乙乙竹
𪷴	添添二月米
𫵧	又竹言三曲
𫄎	巛一又曲巛
擼	寸添儿一曲
𪝱	川添目儿卜
𧍌	口巛添乙口
𬞎	十卜曲口儿
𨏄	梄曲一二三
𢺒	寸添儿三二
𪢍	口一巛二口
𪝳	川添添口二
𤞻	月竹人又口
帒	川添七言目
𫅫	竹寸一乙乙
𦼞	十卜人竹曲
𪝌	川添十一曲
𫌌	之广目之二
𩌂	十十十巛口
𬮷	又寸曲人二
𡮒	竹梄乙巛曲
𦚕	月一十二
𠴛	口一之人乙
𨁭	口卜巛曲竹
𠸧	口一米儿口
𩘬	月卜之一又
𬕳	竹言三儿卜
𦄠	言寸目人巛
𡃻	口一十口米
𥟉	竹梄竹梄月
𡎥	儿言卜人二
𪒷	竹二广二米
𢪳	竹寸乙添人
𫖚	言米曲曲人
𥫌	言米大大大
𢴋	寸添巛儿广
𤺱	广一儿大米
𬅂	梄一十二之
𩪽	目之巛巛斤
惍	米卜斤一
𩸸	儿一一又巛
𨰪	斤一斤二米
𫋿	之广梄一竹
𤋶	米人十人之
𣗼	梄一口一目
𫗌	大寸十乙广
𫜈	竹一巛口人
𩄴	梄添川三二
𩺢	儿一寸斤口
𡆄	口一寸三三
𪭫	寸添一卜言
𡳃	又竹竹二巛
𦡢	月一十米巛
𨮒	斤一十之儿
𦷭	十卜梄二巛
𫱸	巛竹一三曲
𢀭	七添又十月
𪢌	口一又梄目
𬉪	添添乙言寸
𧵆	目人斤寸
𧖃	口巛卜一大
𤐠	米人二巛曲
𠶟	口一寸添曲
𨀒	口卜大寸目
𨠣	梄寸一添卜
𨐺	言十曲曲大
𠴌	口一又二米
𢛨	米卜言人广
撛	寸添米儿十
𫱞	巛竹言人川
𫡁	米一又米曲
𥻧	米梄米曲人
𪷪	添添一乙目
𦷫	十卜添竹巛
𪤘	巛言二十梄
𡍋	二一大十十
𪀄	卜寸口一儿
𫱬	巛竹十又竹
𤃥	添添十口米
𡂵	口一曲曲斤
𫵭	又竹米巛目
𡀿	口一又曲巛
𦴋	十卜目之又
𣅵	曲一之巛
𬖫	梄口米梄月
𥛉	二曲巛一三
𪵅	一添儿目十
𫋶	之广乙儿卜
𪪪	广大十三卜
𥍍	目一十竹目
𦙜	月一大大乙
𡗶	一添大寸卜
𡄦	口一七口口
𥺕	米梄寸添乙
𤡁	月竹十人人
𣘾	二寸曲之月
𩟬	人又大大大
𬰉	梄添曲卜又
𥕌	大一梄曲斤
𬊠	米人川二月
𢙕	米卜言曲
𩚦	人又七寸乙
𣓦	梄一添竹之
𢚴	米卜乙言之
𡒫	二一梄目二
𩮿	三七斤米月
槞	梄一言米曲
𬖅	竹言言乙乙
𤺮	广一之竹川
𨆡	口卜十巛梄
𦠽	月一斤米
𠽗	口一目一又
𱤎	梄一巛儿广
𤃞	添添目人人
𥇈	目一口一巛
𣊋	曲一一竹口
𡄏	口一米口之
𠵏	口一七一口
𤜭	月竹乙一
𣔟	梄一十卜大
𤴶	广一二二
𧍆	口巛乙一斤
𠠑	竹言又乙曲
𠸍	口一米三大
𤽴	川曲二竹乙
𬯹	梄添月又
𡡂	巛竹米言曲
𢱏	寸添言寸一
𧴋	斤月梄口二
𢴚	寸添七大口
𢟑	米卜梄曲一
𫴋	之寸言一卜
㭁	梄一乙添竹
䟻	口卜人寸竹
𪩺	又二之又大
𢗆	米卜一添人
𥓳	大一人卜又
𥰈	竹言川口三
𦞏	七大一人人
𤇧	米人川添二
𦋂	目曲曲一寸
𫷗	竹一十巛又
𩏳	又口口川川
𨵣	曲寸二人又
𩘨	之人人口月
𬥣	人一乙大乙
𫴺	梄一巛添曲
𥒅	大一一口人
𥇶	目一斤一
𣛤	曲卜梄人人
㗳	口一竹一口
𡑪	二一十人巛
𪅪	言一口乙儿
𬍀	月竹言儿十
烸	米人竹一巛
𧏲	口巛一曲米
𨅞	口卜竹一口
𧋄	口巛十一人
𧻩	二人二竹儿
𤞺	月竹竹二口
𥱱	竹言言卜口
𠰙	口一竹大曲
嘇	口一巛人斤
𦀚	巛一口竹二
鐛	斤一曲口曲
𦢾	月一目又卜
𫄼	竹一十十梄
𡀮	口一儿巛言
𢯨	寸添十一目
𱔒	口一言寸月
𥄵	目一梄一言
𱤒	一添梄曲大
𤅉	添添梄又月
擛	寸添十巛梄
𫇄	言一巛十儿
𩛸	人又竹一巛
𫯕	大七寸儿卜
𠃣	乙七曲人竹
𫇞	斤乙曲目又
𠗹	广寸一曲米
𪩯	乙二言大竹
𡮅	川二儿寸曲
𫵦	又竹十人广
𬠺	口巛米竹七
𫤉	川添儿口口
𣈕	曲一梄一竹
舖	人寸竹卜梄
𧋵	口巛月竹三
𣖡	梄一目人曲
𬑶	竹大一米又
𠃅	大大目曲目
𡝖	巛竹乙言之
𬛈	目寸人目米
𬨬	之一乙又儿
𠸨	口一川曲二
𱠻	寸添曲十儿
𣡤	梄一曲口十
扗	寸添二一
𪽣	之寸言曲曲
𦓇	二竹儿口口
𪵠	竹七巛目人
𨖧	竹七之梄口
𠳿	口一又竹竹
𢵋	寸添二竹乙
𠟸	言寸二口曲
𤞼	月竹言人口
𫯅	二二又又乙
𪩦	七添又梄梄
𫃫	巛一大一十
𬧐	口卜巛一曲
姅	巛竹米二
𣋼	曲一儿一曲
𥆃	目一巛竹口
𤀐	添添十之目
𪝹	川添之曲竹
𦅯	巛一竹二寸
𨗜	人寸之梄口
𢬩	寸添川添七
𤆺	米人乙一巛
𩽋	儿一曲巛竹
𡃜	口一大之川
𫲍	巛竹十大曲
𠾸	口一二乙口
𢗉	米卜目寸人
𪾟	目一一巛一
𠝇	广大儿乙曲
𢹤	寸添二儿巛
𧜵	之广十之目
𥌧	目一儿一曲
𫫒	口一又二曲
𫮐	二一米一川
𪲭	梄一言一一
𡮯	曲人竹竹口
𢪏	寸添曲一
𢖵	米卜巛竹
𠣛	儿乙巛言梄
𨡈	梄寸巛大二
𢤜	米卜米大乙
𪨈	大儿口一口
𣩸	大一言儿儿
𣼸	添添一川七
撴	寸添言乙竹
𧏱	口巛目大目
𠊙	川添之寸目
𢙽	竹一巛乙之
㨂	寸添梄一曲
𥄰	目一川添二
䲼	竹三儿巛
𧿬	口卜一添巛
𫫛	口一十卜梄
𢄝	川曲目儿乙
𡘮	一添梄竹人
𥾽	巛一言一卜
𱻢	言米曲乙乙
𱐩	竹一乙竹
萡	十卜添添川
𫰕	巛竹川乙竹
𪡎	口一乙人之
㭬	梄一大月
𪭡	寸添川添十
𪭱	寸添广又大
𧜹	之广月三月
𥐆	竹大一米米
𫥪	言一人一人
𢬮	寸添七大一
𡂆	口一梄儿曲
𨤼	竹十曲口十
𩻓	儿一十人竹
𠓨	儿乙乙二人
𫣱	川添之竹之
𪑑	目曲二言又
𣔣	口一梄三言
𠹲	口一添添二
𣌆	曲一言寸二
𫃮	巛一人言三
㘈	口一儿又卜
鈬	斤一又竹言
𦢶	月一竹竹大
𫠴	斤二人二巛
𬯽	梄添添巛乙
𥚄	二曲巛口人
𠋺	川添又言口
𨠳	梄寸言巛人
𫠪	巛言人一卜
𨻫	乙口言米曲
𠽍	口一添竹二
㥋	川添言儿之
𪠝	二一巛又儿
𬖼	米梄目卜又
𫫴	口一巛巛儿
𪩭	乙曲梄人人
䙛	之广言人巛
𡗄	米一又儿儿
𤋽	米人曲人川
𧁵	十卜寸十米
𧝦	大大卜曲言
𫉡	十卜月人十
𡨧	之寸言人十
𬷲	二人七巛儿
囻	口寸乙二七
𠾀	口一言月竹
𢣅	米卜十儿口
䒹	十卜三卜梄
𨆷	口卜曲米寸
𧻚	二人二寸曲
𪽝	目曲二巛曲
𪿀	目一之目巛
嚈	口一大月大
𣩦	一添儿二一
𪹚	米人言之言
𨢇	梄寸儿竹曲
𨂖	口卜添添言
𬏎	斤梄曲卜一
𬥆	儿添口三二
𥬋	竹言人一一
焒	米人口一口
檂	梄一曲曲大
𥉹	目一曲卜巛
𢩣	之竹言儿三
𦂿	巛一十乙乙
𪐾	目曲二川二
𫛎	竹言竹大儿
䤲	斤一二一米
䇛	竹言卜卜
𫄌	巛一口斤巛
𤳱	曲卜广曲人
𫬑	乙寸口一斤
𪽹	广一乙目巛
𠽏	口一乙儿川
𠒦	曲人一口口
𦰟	十卜乙一一
𡦫	乙一斤斤目
𩮭	三七斤一目
𡳳	又竹竹目曲
𫥥	言一人言广
𠓩	三卜梄一人
𤼔	广一三又之
𧝧	之广米一七
𥐧	大一十卜
𠿀	口一竹曲月
𣴚	添添乙乙乙
𱜜	川添一七又
𪪇	一添米之言
埈	二一巛人儿
𡚢	大寸十儿竹
𫷏	巛一儿七目
𢣧	米卜卜一一
𪶭	添添一曲米
𬁥	二竹一乙曲
𥋴	目一梄梄二
枮	梄一卜寸口
𦧘	目寸人人竹
𠄯	一添一梄一
𬺘	言米曲梄目
𬦿	口卜川添言
𨁍	口卜目儿
𬑛	目一人又之
𩿚	儿巛广寸十
𠲧	口一七言二
𪧻	川三寸言米
𧄵	十卜月人巛
𬐌	川曲寸添又
𩼀	儿一口口十
𬩧	之一目三梄
𢫡	寸添乙竹乙
𬅀	梄一言梄口
𤵕	广一人一一
蝩	口巛竹曲二
𢀮	言一口七又
㖼	口一十二梄
𡏠	二一月人巛
𢆠	梄一人米十
𣖟	梄一言寸十
𪷩	添添一梄梄
𥄮	目一竹添二
𥜤	二曲巛七七
𦲞	十卜巛大斤
㧺	寸添曲添曲
𫭔	口寸三大口
𪴾	目曲言寸卜
𧯅	人一人竹曲
㹯	月竹川添梄
𫡵	二卜又目米
𧲫	斤月乙添人
嚉	口一曲米寸
𫁅	卜寸目竹巛
𦤯	川目大巛乙
喯	口一大十十
𣑳	梄一三卜梄
𧂁	十卜口一七
𢪉	寸添乙巛卜
𤣚	月竹曲儿乙
㛪	巛竹大寸曲
𠶎	口一人卜又
𣻾	添添曲曲竹
澟	添添言口竹
𦼥	十卜添添二
𩭆	三七斤一口
𫡎	大一大口口
𥾗	巛一曲人
𥽄	米梄巛口儿
𢵌	寸添乙米大
𤳸	曲二目儿儿
𫢚	人寸卜一儿
𠺯	口一目人言
𧞴	言儿言二口
𨄿	口卜巛儿广
𠡧	言人口一乙
𩽊	儿一大大大
𪢖	口一竹又之
𬴓	竹言三米目
𣏿	梄一一添大
𠺙	口一之一又
𫷰	广大梄斤又
𦀺	巛一梄曲
𬄹	梄一大目目
𡊲	二一言添三
𪺨	七卜言人十
𱸉	竹言言儿添
𫡛	大寸乙巛之
𢶢	寸添竹目大
𫠽	卜一米三月
𥓷	大一广又人
㗑	口一竹一三
𪛅	口卜儿儿之
𦟽	月一之竹目
𪨖	又竹竹七曲
𢪥	竹寸儿乙斤
𫚳	儿巛卜寸口
𫅲	乙广乙言曲
揬	寸添之人大
𦃾	巛一一曲米
𣫕	曲卜又人月
𥳓	竹言竹曲月
𬏚	广一一添
𤎛	米人添竹二
𣺾	添添十巛口
𢉾	广大巛巛目
㮀	梄一又曲巛
𨀕	口卜七添三
䮴	三米又口米
𠽒	口一一卜大
𤮃	一巛目大目
𠆍	言一月目人
𢟘	米卜三十七
𫠧	竹一十一卜
鋥	斤一口一三
𣆐	曲一卜寸又
𣐅	梄一竹添二
𡅳	口一十川乙
𢹇	寸添目米大
𦏄	米三大曲一
𥵘	竹言曲儿曲
𦔙	三卜梄七儿
綡	巛一言口曲
𧋂	口巛添一寸
𠏲	川添目曲二
𢦂	米卜十梄目
𣐴	梄一川添二
𡧲	之寸一卜口
𩂠	梄添川添七
𬩋	之一梄言言
𠱅	口一又言二
𠸽	口一之又儿
𫠼	卜一寸添口
𫅯	乙广乙梄口
𢠤	米卜乙曲一
𧅬	十卜曲言口
醝	梄寸米三二
𠂫	言一卜乙竹
𪯰	人寸竹川又
𠢑	大七寸言乙
𢯐	寸添巛十口
𫣢	川添言曲口
𢭰	寸添梄一二
𤷄	广一米二乙
𬏸	广一之一寸
㖑	口一七竹十
𠣂	言寸梄目乙
𦹷	十卜二言口
𥐔	竹大一又口
𪁎	曲人月一儿
𠁻	口一口大大
𨆤	口卜又口米
𠡛	口寸大寸乙
𦂈	巛一曲二月
𢵴	寸添卜之目
𬏓	斤梄曲卜乙
𤯑	十三巛口竹
𨋤	梄曲卜寸又
𩬑	三七斤卜口
㯷	梄一川曲米
𬚌	十三二竹儿
𪰇	曲一儿添卜
䉭	竹言巛人巛
𢲯	寸添添人人
𦏓	又大口梄一
𢇉	巛巛乙言寸
𠟥	曲人大竹曲
𤏥	米人川之川
𥽢	米梄人梄大
𠰘	口一目梄
𪅬	川添七巛儿
𫠮	七二一添卜
𬡞	十卜之广乙
𦛿	月一十卜言
𥑂	大一十寸又
𤳨	曲二二巛曲
𨃝	口卜人卜二
𨁩	口卜寸添乙
𡾵	目目川川言
𩱻	川口卜寸
𨁷	口卜十寸目
𡅊	口一十目米
𬂍	月一曲人二
𫸏	广大十言人
𫯓	梄一人儿儿
𢢯	米卜目目川
𪳂	梄一米一川
𪾀	川曲七口一
𢱖	寸添十二梄
𨀐	口卜儿卜广
𤠴	月竹乙一一
𨨅	斤一七口一
𠻆	口一乙口梄
𪱚	月一卜一
𢁯	目卜曲一
𬟃	十卜曲一大
𨃑	口卜寸儿添
𤈠	米人又大二
𬃑	梄一米三川
𢤞	米卜七又目
𫕪	梄添添儿曲
𣡝	大卜目巛梄
𧿨	口卜斤寸又
掑	寸添十三
𢕸	人卜米儿十
𱳚	目一言曲大
𦀐	巛一广大二
𧺀	二一米斤曲
𠴍	口一乙言之
㦨	米卜又梄目
𦘱	月一卜寸
𢶿	寸添之十目
𣙬	梄口梄七又
𠴜	口一寸十又
𫗷	米一川口梄
捠	寸添斤二人
𤁠	添添之十巛
𢚸	三一十卜之
𫴯	目人曲寸寸
㗀	口一巛巛目
𫪣	斤寸一川二
𨙍	之一竹目口
𤝑	月竹竹添之
𥅘	目一儿添曲
𨊌	川三米儿十
抈	寸添月一
𡍝	二一十目人
𢲭	寸添梄寸乙
𩵜	儿一儿添卜
𥙩	二曲巛巛人
𧀐	十卜三一川
𣷮	添添大一十
𦀏	巛一巛卜竹
㖅	口一七大一
𦎡	米三大寸竹
𡂎	口一巛巛曲
𥋓	目一曲口曲
鑡	斤一卜人
𢷹	寸添广人二
𧛋	之广人又之
𡞕	巛竹儿卜曲
𨖙	之一目曲大
𫤢	竹二儿竹竹
𧏯	口巛大七寸
𩶝	儿一一添卜
攞	寸添目巛川
𩺨	儿一川三二
𩴬	目曲目人川
𬚯	月一二二
𪮩	竹寸米梄目
𪹎	米人之一斤
𡳤	又竹言二乙
𢣄	米卜之一目
𤓩	米人言巛竹
𥾾	巛一川添卜
𣋰	曲一十月二
𥖔	大一梄七七
𣍋	人寸一一卜
𣾿	添添口一儿
𫏢	口卜竹目大
𫌐	之广二七巛
𪻋	月竹广米寸
𤳷	目曲巛儿曲
𥐉	又人竹口米
𬩯	之一梄口儿
㮛	梄一曲一卜
𦁀	巛一目人
𡏢	二一三米
𤯰	竹三广儿言
𥇻	目一之寸曲
㓠	卜寸口一曲
𥶇	竹言儿一曲
𤣄	月竹广又米
𫩉	二曲巛三又
𤹘	广一大七寸
𥈳	目一之人大
𢹫	三卜乙竹目
𣞽	梄一又米乙
𬛯	川目大言曲
𤆹	米人七卜
𧐾	口巛言口乙
𩄔	梄添寸曲一
𥓉	大一七大乙
𩅚	梄添二一川
𬁌	儿七曲十言
𫯳	竹十曲二二
𠉱	川添之竹言
𫙖	儿一又竹儿
䟬	口卜斤二
𠔭	人一巛人斤
𦼝	十卜米川人
𪻊	月竹二竹又
𣻗	添添竹儿儿
㷚	米人言之一
𫠻	大卜川添言
𢯕	寸添之寸目
𢺔	寸添之曲目
𨔍	之一目十巛
𠖘	之之巛目人
𡹞	目目言口曲
𬇑	竹乙梄一卜
𢫌	寸添川添乙
𣚮	寸添言曲梄
𫗗	人又又竹目
𬯄	乙口大二二
𠏥	川添目米大
𢠉	米卜川目巛
𬪄	乙寸二儿卜
𬜆	竹卜竹添之
𫽦	寸添添月梄
𡮥	曲人又寸竹
𰛻	添添又二米
𧶭	目人大十十
𡲤	又竹竹七目
𪠗	斤寸曲巛口
𨨪	斤一竹目曲
𪶵	添添竹竹人
𣠓	梄一竹梄二
𢣂	米卜米竹七
𡗋	言一口儿儿
𦂼	巛一十三巛
𡨺	之寸一之寸
𤛞	竹二又寸竹
𩺱	儿一七大口
彣	言人斤三
𠏠	川添口二二
𪨁	斤添乙一曲
𫷜	竹一十目米
𠾛	口一十曲人
𨦥	斤一添添乙
𧴤	目人卜寸
𡔑	二一七目目
𩁶	梄添乙七
𥣒	竹梄人曲之
𡆈	口一言竹儿
𪖭	川目曲一寸
𧃶	十卜月一大
𢴘	寸添月三月
𪲽	人言梄寸斤
𨅐	竹一十米口
𣳮	添添口一口
𥴙	竹言梄曲十
𦪦	斤乙曲口竹
𬐆	川曲竹添之
𡆁	口一人二一
𣺽	添添目二巛
𢯛	寸添添添言
𡪻	之寸曲十口
𡃽	口一川梄大
𬡯	之广言曲口
𫶜	目目言儿卜
楴	梄一言之目
𨇜	二竹目儿口
𫂷	米梄人言十
𧜻	竹十曲乙言
搈	寸添之人口
𫏾	梄曲曲儿口
𬧒	口卜口一一
𬋱	斤米儿添卜
傦	川添目之
𤵖	广一曲一
𣈒	曲一十三
𡤓	巛竹巛目目
𫸌	广大十二又
𠽂	口一乙曲一
𢢈	米卜之人广
𤏣	米人言斤言
𢷵	寸添竹儿十
㫵	曲一曲三
𢌎	广大十言乙
𩆏	梄添十巛梄
𫗺	米一川乙竹
𬚁	米三米斤川
𠱉	口一人寸斤
𢸝	寸添添二曲
𤊥	米人二人儿
𡑵	二一十卜月
𣋽	曲一人人曲
𬛃	目寸人人二
𪪫	十一口广梄
𤎐	米人七大口
𠑖	川添言目川
𥱪	竹言目之
撎	寸添二口米
𡓇	二一儿一曲
𠺚	口一三曲三
摼	寸添七又二
𢫖	寸添梄一言
𣓿	梄一十之乙
𬉙	添添言十曲
𥘑	二曲寸言
䖳	口巛之竹七
𢫃	寸添口一巛
𩯀	三七斤梄口
𫶴	米三二口口
𢗇	米卜儿言
𢴒	寸添言又米
唻	口一梄人人
𦄴	巛一言川曲
㯲	梄一梄梄二
𦄀	巛一三米
𣭻	口卜竹七
𥺽	米梄人目十
𫍍	言寸十儿言
𥯈	竹言梄斤又
𨯹	斤一竹言三
𠴔	口一口一三
𨆓	口卜人目巛
𡓏	二一米十乙
𠯽	口一卜卜
𨬊	斤一二乙竹
𣔻	梄一之人大
摱	寸添曲目又
倈	川添梄人人
𠿹	口一川二目
𠯹	口一川乙竹
𩹩	儿一十言目
𦟺	月一寸二卜
𥝥	竹梄乙添人
𨄉	口卜言竹竹
𤷲	广一巛大梄
炵	米人儿卜广
𢄃	目卜添斤儿
𪞠	广寸人之又
𫰇	巛竹巛言
𱡅	寸添目米二
𪹪	米人二巛之
𥋹	曲一一乙七
𨃍	口卜之人大
𩁱	川卜梄竹目
𡂃	口一二巛川
𣉵	曲一儿儿巛
𬏖	曲卜十三十
䋘	巛一三卜梄
𫁛	之人七目十
𪫵	三一十卜之
𥖕	口一口大又
獜	月竹米儿十
𫧾	儿竹言巛二
𪷥	添添言人儿
𪽽	川曲斤二
𠡺	二一巛乙乙
𪽲	广一一人大
𬑾	大一一添大
𣎣	月一川言竹
𣞎	梄一十竹目
㶩	米人之之儿
𡂰	口一米十乙
𥗌	大一卜大曲
𢙭	曲人大寸之
𥯉	竹言巛竹大
䠣	口卜乙十人
𢜗	米卜三人二
𧴱	目人巛竹
𢥅	米卜斤川目
𠅒	言七一添梄
𠼶	口一二乙又
𧾌	二人乙十人
𬋫	斤添一儿卜
䇠	竹言言添三
𫔸	曲寸二二又
𪡷	口一乙人竹
𠸛	儿言口竹儿
𦈂	巛一人二一
𣻈	添添川三二
𤼞	广一川巛人
閧	又寸十一人
𡆖	口一十川米
𢨵	之竹竹一十
𠇖	川添竹添之
𣘉	梄一月又口
𫬠	口一七竹目
𢭴	寸添米又大
𢱗	寸添十十口
𣋀	之寸竹曲竹
𫅝	米三大曲一
𧜐	之广巛口之
𠴥	口一添之儿
鬭	三三二巛斤
𨆾	口卜之又二
釟	斤一人一
𥩇	之人米口之
𨋣	梄曲一目人
㫧	曲一米梄
𪇐	儿巛米月大
𬡟	之广十卜月
𡓢	米人儿人二
𪬎	儿添又之乙
𢱙	寸添乙巛人
𠮙	口一乙七
𦲻	十卜斤竹二
𦾤	十卜人曲之
𢸜	寸添米十乙
㘋	口一七又目
𬧖	口卜之米川
覵	又寸月一目
𬏪	广一之寸巛
𩸘	儿一之寸乙
𬄓	梄一言人口
𡒭	二一川曲曲
𩄵	梄添巛目人
𠬠	米寸又言
𫣞	川添卜七曲
𫶯	米三二卜巛
𨅃	口卜目之二
𨃈	口卜十人乙
𡅪	口一大曲大
𠰏	口一竹添之
𤋸	米人三乙大
𧷝	口一儿口目
𫺈	米卜添添巛
𢹣	寸添竹目口
𬪾	竹十曲大乙
𠵱	口一川添言
𫈥	十卜梄一口
𨀼	口卜二竹儿
𤂷	添添又人广
𦎬	米三曲一竹
𨲖	曲一目巛三
𪡔	口一目十巛
𥬮	竹言添添二
𬣎	言寸人人三
𫵉	言添又曲大
𬩔	之一曲乙人
𩺣	儿一曲儿添
𠴕	口一巛曲竹
𪪀	竹添乙儿梄
𠯿	口一言一人
𢵽	寸添又梄口
𱫳	七竹儿川
𠽐	口一儿一
𫊬	口巛目寸大
囄	口一言巛川
𢟟	米卜一川七
𤿍	又卜一添寸
𪁅	儿添乙曲儿
𠓑	曲人一儿曲
𪪳	人一巛言十
𦼃	十卜人口曲
𨣤	梄寸梄梄二
㗞	口一大一又
𬂽	梄一梄二又
𫤤	曲人一口曲
𠮩	口一又乙
洡	添添三卜梄
𧄊	十卜曲口二
𫷙	一添米言川
𥓄	大一曲卜二
𦟸	月一添儿言
𬚣	三十卜一乙
𨀰	口卜广寸曲
𡏯	二一目人竹
𧢟	卜人目儿
𦛉	月一口一目
𬟠	十卜一曲曲
𫋐	口巛二卜目
阥	乙口曲添
𦄁	巛一之一又
𢠣	米卜乙梄曲
𤳄	曲二目二巛
𨡊	梄寸口乙曲
䁾	目一十七言
𩂟	梄添七大
𣾽	添添竹竹竹
𣿇	添添竹又之
𧀒	十卜巛口竹
䏾	月一三人二
𡖱	儿言儿川米
𬊭	米人曲一曲
㘇	口一米之梄
𣲦	曲添曲人竹
𦝃	月一梄一梄
𩷕	儿一言添又
𫈈	十卜川大口
𦡲	月一之目一
𩟡	人又曲米寸
濓	添添言曲人
𠶒	口一米曲一
𬦸	口卜曲儿儿
垹	二一三卜乙
𨛦	又大口口乙
𧤸	儿添月人儿
𤯿	广大儿竹竹
𠎬	川添竹二寸
𩵃	川口言川曲
𫯧	大寸川竹卜
𩷛	儿一儿添月
𧣠	儿添月一卜
𪲾	梄一斤一口
塸	二一七口口
𡜵	巛竹梄二
嗘	口一斤巛大
𠸺	口一之米巛
𤁙	寸添人一口
嘅	口一又七儿
𢜠	米卜曲一月
𥽪	米梄竹言三
薟	十卜人人人
𪹂	又二米又二
𢤡	米卜大大大
𪼀	三一言之目
𬖵	米梄之竹目
㩡	寸添大大大
𪤤	二一二又曲
𨮊	斤一十广十
𧋿	口巛米又大
𫆥	之竹月言儿
𠺭	口一川三二
𠳒	口一一大卜
𢠐	米卜儿一
㖪	口一七口一
𪃙	二竹儿巛
恾	米卜十卜言
𦒹	二竹儿言人
啿	口一十三巛
𨒸	之一大卜乙
𥾿	巛一竹一十
𡁺	口一添人口
𤉜	米人广大梄
噷	口一言曲儿
𤓛	米人曲乙川
𤋹	米人梄十口
𪬳	言七之口目
𬏇	曲卜三一十
㨢	寸添巛儿儿
𥐏	竹大一乙口
𢆪	二一米曲二
𬚸	竹卜目人人
𨄂	口卜言又乙
𧏳	口巛寸添梄
氽	人寸曲添
𡲫	又竹竹大目
𠼾	口一目之二
𤑭	米人大大大
𢟔	米卜之一又
𥼳	米梄二巛之
𠲵	口一二巛乙
𫉚	十卜言寸之
𤍄	米人二曲目
𬏠	广一巛巛乙
𩙌	月寸二月曲
𪨣	目目竹一乙
𣇝	曲一广人之
𣾾	添添曲言口
𧻪	二人七竹大
𫥸	乙寸卜寸口
𣛩	梄一竹人三
𥌸	目一又儿川
𧛇	之广三七
𪷮	添添竹人竹
𫾕	寸添十大米
𠄽	二寸寸添曲
𨇣	口卜七竹目
𤶄	广一川竹二
𡃑	口一言三月
潷	添添竹又二
𦂻	巛一人又二
𪒽	目曲二大大
𬉽	米人目目乙
𠡏	竹三乙竹
𬒏	大一目目乙
哯	口一目儿
𪀎	口一人言儿
𠻂	口一目目言
𢯘	寸添十川儿
𬛏	广卜儿人巛
𠤆	儿乙斤添二
㖔	口一一大口
𩷊	儿一巛卜竹
𥺎	米梄目三人
𥇹	目一曲一寸
𪶊	添添言人寸
𢝀	米卜之人大
溩	添添儿川
𫾗	寸添言目十
𫊩	口巛乙添人
𥩉	之人七梄曲
𦅲	巛一二七巛
𠺵	口一三十七
𫇐	七二又又一
𡏘	二一一川儿
𠶘	一卜口儿曲
𢀥	七添又三乙
䤠	斤一卜卜
𥸿	乙曲米梄
䖡	口巛又二卜
𡀣	口一十三乙
𠴝	口一添添三
𩺌	儿一十之目
𢺖	寸添曲十儿
𩼤	儿一言口竹
𦢴	月一米之大
㫾	曲一曲目口
𠻃	口一梄曲一
𬳦	竹梄曲又目
𠹛	口一目口米
𠖾	广寸一添梄
𬞢	十卜斤口儿
𬈗	添添寸斤巛
𦼟	十卜巛巛儿
𪮴	寸添又米巛
𡮶	竹十曲目口
䲨	二卜儿巛
𣋝	曲一口口梄
𣲹	添添目寸二
𣗒	梄一斤一十
𥠯	竹梄十卜口
㐱	人寸斤三
𫿕	言乙竹月二
𦚭	月一口巛
𫇌	川目大大曲
𡃐	口一目曲一
𣩁	一添儿寸斤
嗂	口一斤十巛
𡀶	口一添川曲
𠿸	口一十一一
𡺦	目目乙又目
𩇢	三卜月口竹
𤯊	十卜人梄十
𥗹	大一十儿竹
忼	米卜言一月
𬐸	卜七曲儿卜
𫥧	巛曲巛十巛
𬡶	之广目米二
𠞹	斤梄之巛曲
𪴹	一添卜二巛
𦀿	巛一又竹竹
𥽌	米梄之米川
𠰍	口一言添三
𫤄	川添一寸川
𠢬	竹一十米乙
𦆺	巛一人之大
鬂	三七斤斤人
絩	巛一儿寸添
𫣃	人寸之之巛
𣉲	曲一川卜又
𤺶	广一三米又
𬞊	十卜之目一
檺	梄一言之大
呡	口一乙二七
𠸠	口一言曲口
𪴞	川曲添曲月
𱿜	口巛之巛
𬓰	竹梄言儿言
萾	十卜乙又目
𢭽	寸添添之儿
𤚦	竹二十口梄
𣟫	梄一十又月
𱤕	梄一十十十
𬚀	又大口米曲
𬣈	言寸川竹月
𪪉	二一米巛竹
𣛟	梄一曲口竹
𧚠	三一十卜言
𬱻	言米月寸二
𡡦	巛竹乙米大
𪁂	言曲儿巛
𨧟	斤一乙言之
䃄	大一言口曲
𤊨	米人七口一
𤪊	三一斤人之
𫼌	之竹十一人
𩍢	十十梄添曲
𤈟	巛竹口一米
𫏊	口卜川竹二
𫰴	巛竹之寸竹
㓭	曲一儿巛曲
𣉹	曲一人人竹
𧡊	川添梄一目
𫑯	言添又大十
挗	寸添大寸乙
𡴯	目目乙七
𫇿	十卜梄一口
𡁛	口一巛口竹
𬴭	三七斤月口
𣠗	梄一竹之目
𥙓	二曲巛添月
𫘵	言一口口又
𠼕	口一寸添曲
𫌢	目儿十目米
𨙌	竹言又一一
𬹏	广大梄言口
𫡉	之寸乙一口
𪶏	添添二儿卜
𬪼	竹十曲二儿
𩀳	三一十巛川
𫿇	言乙竹人目
𫽻	寸添曲人二
𪥛	言米曲梄大
緍	巛一儿七曲
𣄖	言乙竹一月
𬃴	梄一梄一川
蕯	十卜乙一竹
𧶬	目人巛曲一
葇	十卜又川梄
㗜	口一言巛曲
𣠲	梄一二口米
𣛥	梄一曲三之
𪖬	竹一巛一川
𡄧	口一言目二
𨀺	口卜一儿曲
𨁘	寸添卜卜口
𬘋	巛一斤斤目
𬨠	之一竹添十
𥣽	竹梄川口口
𡴉	一添巛曲月
枛	梄一斤添
𡤊	巛竹竹添二
𠴚	口一川竹卜
𠶃	口一三一一
𬡴	之广巛川目
𫗂	月寸二之又
𫨩	巛言口儿儿
㨃	寸添言口乙
𥺻	米梄斤一
𬩱	之一竹二一
𬇫	添添寸添乙
𢳝	寸添十十乙
𦷩	十卜大竹之
𬑸	竹大一之大
𠜭	乙寸寸之儿
𬩩	之一乙目又
𠄳	二寸二巛乙
𨸾	乙口广卜儿
𬕼	竹言竹口言
𫉎	十卜梄又口
爙	米人言口十
𤇥	米人言米
𦢄	月一曲三言
𡃺	口一之二一
𥽔	米梄巛川目
𧼌	斤月二人
𧊎	口巛七竹巛
𩴚	川口言川曲
𫪗	口一一七卜
𧖰	竹添目梄儿
慤	二二之月之
秱	竹梄目一口
𬤴	人一人口大
𬎣	斤言竹添之
𫪏	口一添儿斤
𬏌	曲二二人乙
𬗻	巛一二又目
𧙽	之广口巛
𠗰	广寸三人斤
嗙	口一言之言
𫴬	言人寸儿卜
𫯵	大寸言口乙
㯊	梄一一巛米
𦀻	巛一乙乙竹
㑏	川添之寸寸
𩵞	儿一竹十
𫥩	言一人又口
𢺛	寸添又曲一
𤵳	广一梄一一
䀲	目一竹一巛
𨇍	口卜二二梄
𢽙	又竹竹七竹
𢪲	寸添儿儿儿
𱑛	巛大二言言
𪂰	儿巛广儿言
𬐎	川曲言人十
𪨜	又竹言梄言
𠽈	口一添七七
𠀧	乙曲三寸
箤	竹言言人十
𡔒	二一曲口十
𫠯	三一十一卜
𪞷	巛曲巛卜十
𡂌	口一十曲竹
𫎰	二一米巛曲
𠗣	广寸人目十
𬹸	卜人米儿十
𤍃	米人添竹巛
𡮽	曲人大十目
𦄓	巛一川又儿
𪝮	川添言竹儿
𬩄	乙添竹米大
𪢆	口一之一二
𦙤	月一竹七
𧋇	口巛大大卜
𣈞	曲一之人二
𨉟	川三人口乙
𤎏	米人目梄大
𥟌	竹梄十卜月
𨄑	口卜儿口曲
𩪵	目之曲巛竹
𢶥	寸添添川十
𤞑	月竹口寸口
𨱽	三七曲梄竹
𤞩	月竹目三乙
𠔦	口一乙斤人
𢷣	寸添川卜人
𫧬	竹一十言二
𧓏	口巛三又大
𤰁	川二一二竹
𥮇	竹言三卜乙
𪞅	言一巛巛口
𪳔	竹一梄目十
𨑮	之一川添十
𠻪	口一添米米
𥊜	目一言又大
𧵟	目人斤言
𠠚	卜人曲寸
𫦇	人一乙卜巛
洏	添添大目
𫃚	巛一卜寸
𡂙	口一之曲竹
𢭵	寸添巛又乙
𪶚	添添二梄之
𠖝	之之一人之
𤻒	广一大人十
𨃻	口卜一曲米
𤋼	米人十十口
𣻅	二二口曲竹
𬇭	添添曲一卜
𠿿	口一米竹七
𠹚	口一口一目
𢀫	一添巛二月
𬛲	竹添十卜七
𪓪	之又口一三
𪭸	寸添口广十
𫆸	目寸人梄寸
𫉩	十卜口一儿
𩘪	月卜之人口
𪉥	卜寸口竹巛
𡔃	二一十二川
𠬒	二一巛言目
𥴗	竹言巛巛儿
𤎎	米人广梄梄
𫴳	又二寸三十
𦁂	巛一川添米
𠿴	口一大一寸
𥋵	目一言曲儿
𢰥	寸添十巛口
﨡	口巛竹三
𤖸	川又言添三
𪺤	川又口乙曲
𲎚	三一十十又
𨮍	斤一言口竹
𪁵	又竹乙口儿
𬊊	米人三一十
𰇼	口一巛大斤
𣆏	曲一大卜一
𪁶	之一寸言儿
𩠘	米一川儿卜
𢗠	米卜七寸乙
𨯘	斤一川人人
𥻡	米梄又竹目
𥋶	目一言口竹
𣛭	梄一二竹乙
𬕻	竹言三曲之
橷	梄一川儿儿
𬡋	之广七添目
𡚦	巛竹言添
𩻕	儿一梄之儿
袩	之广卜寸口
𥌎	目一梄添大
𫅡	米三又米口
𦋦	目曲十巛巛
𤆻	米人七寸乙
𣖙	梄一米三大
𫃸	巛一寸斤巛
噋	口一言乙竹
𣾶	添添乙米大
𫄂	巛一竹又二
㧍	寸添言乙
𬗂	米梄三三三
𢫑	寸添儿言卜
𣼽	添添言又月
𬈰	添添言川卜
𢴇	寸添二米月
𫬢	口一口大目
𪁄	儿巛二二口
𦹸	十卜曲十曲
𢶐	寸添卜口米
刧	二一巛言乙
𣌔	曲一之口大
𥡘	竹梄十竹月
𩰈	三七斤二一
𬦗	二人乙三梄
𪒗	目曲二人梄
悑	米卜梄二
𠻀	口一人卜二
𪅩	巛言巛斤儿
𪮈	寸添川口人
𣹗	添添三人斤
𦪼	斤乙竹儿曲
𪟓	乙寸乙儿儿
𢲫	寸添三米
𡈺	口寸口目十
𬠨	口巛又二目
𦡞	月一梄梄二
𥻹	米梄十人梄
𫆭	目寸人之米
𢸾	寸添川口人
𫋑	口巛三曲三
𣻃	添添川言口
鴺	大寸乙巛儿
㫻	曲一人目十
𬅳	人一人又之
𪄸	三卜目人儿
𫿰	之寸乙一言
𬙛	目曲大寸广
𪽛	又竹十人曲
𬂥	梄一口一儿
𠿵	口一斤月又
𫸬	之之月乙卜
𱲢	米梄巛斤目
𤊭	米人广大二
𢮫	寸添巛又乙
𫄆	巛一大人十
𬹀	广又十言川
𬚞	一卜口三乙
𩺩	儿一目二巛
𣡚	曲卜梄儿目
𣇊	曲一大卜口
𦄂	巛一十之目
𨐿	言十斤斤目
𤀕	添添之人二
𤒟	米人竹竹大
䱒	儿一口一乙
𫐮	之一人目十
𢫕	寸添言添曲
𢪗	寸添川添卜
虶	口巛一添寸
𤻫	广一曲米寸
𡭲	曲人竹巛巛
𤏦	米人三乙巛
𨠴	梄寸梄口
𬨵	之一斤竹之
𬂨	梄一寸儿卜
𥱫	竹言大寸三
𥈶	目一十目米
𠽕	口一寸又卜
𢫘	寸添卜寸又
𠸚	口一十儿口
𤍅	米人一曲米
𤂬	添添大大大
𬀭	曲一卜寸又
𫴾	曲人曲儿儿
𦝎	添添二人人
𦹳	十卜人又目
𢱸	寸添之一又
𤴭	广一人一
埮	二一米人米
𧛶	之广人二寸
𠺰	口一竹儿曲
𡮣	曲人又寸竹
𦪐	斤乙川儿之
𨑜	之一一添卜
𤾟	川曲言竹十
𦕟	三十言添曲
䇻	竹言又竹竹
𬈅	添添二巛口
𠌧	川添人口竹
揾	寸添曲一目
紷	巛一人寸之
𲎣	二一人儿卜
𬰓	梄添之又二
𠫾	二一巛儿儿
𥰇	竹言言寸十
撔	寸添曲口曲
𪝕	川添人乙目
𪝻	川添七添梄
𡫶	之寸十三十
𡮮	曲人又寸之
𫰟	巛竹二儿广
𤄲	添添言口三
𡒯	二一十一大
𤁩	添添斤斤目
𡮍	曲人寸巛巛
𡍟	寸添大一十
𦩳	斤乙二竹
𪡉	口一口儿卜
𦑃	一添曲乙乙
𡭕	一添曲人
𫵋	言米曲之曲
𤠅	月竹大卜目
𪨆	曲人竹一儿
𠓹	人寸三目十
𧞥	言儿目斤巛
𫬊	口一目乙口
𠁚	一添卜目曲
𢮩	寸添乙一斤
𪄤	大寸三七儿
𠰚	口一儿添曲
𬆄	一添卜之目
𣅶	曲一言一人
𥱭	竹言川添三
𫅹	三卜梄一曲
𬧻	曲口巛竹梄
𬔫	言米梄目目
𬖮	米梄曲竹目
𥊘	目一之一口
𪤍	二一又十儿
𤺭	广一竹又二
𩄓	梄添十巛梄
𫔷	又寸一乙之
𡅢	口一之梄二
𧠅	梄口人口乙
𬦡	口卜人寸卜
𡅐	十卜人米口
𠳝	口一大卜口
囒	口一十梄目
𠺹	口一十大乙
𫥜	广寸人人十
𠸄	口一十目大
𤏨	米人竹大目
𪔚	二二口一口
㺔	月竹斤米
㙁	二一竹一巛
𢹥	寸添大大二
𠇍	人寸米卜
𥇁	目一川言三
𣌂	曲一大月二
𩽗	儿一三人口
𬋼	人一人言曲
𪦓	巛竹目乙七
𬬃	斤一川儿卜
𡃾	口一梄曲米
𢟞	米卜广梄曲
𨳱	竹一十寸又
𡡧	巛竹竹口曲
𤗲	川又巛人斤
𡄪	口一口口川
𪷶	添添斤人之
𥢳	竹梄添添二
𢠦	米卜十口二
𩳳	川口梄人人
𫜹	又二
𢶽	寸添乙斤川
㕪	口一之之儿
𨇘	言卜口卜
𡃘	口一言米米
䔲	十卜又口米
柪	梄一巛巛乙
𨀾	口卜添添巛
𱒚	口一一口人
𬉊	添添三口三
𣛠	梄一目曲目
𨭺	斤一梄梄二
𪚤	言卜言月三
𠑉	川添人之又
𤘂	川又十之儿
𣎏	口寸十大月
蒣	十卜人人竹
攊	寸添大竹卜
𱮆	月竹之广乙
𣐲	梄一口一巛
𢲲	寸添言又乙
𡥵	乙一曲儿儿
𫄕	巛一曲儿巛
𤗹	川又斤梄曲
𣼰	添添三十之
𤥭	三一梄曲
𣉐	曲一之梄言
抸	寸添竹添之
𫻂	巛竹又之又
𠶜	口一竹目曲
𫺼	米卜斤卜川
𫕖	乙口一言又
𪤻	儿言儿言又
𧖐	口巛七目目
䈵	竹言人乙乙
吘	口一竹一十
𨡧	梄寸巛大大
𠊡	川添米三儿
𠵋	口一川曲二
𤿱	口一乙曲又
𤀒	添添人曲之
𨆥	寸添口目口
𦓊	二竹儿目曲
鈙	斤一卜寸又
𧋾	口巛口一乙
𫤓	川添儿之又
𡅷	口一言竹七
𥸁	竹言十二川
𥇸	目一斤二目
𩠴	米一川目曲
𫔮	又寸月一
𦀹	巛一梄一寸
𪿁	言米曲竹目
𥺾	米梄卜卜月
𢢉	添添十口之
𤟛	月竹儿儿言
𩄑	梄添十目米
𡆙	口一言儿言
𢭜	寸添二之月
𦟶	月一米卜口
㰁	梄一大大大
𡀰	口一川目川
𪁳	口一口一儿
𠰺	口一川添七
𩩬	二二之月目
𥟹	竹梄月口人
㳌	添添曲乙
鱙	儿一二二一
𢷯	寸添七口大
𢘮	米卜言米
𡶀	目目目寸人
𡵉	目目一儿
㧼	寸添三卜儿
㜥	巛竹目曲目
𢯔	寸添竹卜曲
𪣾	二一巛儿儿
𫃰	巛一巛大斤
𤅧	添添三口口
𤆸	米人之巛
𣈙	曲一川儿曲
𧓆	口巛川梄寸
𫩍	斤寸又梄曲
𤺴	广一二乙又
𢯤	寸添曲一乙
𢡿	米卜又寸梄
𢟎	米卜人卜二
𥚅	二曲巛一三
𬩐	之一又巛巛
𥻸	米梄目梄一
𥒮	大一又竹竹
𤗤	川又二卜目
櫗	梄一十七言
𪞸	言一人竹十
𡻗	目目十目人
𡻓	目目川言口
𡚃	斤一一巛大
𢯜	寸添巛一卜
𤂱	添添竹人曲
𫼩	寸添米一目
𠳗	口一二之月
𢴜	寸添川添儿
𡓄	二一十儿三
𪦟	巛竹乙人广
挅	寸添乙竹梄
𠶊	口一二一又
𪭃	米卜梄曲目
𠒷	竹二儿川言
𣜰	梄一广曲人
䁘	目一斤十巛
𪨚	又竹米言三
𣈖	目一三人二
𣅘	曲一一添一
𢳳	寸添目目十
𫸉	广大又二米
𡅨	口一竹人言
𫯐	儿言儿梄一
𤐡	米人二一川
嵿	目目一卜大
𥗳	大一之口大
𥮉	竹言梄二
𫮂	二一广大曲
螉	口巛人乙乙
𩊾	十十又言月
𬩕	之一目竹十
𱣜	梄一寸大乙
𦚗	月一七添目
𪹜	米人广大梄
𪭥	寸添大寸二
𢫝	寸添儿卜广
𪵦	言米曲一竹
𩚵	人又十二
𥞖	竹梄月二
𦪵	斤乙竹言十
𤳧	口一口十人
𨃐	口卜十巛口
𩤕	三米三卜儿
𫃀	米梄之寸巛
𫃩	巛一巛又卜
𤒴	米人添巛米
𢏿	乙巛之儿乙
釖	斤一乙寸
鐄	斤一十曲人
𬁀	儿七曲曲竹
𥬧	竹言人寸卜
𧦔	月寸言寸十
𢷮	寸添曲米寸
𢲨	寸添添竹巛
𦟂	月一之一米
𢠄	米卜目之二
𩺺	儿一川七儿
𣵲	添添川添米
𣖖	梄一寸二寸
𫯰	二言竹曲二
𢂰	目卜儿添又
𪮍	竹寸十二梄
𢘭	米卜月二
𡀷	口一之十目
𨀊	口卜乙竹乙
𥹀	米梄之巛
𠷦	口一儿儿乙
𣘌	梄一二口儿
𢩮	寸添七言
𤃠	添添人斤巛
𦄃	巛一寸斤口
𥂉	一添巛儿目
𡄨	口一目口巛
𪰓	曲一一米十
埁	二一目言又
𤳰	又竹竹曲巛
𫀥	言一人十曲
𢜝	米卜一口又
𦞍	言寸十人人
𫓆	斤一十梄寸
𫼴	竹寸口一口
𫥛	广寸口口梄
𬗽	巛一曲梄寸
忊	米卜一卜
𦹶	十卜梄一目
糆	米梄又口目
𬜊	竹卜目人曲
𢜢	米卜人卜又
𧋃	口巛大卜乙
𠿲	川卜口曲一
𠻼	口一十口米
𣓆	梄一斤竹二
𧿆	口卜乙二
𡱩	寸添竹又言
𠞛	之竹乙乙曲
𦛍	月一一目二
𬳚	米一川寸口
𧽇	曲梄竹二乙
𨐸	言十又口米
𬦶	口卜七二曲
𫢍	斤寸人寸
𩭜	三七斤口儿
𬀶	曲一竹三乙
𥿁	巛一三一
挭	寸添一曲人
䌌	巛一乙乙川
𡉽	二一言一人
𤻏	广一川二月
𢺓	寸添梄竹二
䃹	大一又梄目
拪	寸添梄口
𡊸	二一七竹大
𣌛	曲一一梄大
𫥯	又竹言又竹
𬍍	月竹二目米
𫅰	曲三之乙乙
𪸁	添添广二又
𫁔	之人二七三
𢜜	米卜卜七
淁	添添言米巛
𩅻	梄添添添二
𣼱	添添川目巛
𫺽	川目之一乙
𲃪	口卜言人寸
𧺂	二竹目二米
𩅘	梄添之梄口
𢩧	寸添乙七
𢭻	寸添口一儿
𤴪	广一月寸
𢥖	米卜言川曲
𣇜	曲一目人
𨰲	斤一七目目
𥢉	二二之梄口
𡀠	口一川竹月
𠼼	口一十斤乙
𠐬	川添竹竹大
𣘈	竹一梄目十
𨷯	又寸川人二
𠛌	之之儿寸曲
嚛	口一川巛梄
𬛘	月一米梄寸
𬛒	月一添添二
𥉲	目一又十儿
𬷊	儿巛斤言
𩠔	米一川目竹
𡫨	之寸之目目
𢪮	寸添梄一
𪜾	川添目三乙
𠼴	口一儿儿大
𬞚	十卜大人十
𬧇	口卜添斤巛
𡒮	曲梄曲斤二
𨦁	斤一川添二
𢵉	寸添目竹之
𢚹	米卜曲二巛
𬆅	曲人目一卜
𨁬	口卜川添曲
𠔮	米一又人月
𣎷	梄一乙七
𢒎	之之一一斤
𬙖	目曲一添卜
𨕭	卜一之一梄
𧎝	口巛三一大
𧿐	口卜竹十
𤮒	一巛又米巛
𠝕	乙寸曲儿儿
𧿫	口卜广寸十
𠷥	口一言之一
𬺗	言米曲一卜
𤇮	米人竹添之
𠾔	口一竹口儿
𣘁	梄一一一口
𡃋	人寸一口目
𫊔	十卜二曲米
𡮓	竹十广曲竹
𥶯	川口竹言曲
𬂇	月一三曲三
㧵	寸添大卜口
𢪱	寸添儿乙斤
𢖕	人卜巛米巛
𪩬	乙曲儿添卜
𩚧	人又七竹
𠅎	言七竹二人
𦨑	斤乙寸言竹
𪽸	广一二七巛
𦚔	月一乙寸口
𥗎	大一竹儿曲
𨅾	口卜梄梄梄
幍	目卜斤添川
𢢲	米卜十巛梄
𤢫	月竹一十十
㘃	口一十口之
𪹰	米人言人川
𣞃	口一梄口口
𥶂	竹言十儿儿
𨄟	二一川卜口
𩷶	儿一十卜言
𩳴	川口二二卜
𪸯	米人斤添巛
𪡭	口一梄寸乙
㳹	添添梄一三
匬	七添人月曲
𪬲	人一乙米又
𠜏	口一目卜曲
𢶶	寸添言曲之
𧁴	十卜人人曲
𥊗	目一添米米
𢶻	寸添十卜月
𣠘	梄一竹添十
𪸟	米人儿言卜
𬛎	目寸人之川
𢭫	寸添乙一一
𪬫	言米曲儿卜
𫢵	川添儿一卜
𨘗	之一曲米寸
𦵙	十卜添巛口
𪷄	添添月口儿
𠽇	口一添川二
𣄇	言乙人目十
𠽛	口一乙二巛
𨠉	梄寸之巛
厔	大大七二
𩆡	梄添之十巛
𪂱	儿巛卜曲十
𦟍	月一十巛人
𦜀	月一口一大
𢹨	寸添巛人斤
𣲍	添添一儿
𪉾	卜寸口巛竹
𤼓	广一十竹目
𪰃	言乙竹十米
𥧪	三一十之二
𪾋	曲寸又言目
𬆃	一添卜一目
𪽖	乙寸二乙曲
𩮔	三七斤之梄
𫡭	二一曲二乙
𢴞	竹寸目曲大
𨖼	之一竹目大
𩙻	乙七广曲之
𥑶	大一三卜梄
𨮈	斤一言曲儿
𠴑	口一十卜巛
𣑴	梄一添添二
𫜵	斤添
頺	竹梄乙竹大
𢰽	寸添儿又之
𩅀	梄添二米月
𦚖	月一竹添之
𪯛	言乙竹三巛
𪁴	儿巛人人口
𣼯	添添二言口
睈	目一口一三
𥃚	言米曲月目
𢚶	米卜斤添巛
𣠰	梄一竹又曲
𨃏	口卜川之又
𫃉	梄口米一巛
𤺯	广一又寸之
𫮹	二一十曲曲
𬎸	川二儿寸竹
䘜	之广目卜
𤽸	川曲巛大二
𫤠	竹二儿儿儿
𧦖	言寸竹添巛
𡱶	又竹口一口
𣗱	竹梄曲一卜
𣟂	梄一之目言
𦠯	月一又寸梄
𠸥	口一言寸十
𣎞	乙曲月人儿
𠽀	口一川目巛
𠳨	口一竹一巛
𤑉	米人川卜人
𪔡	目人二十又
𫥣	米一又竹月
阦	乙口米人
𣭃	口寸人寸竹
𥱬	竹言言寸乙
𬍄	月竹广梄梄
𥿂	巛一之巛
𩹹	儿一川卜又
𫐽	之一米曲竹
𫗁	月寸二之又
𡂅	口一目人儿
鴂	又添大寸儿
𢉽	广大梄十口
𩕳	之寸之一大
𨤵	曲卜二米米
𫇶	十卜一目二
𧒅	口巛目竹之
𠼷	巛言口七口
𢝜	米卜言之一
𪱡	月一人寸二
𬜜	斤乙竹人曲
𢸢	寸添竹巛大
𠤩	目曲巛儿儿
𩻻	儿一一曲曲
𠁑	十一儿一卜
撁	寸添言之竹
𦕳	三十二竹儿
熣	米人目目川
𪣱	二一言儿卜
𥺺	米梄目目言
䨔	梄添曲人一
𫡌	口一口米乙
䳧	儿巛川又竹
𬳕	米一川目竹
䁛	目一川口
𣗓	二寸梄一二
𫋩	口巛目儿米
𫺴	言七之口月
刦	二一巛言曲
伵	川添目曲
𥿀	巛一曲一
䓊	十卜二又口
𡏟	二一斤十巛
𨇉	口卜目曲曲
𬇅	竹七七口口
𠸼	口一之乙十
𤈤	米人儿人巛
𪵤	竹乙一卜口
𠻷	口一三一目
𥌦	目一二二梄
𫃔	米梄卜米乙
𧍊	口巛大二二
𬒼	二曲巛儿儿
𨹬	乙口口一口
𣖝	梄一十川二
𫱏	言七巛十人
𨀑	儿言卜寸口
𠦩	十寸梄一竹
𢲮	寸添三十卜
𪮦	寸添人一寸
𢤢	米卜二月米
𡀇	口一十曲二
𨁝	口卜十之乙
𡾫	目目竹竹大
𦟻	月一七大口
𪇌	儿巛曲曲大
𪟦	曲卜乙竹川
笣	竹言儿乙乙
𪸔	米人卜卜
𣵮	添添三卜乙
㕸	口一言米
𢯮	寸添曲卜月
𦨜	斤乙七竹
𧎛	口巛之人大
𣎊	月一又竹目
𦢳	之竹月一斤
猚	月竹川卜
𦓅	二竹儿人梄
𬈋	添添曲又目
𨱪	三七月言言
𨔊	之一言人十
𫡔	儿添卜卜巛
𪱮	言七月二目
𦂾	巛一之竹人
𢷂	寸添卜又米
𫆿	曲卜月之米
𫌄	之广巛大三
𢯠	寸添添添又
𧘸	之广一添巛
𤾰	川曲儿又卜
𣦰	大大竹口人
𬩍	之一儿儿米
𦼛	十卜二人斤
𥉸	目一七又二
𪿄	目一竹言曲
𤶺	广一口一儿
𫑺	梄寸竹一目
𬲄	月寸二人口
𥬉	竹言儿乙巛
𧢑	目儿又寸曲
𩟂	人又之一目
𤒠	米人二竹目
𪹷	米人曲十儿
䠏	口卜又一大
𨃋	口卜米一目
𨴦	又言三卜又
𤟂	月竹言巛月
檒	梄一梄一月
𨅰	口卜梄又一
𠻉	口一之一竹
𤔷	乙添竹儿又
𮬩	米卜儿巛
𪾭	目一梄一梄
𪬪	人寸卜曲之
𠳑	口一寸一乙
𫱩	巛竹又十又
𫶾	目卜人寸
𥙪	二曲巛添米
𫾝	广大梄目人
𫘃	竹梄曲曲儿
𩵿	儿一卜寸乙
𠁙	大卜言竹卜
𧔚	口巛之川乙
柆	梄一言米
𩕆	言米曲十大
𤸨	广一儿添曲
𫑽	梄寸又梄口
吔	口一乙卜
𨯛	斤一十二巛
𦭦	十卜言添三
鈢	斤一梄一
𧐻	口巛二一川
𬱍	川寸大人广
𦍛	米三言曲巛
𦇮	巛一斤曲二
𢇢	广大目目
𠺱	口一二月之
𠺲	口一寸添大
𠴤	口一二一之
𨌀	梄曲三十
𩅹	梄添添又目
𫪸	二卜又口目
𠈋	川添七竹大
𤓢	米人曲口十
𡂲	口一一儿曲
𥉫	目一言米曲
𡃓	口一寸斤曲
𫈨	十卜曲人川
𬢀	斤寸儿人目
𡃊	口一竹儿曲
𫧣	十寸目儿卜
𫇰	十卜卜添曲
𥸒	竹言曲口十
篘	竹言儿儿巛
澾	添添之二米
㯿	梄一巛人巛
𤮠	一巛十一大
𥉩	言米曲梄目
𡆗	口一之巛川
𨇑	口卜目儿儿
𫈜	十卜添添曲
𣼮	添添曲卜儿
𫤏	川添儿一乙
𥯒	竹言十七口
𪠺	口一寸添月
𠼵	口一川之一
膁	月一米曲人
𠴠	口一人目人
𫊿	口巛人巛十
𬛩	七一卜目米
𪅨	竹梄儿儿儿
𨨤	斤一米二巛
𩈘	一添梄口目
㗙	口一儿儿巛
鵉	言曲儿巛
𥳅	竹言之一言
𪺘	儿添又卜目
𪽏	曲卜人寸之
𤭵	一巛言米曲
𪬏	米卜竹梄曲
𫁧	言米人二寸
𫫺	口一三曲一
𬷎	斤寸一口儿
𣱭	竹乙言口竹
𪡿	口一月巛二
𥸷	米梄儿人
𢷁	寸添月目米
𦅰	巛一梄曲十
𫐹	之一又竹目
𥅿	目一寸添月
𫒬	斤一川儿儿
𦪨	斤乙口口人
𫷞	竹一十曲之
𨦀	斤一口一巛
𠶤	口一曲目口
𤬈	川添又竹斤
𤮗	一巛口儿口
𠸒	口一川口梄
𥧩	之人巛目人
𤯱	大寸一口竹
𥻠	米梄目曲竹
𡮋	曲人梄一竹
啺	口一曲儿斤
𪾦	目一卜寸又
𨫅	斤一川目十
𢱒	寸添米三大
𦅱	巛一口竹梄
𣦛	川添曲一卜
𦊚	目曲梄一一
秥	竹梄卜寸口
𣈘	曲一广卜口
𥜀	又竹竹二目
𪨐	又竹言大言
㵣	添添曲巛儿
𦤰	川目大又目
𤡌	月竹又一乙
𠻊	口一广十目
𡌢	二一人又口
𨀤	口卜三卜梄
𡭺	曲人竹添大
𤞖	月竹三卜梄
𨗊	之一二竹乙
𦗝	三十梄曲斤
𣐆	梄一七寸乙
𫫀	口一言一口
𬛕	梄一人之月
𪟅	广寸又大曲
𠴎	口一添竹大
𠯋	口一人一一
𫲤	乙寸口一乙
嚂	口一七竹目
𦝅	月一人乙之
矑	目一卜曲目
𦡬	月一人目巛
𪁆	儿巛斤一口
𢶹	寸添曲言曲
𪸽	米人川添七
𫻔	米卜目七七
𡮄	曲人之儿乙
焩	米人月一月
﨏	二一人人口
𠓇	曲人一又月
𪆣	曲一言曲儿
𬩥	之一大人人
𩺯	言乙竹竹儿
橬	梄一七儿曲
𢂜	又大大寸目
𣳢	添添儿言卜
𪬡	米卜曲又目
𥊣	曲人目十目
𡺥	目目曲目巛
𦟪	月一之一梄
𢭾	寸添十卜月
𢳆	寸添三乙竹
𣙙	梄一梄口竹
𥒦	大一二一乙
啌	口一之人二
稴	竹梄米曲人
𫣂	川添乙又目
㖺	口一三人
𦛼	月一斤二人
𦟏	月一广大梄
𤮞	目目川口一
𡄬	人寸一巛川
𡄁	口一广口竹
㖹	口一人乙目
𤞦	月竹竹一巛
𠸘	口一川人口
泑	添添巛巛乙
𡥚	乙一一卜口
𨧆	斤一大卜口
𥭶	竹言十卜言
𣆯	曲一人卜
𥸠	竹言目口米
𤺲	广一曲口竹
𨀽	口卜口一目
𤻼	广一儿一曲
刟	乙寸口一曲
𱏰	曲人一梄曲
塳	二一之儿三
𢱘	寸添言竹斤
𪤿	儿言儿曲二
𤶏	广一曲人一
𨇵	口卜二儿儿
𡆞	口一三二斤
𤑟	米人儿一曲
𤏧	米人竹一口
𬕹	竹言言一卜
𦣎	月一十二川
𢙔	米卜二曲巛
𦮲	十卜二曲巛
𢠧	米卜川人儿
苭	十卜巛巛乙
𬑵	米二竹口米
𱞋	米卜卜寸又
𨇗	口卜大竹卜
𣰳	竹七竹言曲
𦟑	月一川一口
𫯨	又竹竹一大
𪥔	之人二卜大
𤢗	月竹梄添曲
𠷇	口一言竹乙
𩄲	梄添之一米
𬖆	竹言言三十
𢥷	川目之又卜
𨘘	又竹竹梄口
𤮾	一儿十二
𣙫	梄一竹言言
𨅻	口卜之竹口
噒	口一米儿十
𩖅	曲口巛竹大
𡅬	口一米目曲
𨡨	梄寸十三
摙	寸添之一梄
𣄒	言乙人卜二
𬏡	广一七大
𦃐	巛一又言口
𬵿	儿一十梄目
𤚧	口一竹之竹
𨧰	斤一竹广儿
𥴘	竹言巛十梄
𧹿	二一米儿曲
𣈜	曲一曲一寸
𠻒	口一大大曲
袏	之广大寸二
𬀛	言乙言儿川
𤊧	米人十寸目
𠶥	口一之人乙
𩸯	儿一又又又
𣷰	添添目目大
鶮	言一口口儿
𪧾	又二寸目川
㦄	广大梄梄之
𧃷	十卜卜一一
㗴	口一又寸月
𢶸	寸添言口竹
吀	口一竹十
嗗	口一目之
𡈡	口寸巛儿广
𪃍	曲一目巛儿
𫣚	一添口二曲
𬦢	口卜又寸
𪤺	儿言儿卜巛
𣌌	曲一竹斤大
𥐒	竹大一米目
𧗅	竹添目十梄
𩁦	梄添曲川又
𫅚	米三大竹又
𬠼	一添儿竹目
䗊	口巛米人米
𬪪	梄寸梄寸
𥕄	大一二曲二
𪠱	三十又乙言
𱥤	竹七言米曲
𧞤	之广十川又
𣔩	梄一口大目
𫖄	川添又口目
𬁻	月一三卜梄
𣋚	曲一言曲儿
𬉌	添添口目人
𠉝	川添寸卜乙
𡿅	目目曲巛大
𣭛	竹七竹添之
𢬿	寸添七竹十
𫮒	二一大一又
𫬱	口一之目巛
𪅤	七一又二儿
𨖲	竹添十之梄
𢊫	广大二言口
𠺺	口一梄二二
𢃉	目卜口乙曲
𣺼	添添曲口儿
𪷡	添添口儿斤
𫊐	十卜十二一
𠅐	竹二人寸言
𥑴	大一言儿
𨲷	三七言曲一
𢹊	寸添米曲七
𣹓	添添十巛口
鏓	斤一川儿之
𡍞	二一竹大米
𠦻	米二二人儿
𦠴	月一三言又
𫑃	之一广又梄
𤿰	三一十卜又
𧤹	寸添川儿月
𦚐	月一之寸儿
𧅭	十卜曲一大
𠝼	十二梄一乙
𦰣	十卜川儿言
𦣗	月一人二一
𥢆	竹梄巛卜目
𪦆	巛竹大一之
𨫵	斤一口口一
𦡤	月一添川十
𦟗	月一又言川
𠦳	言米竹斤竹
㖠	口一大寸二
𬖏	米梄口一
𡳛	又竹米二口
𧼋	二人斤月
𢱝	寸添十巛巛
𤝫	月竹目寸二
躘	口卜言卜
𦠵	月一乙米大
𡄩	口一斤又之
𬴚	言一口之二
抋	寸添之巛
𥊖	目一二一川
𣷳	添添广儿言
𠿳	口一广曲人
㮿	梄一曲十二
𢀬	七添又又月
𢺁	寸添梄曲儿
𫾌	二一乙之竹
𧂄	十卜又儿川
啚	口一十口口
𩯮	三七斤人人
𬩇	之一乙米大
𥘀	大一曲十儿
𫉸	十卜一口儿
𫗸	米一川十曲
𥺿	米梄大一口
䈫	竹言巛目人
棦	梄一儿添又
𫉓	米一目梄曲
𬵎	儿一口寸目
𫦬	月乙目三乙
𨄵	口卜米曲十
𪁇	言一巛儿儿
𠄼	十寸目二又
𠶆	口一之川十
𬦃	二竹巛二米
𬲃	月寸二三巛
𫙌	二一二卜川
𥑲	大一曲一一
𡣨	巛竹十巛目
𨃷	口卜二口儿
𡝦	巛竹斤乙巛
𡯀	竹一十斤曲
𦣙	月一曲十儿
𡉏	二一乙二
𦀑	巛一言人曲
𱳆	川口目一
𦼨	十卜卜目人
𡮭	乙二乙人曲
𣋆	曲一又寸三
𬋆	米人梄儿卜
𡬷	目人曲寸寸
㩞	寸添米之梄
𬱹	月寸二广儿
𫥮	言一人一人
𢟛	三十之乙卜
勑	梄一人人乙
𠰭	口一儿竹
𬋚	米人儿斤之
𦡣	月一言口竹
悞	米卜口巛大
𡢼	巛竹十儿梄
𨀹	口卜添添二
𬎻	言人大儿卜
𢹪	寸添米人斤
𪫓	人卜又儿卜
𢯧	寸添人人竹
𥃱	目一人寸
𫏠	口卜曲竹目
𩆷	梄添人曲一
𧋆	口巛三卜梄
𪹣	米人卜七曲
䁩	目一儿一
鉷	斤一十一人
𡞖	巛竹广儿言
焾	米人人又之
𥺆	米梄口一三
𦡦	月一十曲二
𨀋	口卜川添二
𧵑	目人十寸口
𨣥	梄寸斤之儿
𡓡	二一儿竹大
𠺠	口一言米曲
𣊎	曲一二米月
𠱓	口一儿大乙
𫆮	月一乙竹巛
𢚵	米卜斤月
𥭍	竹言曲人大
𫊁	十卜添又梄
𩮕	三七斤之又
𣱰	竹乙人曲一
𠄀	斤添乙一寸
𨆏	口卜之米大
𫼿	竹寸乙乙竹
𢘝	米卜儿添曲
𠮿	口一目目
𡋦	二一一添川
𨊋	川三目曲目
唋	口一人寸竹
䆰	之人七口口
𪜢	言一卜添曲
𡂁	口一米二乙
𢴐	寸添竹儿儿
𦁽	巛一曲一三
𫘀	竹梄曲言竹
𧳘	斤月人又口
瀂	添添儿一曲
𠱌	口一七言二
𩹰	儿一卜寸目
𫑌	之一目曲言
𬈞	添添竹儿之
𢫫	寸添又大二
𦢉	月一之竹口
𡅏	口一二口米
𱶭	竹梄十竹目
𬜇	竹卜言寸
𡓯	二一斤曲二
𫣣	川添大一寸
𢲟	寸添之寸言
𬟜	一添儿十二
𥕥	大一七口口
㖫	口一二人儿
𬗜	巛一竹十十
𨒻	之一言人寸
𬲑	人又月乙曲
𦆟	巛一十一大
𠸬	口一川之又
㹟	月竹又添大
𣃤	又卜言乙
𪱟	三一曲三月
𦀖	巛一二巛乙
𣍅	三卜儿之曲
𦝆	月一巛大梄
𫴿	川曲儿言曲
𡏽	二一乙乙川
𤷂	广一月一乙
𫁰	竹言卜寸
䟘	口卜言一月
𪱨	月一言米曲
𥴜	竹言言乙口
䐭	月一十之目
𧋽	口巛十卜言
𢄯	目卜竹巛竹
𠀨	一添卜乙人
𣞊	竹一梄梄寸
𧷺	口一目目十
𡂉	口一寸斤言
𤔛	三十又言斤
𦳙	十卜七二竹
𠰁	口一一卜巛
𪡚	口一添寸竹
𫡝	乙添竹一卜
𩜫	人又梄一竹
𬓛	二曲梄梄二
𥩰	言米七添又
𢆁	目卜竹曲人
𤔻	十卜目儿斤
𥵿	竹言十一大
𥊞	目一口口一
蒥	十卜儿竹曲
𢟖	米卜添之又
𪷘	添添竹曲竹
𧏵	口巛言米曲
𢪰	寸添一添儿
𪤽	二一人儿儿
𫽺	竹寸曲目又
𪴏	十卜乙目又
惀	米卜人目十
𢠨	米卜竹巛竹
琜	三一梄人人
𬩟	之一目儿卜
𫂗	竹言之一米
𧸒	竹大一米目
𢫣	寸添广卜儿
𨃫	川添七曲口
𠓅	曲人一之梄
𥧎	之人竹梄曲
𨃉	口卜人二寸
𨰈	斤一十竹竹
𬟵	口巛竹添月
𥍛	目一目三竹
𩸳	儿一梄一竹
𬁄	曲一十二儿
𢠅	米卜三人川
𦝥	月一竹十川
𩠩	米一川人竹
𬰖	梄添川之儿
𢝙	米卜大卜目
𢵳	寸添梄梄梄
𩡋	竹梄曲大米
𬉣	添添人人竹
𬰘	三卜月一斤
𤫿	人寸竹梄斤
𩩖	目之三一十
𪅫	二一七一儿
𪡥	口一添十人
𢟗	米卜添曲二
𨖨	之一竹儿儿
𫛐	口寸七一儿
踷	口卜二竹
𥝎	竹梄乙七
𠵘	口一又寸
挄	寸添曲人一
𩸮	儿一三人二
𢵮	寸添又人口
𢵻	寸添添添二
𤒚	米人添曲大
淎	添添三人二
𬗩	巛一大一斤
𢠆	米卜之又月
𢬧	寸添竹一十
𡁎	口一川卜人
𦞁	月一十七口
𫡂	米一又米曲
𥽎	米梄巛曲人
𪿸	大一大儿卜
梞	梄一乙乙之
𣡓	梄一竹竹目
𩼨	儿一儿又卜
𠡎	曲一一添乙
㾿	广一言又乙
𫽭	竹寸口一目
𢖀	人卜又口口
𠾣	口一梄梄梄
𣛡	梄一之目巛
𦲾	十卜添二巛
𫯇	二二又二米
𡮉	又寸曲人
𣭰	巛言竹二竹
𧖦	竹一巛巛口
𨃾	竹梄儿曲口
𩢬	三米卜寸又
𫗃	月寸二曲之
𦁣	巛一乙一斤
𧟝	之广斤川又
𨁱	口卜又竹竹
𬵘	儿一十月二
𥋳	目一目目川
𢱐	寸添巛儿添
𣹟	添添二卜目
𬝴	十卜言人川
𩻟	儿一斤米
𠤌	儿乙斤言二
炩	米人人寸之
𥮈	竹言大十十
𫂋	竹言十二梄
䋥	巛一曲卜二
𠵽	口一添二巛
𢠇	米卜言竹十
𩻒	儿一竹言言
𦤾	七二曲一一
𠍣	川添寸添曲
𠹱	口一添又梄
𤞓	月竹竹二儿
𡮨	目曲目人曲
𨳒	又寸曲人
𫦵	之寸一目乙
𥈵	目一梄一目
𠲡	口一巛竹乙
𢶷	寸添儿乙竹
𤀚	添添十人梄
𫑏	乙寸二之大
𤛇	竹二十目人
𧎜	口巛又竹七
𢠪	米卜目二二
𠶛	口一言口曲
橯	梄一米之乙
𬗆	巛一乙一巛
𤐜	米人目目川
𬡹	梄口川添川
𫸈	广大之儿十
𢵩	竹寸乙米大
𠏳	竹十曲巛人
𢬨	寸添添添巛
𬝮	十卜米广十
𤶜	广一巛大二
𢯢	寸添之竹斤
𨅀	口卜米梄言
𥯌	竹言竹大口
𫐿	之一梄口竹
𤝞	月竹梄一言
𫆧	月一人又二
𬈢	添添言米儿
𦷨	十卜人十又
𫉮	十卜言曲儿
𣠕	二寸梄大二
𡮷	曲人七又目
𦒮	言卜乙广乙
𠽔	口一又梄口
𪸧	米人口一目
𪾁	川曲添二巛
𧍝	口巛言之目
𨁧	口卜目目人
㕭	口一竹添大
𢀧	七添又目十
𥐋	竹大一十人
𫔤	又寸言人二
褠	之广十目二
𡪇	之寸一儿斤
𣱆	之竹儿七
𧥇	儿添月目川
𢚽	米卜添巛乙
䀩	目一儿卜口
𥩍	之人七儿曲
𣾺	添添又一十
𨅼	口卜十人人
𪮔	寸添添儿口
𫘶	斤二言目口
𫤑	川添之川又
𢵼	寸添二七巛
𢣀	米卜大一寸
𢲤	竹寸言目口
𥖩	大一人目曲
𨃹	口卜添言又
韈	十十十七言
𬔈	之人曲二
𫓒	斤一曲曲大
𨮌	斤一又卜大
𨓑	卜一之一乙
𫄓	巛一目米大
𫐂	之寸曲巛梄
𪩨	儿添目七又
𢪷	寸添目一
𦀎	巛一一儿曲
𤉕	曲二大寸米
𧍍	口巛梄人人
𠍦	川添曲又目
𨁎	口卜口一三
㭳	梄一二竹乙
㺗	月竹口曲一
𦄻	巛一巛乙目
𡤔	目曲目巛口
𩙍	月卜人曲之
𫐝	言十言巛人
𧍈	口巛广卜口
𡳒	又竹竹曲巛
𩂶	梄添一儿曲
𦾢	十卜梄十巛
𩛜	人又言人寸
𥐈	竹大米巛竹
𤠋	月竹米梄巛
哰	口一之寸竹
𡂳	口一大大大
𤌅	米人乙儿十
𡓮	目目川人二
𫻜	儿乙斤大米
𧤁	儿添月人儿
𬂑	大寸月大竹
𤊰	米人言曲又
𤊪	米人曲一人
𫷚	一添米月月
𫴷	又二寸大大
𧹰	二一米竹曲
悜	米卜口一三
𢣆	米卜目目口
㧯	寸添二竹儿
𣟪	梄一三大寸
𬍌	月竹儿口大
𡣄	巛竹添乙广
𢱓	寸添添竹儿
𩩫	目之曲一曲
𬚺	目寸人广儿
𪬭	米卜又斤又
𦀊	巛一大寸乙
𡳢	又竹言二乙
𢳠	寸添十大十
𧋘	口巛米乙川
𨃵	口卜月米大
𡅍	口一巛二一
𡦶	乙一斤广十
𧑐	口巛又人口
𨷈	又寸十目巛
𠶔	口一米又二
椲	梄一又口十
𥇷	目一目目大
𫠢	卜一一卜
𪿍	竹大口乙曲
𬋳	斤添二乙又
𰇮	乙添人一口
𣺺	添添人卜二
𪝈	川添斤之又
𢠈	米卜人乙目
𤂨	添添梄曲大
𨨫	斤一斤添梄
𠙣	月寸目二巛
𥋸	目一梄添曲
𣜻	二寸曲大寸
𣌋	曲一人人儿
𬉎	添添月曲二
𩂑	梄添月寸二
𫣙	二寸曲口人
𡮗	之一曲竹大
𥁷	添添竹之目
䓔	十卜二竹乙
𬙿	米三米口月
𨳦	又寸又言又
𣜱	竹一梄目十
𠵨	口一曲一寸
𧐿	口巛目之二
𢚁	米卜乙乙之
𢱞	竹寸十巛巛
𠼯	口一言竹十
𫜗	广大梄儿曲
𧀟	十卜巛又目
𪪩	三一十十米
𦄾	巛一曲米米
𣈰	曲一米一目
㹭	月竹曲梄竹
𠴫	口一卜曲又
𫇖	竹卜言人口
𥌈	目一七竹目
𤮟	一巛二一川
𥵖	竹言月曲之
𬯩	乙口一儿目
𣙦	梄一广二寸
𪷃	添添曲又目
𪦲	巛竹巛目目
𨂙	口卜言口曲
𪯼	言乙言人川
𡋂	二一竹一十
𥯍	竹言梄一竹
𠲥	口一二曲巛
𦛊	月一大卜乙
𢶾	寸添竹大川
𠸜	竹二儿儿口
𥚤	二曲巛人竹
𫈃	十卜月竹三
𬨖	言十乙七
𡳜	又竹竹竹乙
𩹭	儿一寸二寸
𨄙	口卜儿巛
𩛃	人又斤言
𬆒	一添儿儿卜
𡣻	巛竹之十梄
𠲢	口一口一目
𫢼	巛言口川七
蜅	口巛梄二
𠽘	口一二川口
𠿯	口一目目川
𠲺	口一目乙人
㵧	添添十人巛
𠎩	川添曲三之
𠖯	广寸竹一乙
𡍛	二一斤竹二
𥻻	米梄巛目人
𢣈	米卜巛人竹
𦃀	巛一人二寸
𫌠	川添梄一目
𲃟	口卜人二巛
𢮬	寸添巛巛曲
𥠭	竹十曲二竹
𬉝	添添斤儿卜
𤽗	川曲卜寸一
𠄶	川添竹二又
𫺲	月一儿儿之
𠢟	目三乙寸月
𪭳	竹寸又人
𪡦	口一广卜又
𦹱	十卜目人斤
𤈡	米人目目一
𪹾	米人之又二
𣖘	梄一巛一二
𫵊	曲人竹二口
𭆺	口一一十
𫴲	又二寸二乙
𬠳	口巛十之儿
𥚯	二曲巛儿斤
𧐽	口巛添米米
䊷	巛一寸言竹
𠵐	口一米二巛
𣰵	竹七言卜
𨕀	之一竹乙竹
𡐯	二一大川儿
𪵚	竹七言一巛
𦬻	十卜巛竹又
𠲟	口一川添竹
𣮮	又竹目一竹
𤻔	广一十卜二
𪽞	言米曲梄曲
𫸱	乙巛二曲巛
𦎛	米三巛一口
𪱕	曲一三儿卜
𡮠	儿添曲又目
𣙮	梄一言川二
𠎴	川添又大目
𨮋	斤一人曲之
𬏘	曲卜十十巛
𤄰	添添言斤大
𪟳	竹一十儿卜
𤻎	广一梄梄二
𩂄	梄添一添巛
𬮎	米三大寸又
𫑋	之一梄巛竹
鐷	斤一十巛梄
𤑮	米人十大竹
𡇻	口寸言人十
栍	梄一竹三
𫫑	口一乙人十
𢙲	米卜口一口
㮩	梄一川目之
𧛊	之广十一曲
𪰤	曲一添添巛
𫅴	二竹儿巛又
𪥞	米三目梄大
槣	梄一之一口
𠴞	口一川添米
𢆧	二一米梄竹
𥻽	米梄大二口
𢦄	米卜川言川
𣱬	人言大竹米
𫶱	二卜一曲十
𫯿	二言又一十
𢤝	米卜竹一口
𣆱	曲一大卜乙
𫠸	卜一添曲月
𪠉	大大卜儿卜
𫏙	口卜寸斤巛
𪨄	曲人竹乙目
𨖅	之一言又乙
𢮀	寸添之广乙
𱪤	米人一儿
𫧪	竹添十曲大
𦓡	广大梄梄大
𣋑	曲一十巛梄
𠹌	口一巛儿儿
𡮸	乙二乙曲大
𨧝	斤一川曲一
𡗐	十卜目七又
𤯶	曲寸二二竹
𫄈	巛一十儿口
𣋃	曲一人口曲
𬌓	川又之巛
啂	口一斤乙巛
𨩠	斤一曲竹目
𢩿	寸添二二
𪺖	斤添之目卜
𦡡	月一大一寸
𧰜	卜七一曲二
𫯩	大寸十一大
𠎨	川添巛一口
𠶀	口一之人梄
𪾝	斤乙目人儿
𡐚	二一儿一
𦓉	二竹儿儿口
𣙩	梄一目之二
𪽅	广大儿言竹
𥈰	目一添十人
𠶑	口一米梄巛
𥌫	目一竹巛大
𬳘	米一川曲月
𡄎	口一斤川目
𤝋	月竹言人
𫤩	目寸人又儿
𫃶	巛一添儿口
𪶩	添添巛口之
𤌣	米人梄口梄
𪱘	曲曲月梄巛
𣉍	曲一曲一儿
𣰴	竹言言曲竹
𠺼	口一米梄儿
𫪹	三一十十口
𨄴	口卜二米月
𥱮	竹言寸斤巛
𥋺	目一之斤川
𠠊	目寸米二曲
𦝍	巛大梄人人
𡮵	曲人目曲二
𧊕	口巛七竹大
𩿨	斤二儿巛
𪿱	大一斤乙目
挒	寸添一儿曲
𨉠	川三寸添米
𢅬	川曲目目人
𢥪	米卜十二川
𠌦	川添巛目人
囕	口一七目目
𦋕	目寸人人又
𡆌	口一三目口
𫾆	寸添之目巛
𠊝	川添七巛口
𥶄	竹言巛口竹
𠽑	口一一十又
𩆋	梄添寸十巛
𨎠	曲卜儿口梄
𬔔	之人二言曲
㩃	寸添之人广
𢹆	寸添言儿川
𥴚	竹言川添十
𡃛	口一言米又
𥰄	竹言十儿口
𧘪	之广七卜
𬥬	人一乙言川
𢭑	寸添竹又言
𢯗	寸添竹梄乙
𪻃	月竹人又二
㕰	口一竹七
𤹪	广一七口口
𧧯	言寸曲人一
𪖫	川目曲竹巛
𢆨	梄一儿二米
𪷔	添添月儿儿
𥗏	大一米三言
𤉇	米人口巛大
𦠳	月一又乙乙
𦗽	三十广儿言
𣉸	曲一言寸乙
𱳍	目一口儿口
𤏪	米人米之乙
㛎	巛竹口一口
𣟮	又言又人儿
𬀦	一添巛添曲
𨆺	口卜添梄二
𠽦	口一添一口
𣒾	梄一十卜月
𬞷	十卜言月三
𡉦	二一竹一十
𱢎	曲一之广乙
𬰢	之寸之口目
𠱤	口一三卜梄
棿	梄一川二儿
𫲎	巛竹十大米
𬆈	一添卜目口
𬛠	言一巛斤巛
𪨅	曲人竹大川
𪿙	大一大寸米
𤷮	广一人言三
𫮷	二一曲言口
䐗	月一二竹
𥚇	二曲巛添竹
㩫	寸添斤斤目
𢲥	寸添斤一十
𦟋	月一川言口
𨠵	梄寸曲人一
𬩁	之一十乙曲
鎫	斤一川人儿
𫤎	川添儿一卜
𫺎	米卜三卜乙
𠅻	言七添口月
𥾛	巛一七寸乙
𩻹	儿一十十月
𣲠	添添一添儿
𦝈	月一曲大人
䖴	口巛儿寸添
𣜸	梄一曲之梄
𤀓	添添二巛曲
𧿳	口卜乙巛川
𫮥	二一川乙人
𪱴	梄一巛竹
𤭚	一巛竹二口
𬷞	梄一梄一儿
𤬪	二一一巛
𢆫	竹一十一曲
𠾕	口一乙米大
𫅟	米三大卜又
𢁑	乙曲梄儿目
𤋻	米人添斤儿
𠞢	三一曲三乙
𫤍	人寸三目十
𫮇	二一大人人
𢭶	竹寸又竹竹
𣘊	梄一人卜二
𫆽	言一巛儿儿
𤁘	添添言曲口
𡁞	口一言卜又
𬖷	米梄卜又曲
𤖶	川又一目人
𢯒	寸添十卜大
𫌖	之广二二梄
𢵭	寸添十人人
𤇊	米人一米十
𫙔	儿一卜寸又
𢙵	米卜人大口
𠬉	二一巛儿又
𦀴	巛一十卜言
𤒦	米人人人竹
𫂝	竹言儿之儿
𧹟	二一米之儿
𠯅	口一七言
𡀡	口一添乙广
𥼱	米梄竹目口
𪿥	大一梄一竹
𣈚	曲一巛大大
𦵛	十卜竹巛巛
𡣧	巛竹大目目
𪡴	口一言寸乙
𨃊	口卜卜口米
𦄸	巛一言人巛
𫒃	竹十曲又儿
𪯵	七添三一言
𡳁	又竹米大言
𩿙	儿巛七竹
𧎴	口巛寸斤口
𬧆	口卜目乙七
荱	十卜又竹竹
𡹠	目目之寸目
𡁾	口一言口儿
𪆧	儿巛二七巛
𬑅	目一儿添卜
𤶈	广一梄口
𣻆	添添乙竹巛
𣐳	梄一口一人
𨮵	斤一十一大
秲	竹梄二一寸
𦄄	巛一又口乙
𩪞	目之乙十人
𦝊	月一之一巛
𫮋	儿言卜人二
𢃊	大寸目一口
𫋨	口巛言梄目
𤆈	米人乙添竹
𪜝	又言又卜十
𬇁	竹七目言又
𤀜	添添目三月
𡹡	目目言口曲
𪠞	儿言儿二巛
𦆹	巛一曲米寸
褀	之广十三
筪	竹言七添曲
𧣧	儿添月大乙
𫸊	广大十巛儿
𪥯	儿添卜巛又
㕵	口一三一
𣊘	曲一儿一
𠸓	口一寸添竹
𣔡	梄一二一又
𠽃	口一二米月
𤃛	添添梄二斤
𪭮	寸添人人人
𥽡	人一乙十人
𪡩	口一目大米
𢚷	米卜梄曲
𪟐	人一乙斤又
𧹱	二一米十巛
襎	之广斤梄曲
𡀱	口一口一卜
𣒣	梄一十卜言
𨡉	梄寸又之又
𢁍	乙曲斤米
𠸪	口一添儿口
𣙪	梄一广梄梄
𢏡	乙巛竹二儿
𬜎	竹卜目竹之
𪾺	之寸之目目
𡳣	二竹乙又言
𠾾	口一添曲曲
𫂚	竹言梄竹巛
𩼢	又竹口言儿
𬝐	十卜卜口米
𨮑	斤一川目川
𪿹	大一卜目巛
𥹵	米梄梄一口
𠃝	乙七曲人
𡼸	目目竹又二
𢵲	寸添口竹斤
𫤈	川添人之又
𢃈	目卜三一十
𪥷	川添川曲巛
𠻅	口一大竹之
𧶮	目人口十口
䈊	竹言二人儿
𩽖	儿一竹言三
𥌥	目一言曲梄
𥑥	大一竹三
𥷒	竹言大竹卜
𠰂	口一一添一
𦛜	月一人又口
蘝	十卜人人儿
𫒅	竹十曲又又
𨭑	巛一言儿斤
𡎤	二一米三大
𤠹	月竹十之目
𥇀	目一十卜言
㨶	寸添儿巛
𣑌	梄一巛乙口
𥆂	目一川竹二
𣼩	添添乙二巛
𬲞	人又巛十梄
𥓸	大一之广斤
𤡱	月竹口一目
𤗆	川又竹一巛
𪮭	寸添二儿曲
𣎃	月一曲目口
𩜽	人又言大斤
𫏓	口卜竹广儿
𠠩	曲卜儿月曲
𥃞	又大一人巛
𤄮	添添二儿儿
𥉬	目一一曲米
𤀏	添添言七二
𪮨	寸添添人梄
𫆡	言一巛儿卜
𦠆	月一乙十人
𬙴	米三大一巛
𧁺	十卜巛一口
𬊢	米人又言目
𦪃	斤乙之一大
𠄺	二寸川寸目
𪡑	一卜口添巛
𪢣	二二口曲月
𡭦	曲人梄一一
𤍇	米人大七寸
𣒳	二卜梄一三
𣘆	梄一巛目人
䈹	竹言之一川
𩫦	言一口人斤
𨁥	梄一二一口
𫺧	米卜人添口
𢟚	米卜言口月
𫌎	月一米儿言
𬛟	月一二乙目
𤐛	米人又言目
贑	言米曲二目
𢜫	米卜曲竹目
𢌊	广大十三十
𦧜	竹卜一口人
𦲒	十卜大二二
𨁡	口卜斤添巛
𫖧	大人曲口曲
𤥑	三一言七巛
𠿷	口一又言目
𨅁	口卜竹言言
𥄫	目一乙添人
𫴼	又寸寸竹曲
𦁁	巛一米又卜
𦁸	巛一人口乙
𬁏	言人寸儿斤
洷	添添七二
䉒	竹言斤梄曲
㙴	二一儿人言
𤹿	广一儿一
𤅶	添添言巛竹
𧑆	口巛言曲二
𧞾	之广目米大
湥	添添之人大
𨄞	口卜之梄口
𩄶	梄添米梄儿
𠖭	广寸又乙
𡭰	儿寸添添曲
𠩕	大大米梄
𣦎	一添卜目口
𪽩	广一川乙竹
𣷠	添添曲一月
𣇟	曲一之寸竹
𪡫	口一二口儿
𠶍	口一梄之儿
𫩺	口一又言广
𥶱	竹言川曲川
𧐹	口巛竹儿儿
𩠓	米一川竹乙
𦟿	月一二一川
𫥫	又竹七巛巛
𤗖	川又乙一目
𩾰	卜卜儿巛
𣒠	二寸梄一曲
𪳴	梄一月二巛
𢽼	乙曲人人竹
𣙨	梄一竹言又
𬩏	曲添言梄口
𡮈	斤添乙巛曲
𦛋	月一二二口
𨅉	口卜言又月
𪞀	曲人一儿卜
㗩	口一乙乙川
𫊹	口巛人二巛
哴	口一言添又
𢥆	米卜竹言曲
涖	添添川添言
𩹤	竹梄米人儿
𬞕	十卜又梄目
𩂐	梄添竹添二
𣁔	言人口七又
𢞄	米卜二一口
𫠷	卜一川三二
𬛙	月一三米十
𢙪	米卜言人寸
𫴚	之寸之言又
𬈓	添添之又儿
𫇀	月一大竹卜
𬹹	卜人十十人
𫯊	十二梄儿乙
𠽊	口一竹巛竹
𫯲	目三乙大乙
𣞶	梄一二二梄
𡤟	巛竹乙大大
𩺋	儿一广卜乙
𧏶	口巛乙口梄
𫾑	寸添竹言十
𣖢	一添梄人十
𥍑	目一梄目口
搎	寸添乙竹巛
𠳹	口一广大梄
𫆉	竹梄米人三
𩆪	梄添十七言
𥺏	米梄口一儿
𠼳	口一十竹乙
𩝺	人又寸斤巛
𫉼	十卜目儿卜
𡏡	二一言米曲
𠱀	口一又卜
𡀯	口一川梄寸
𱿂	十卜曲巛大
𢋴	十一儿儿言
抯	寸添目三
𫬍	口一曲三言
𤇢	米人川曲
𦙫	月一一添卜
𡗉	二一二儿儿
𭢥	寸添十儿口
𣛢	梄一又竹目
𪮊	寸添言曲十
𪳫	又言又梄曲
𢟓	米卜之寸言
𫵡	又竹竹月一
炪	米人巛曲巛
𫢩	又竹儿言又
䀧	目一十一人
𫭧	二一乙竹乙
𬛛	广卜儿月十
掋	寸添广儿言
𥬩	竹言又竹儿
䖷	口巛人大目
𡽫	目目巛口竹
𢴙	寸添口人人
𦁾	巛一二目大
𣗑	梄一乙口梄
𫙍	川口乙一目
𡉕	二一月口
𬖭	米梄卜曲一
𧷸	目人十曲大
㩜	寸添七竹目
𤻓	十三广目人
𢟒	米卜巛儿儿
𢝆	米卜竹曲二
𤿦	又卜儿言儿
𬩲	之一斤又二
㨋	寸添二竹
𫴞	之寸之川乙
𥨋	之人七三十
𥪸	言米竹二寸
𣞻	梄一目儿儿
𡄡	口一言川曲
𬵤	儿一寸言巛
𧒍	口卜儿口口
𤃜	添添之曲曲
𬇮	添添月又言
𣽊	添添卜人口
𠎪	川添又米巛
𢯥	寸添十一一
𫶵	乙曲乙添竹
𫽿	寸添川添十
𱹵	巛一又寸之
𣂋	之竹广竹口
𣍕	曲曲二二一
𫇟	斤乙曲三之
𢮭	寸添目三人
秷	竹梄七二
訔	目目言寸
𢟏	米卜一曲米
𣔞	梄一乙一斤
𤶐	广一大卜乙
𩶪	儿一七二
𠾦	口一曲三之
𠼺	口一米曲一
𬳨	三米又二
𡃚	口一广人二
𡍙	二一十月二
𩠭	米一川又七
燶	米人曲曲大
𪶾	添添乙目人
𢆥	十寸目竹十
𪞴	月寸言寸十
𠳺	口一言人口
𢹩	寸添梄梄目
𫘼	三七斤三曲
𬧮	川三巛目人
𨭡	斤一添斤川
橽	梄一之二米
𢢅	米卜十十月
𱓄	口一十月二
𫄋	巛一言二寸
𠓺	竹一十米人
𬪮	梄寸大一十
𡎦	人寸人儿卜
𬠢	口巛二曲目
𠐅	川添三之目
𠳘	口一川卜竹
𧋹	口巛一大卜
𥃨	目一卜寸
𤸭	广一人卜二
𣍍	之之儿言曲
𥶮	竹言梄目川
𩇛	竹三三卜月
𥻺	米梄斤巛大
𣉶	曲一三梄竹
𡀵	口一言一一
𦹵	十卜曲十口
𤈞	米人三卜梄
𫑊	之一乙口目
𣼹	添添目一又
𤁕	添添言梄口
𠾷	口一二乙又
𦅭	巛一乙米大
𡉖	二一乙巛
𫬩	言一米十十
𤢤	月竹言口竹
𥮋	竹言川梄一
𦩛	斤乙目三人
㘙	口一口三竹
𬦄	二一米二目
𬳙	米一川广曲
擃	寸添曲曲大
𡓆	竹言言人二
𫽎	寸添川儿儿
𥾃	米梄言巛口
𱓳	口一目一卜
𤁛	添添二竹乙
𰔐	竹寸斤米
𣕃	梄一曲目巛
𩷇	儿一人巛儿
𬛦	七一卜寸言
𦲺	十卜川口人
𡂀	口一梄目口
𤎜	米人言又月
𣁲	广寸十儿广
娫	巛竹乙竹卜
𤘋	七卜竹寸七
𣫲	巛乙川添一
𩵽	儿一之巛
𠂎	竹添巛人
𩴅	川口三乙大
𡮪	曲人十三儿
𤃧	添添寸二米
𧋺	口巛二二之
𨂕	口卜梄一梄
𱱽	川曲言又月
𠞡	目之曲寸
梹	梄一斤二人
𬙵	米三大目人
鮉	儿一乙寸口
𫯡	大寸一米十
𬊴	米人曲广儿
𫗶	米一川米寸
𪟼	言一人十人
𫢫	川添七十巛
𣹔	添添之目口
𨮐	斤一之十目
𣈛	曲一竹卜曲
𧷹	目人之竹口
𪺇	米人言巛川
𤘁	川又十一大
𤀖	添添目目川
𬜝	儿添乙巛竹
𬚈	乙广乙曲人
𤏤	竹梄人目米
𧔙	口巛曲人曲
𩯯	三七斤口儿
𢲪	寸添二曲二
𬳛	米一川巛竹
𡭻	曲人大一巛
銊	斤一七大一
𣩂	寸添斤儿儿
𣋾	曲一言曲梄
𬝗	十卜米卜言
𦡶	月一七竹目
𠿄	口一之目巛
𬗗	巛一寸添斤
𥗨	大一十十儿
䄇	二曲口一三
𠶕	口一添乙口
㾾	广一米曲人
𡔿	二二之一大
𫻉	乙寸言儿目
𬲁	月寸二目米
𤚇	竹二米三又
𨀏	口卜曲一一
𤠰	月竹十目二
𫖂	乙寸二口目
𫵍	曲人卜曲大
𪠠	巛言竹巛人
𫫜	口一月三月
𦼚	十卜梄梄梄
𬲉	乙七广寸川
拰	寸添川竹二
𡑝	二一米儿十
𢌌	三一十曲人
𧔿	口巛月口川
𦠘	之竹月人人
𦥃	七二目十人
𤬲	一巛目寸人
𪭇	米卜米言言
𫐪	之一乙儿曲
𥆽	目一口言又
𪾉	又卜三十乙
𥹘	米梄一目人
𩈩	又添口二乙
𡫐	之寸言曲人
𦷯	十卜二曲二
𠒬	曲人一口一
𢩤	之竹川目又
𤲼	曲卜一曲竹
桗	梄一乙竹梄
𫊮	口巛卜寸又
𦛾	月一米又卜
𧜺	之广卜七斤
𢢽	米卜斤月又
㮈	梄一大寸二
𤊤	米人目目大
𩘩	月卜之一又
𦄺	巛一言又月
𨄃	口卜之一大
𡮞	之寸三曲竹
𣱼	添添乙寸
𦨂	十二梄儿十
樍	梄一三卜目
𬰊	梄添之一言
𥇂	目一口乙曲
𡭱	巛曲巛曲竹
掿	寸添十大口
𢯝	寸添添添米
𫿹	十卜目卜斤
𧎸	口巛言目口
𥉯	目一梄二二
𫇁	月一竹人儿
𦀍	巛一大大卜
𦂛	巛一言竹乙
𪵲	添添口寸巛
𦹺	十卜言人目
𡝃	巛竹卜卜曲
𫔭	又寸一添十
𢒞	梄一目曲斤
㓶	三卜乙大曲
垉	二一儿乙乙
撘	寸添竹一口
㹥	月竹言添三
𧺃	二一米二目
𩗃	月卜目三
𫽂	寸添十人乙
𠍥	川添目竹之
浗	添添一曲言
𫼙	竹寸儿七
鑥	斤一儿一曲
𢬗	寸添三卜梄
𢧚	竹一十七乙
𬆗	巛言口儿儿
𤵊	广一一添巛
𬩓	大大卜梄口
𡮺	七一又目曲
𪢘	口一言梄口
𧻭	二人曲梄竹
𢳙	寸添之儿添
𫵟	又竹言竹七
𦁿	巛一巛十口
𡼈	目目二米月
𢲬	寸添一竹梄
𥀳	又卜梄曲大
𢲦	寸添三十七
𣟭	梄一口口三
鋦	斤一又乙口
𠼦	口一曲目又
𦑗	之竹乙又大
𨂔	口卜言巛月
𥻢	米梄口一川
𩶱	儿一之竹七
懢	米卜七竹目
𢩪	寸添又乙
𫏝	口卜米梄目
𥐍	竹大一口米
𨷶	川二一二又
𱎃	添添乙竹乙
𣆰	曲一大寸乙
𨇓	川添人人口
𡶨	目目大大竹
𧋁	口巛一目二
𨢟	梄寸十巛人
𢴖	寸添之竹口
𤀔	添添人又儿
㖇	口一大目
𪃵	儿巛梄曲一
𫦓	言乙竹竹乙
𧖱	竹添目梄儿
𠓬	言人口一人
𫅞	言添又米口
𪦚	巛竹目人竹
𫃷	巛一又竹目
𠑈	川添添竹目
𬏴	广一米又二
𨙥	之一三口口
𢀦	七添又之斤
𥢄	竹梄川人儿
欗	梄一十梄目
𤷱	广一又寸
𠺧	口一川儿梄
𫶰	米三二十又
𨫊	斤一梄口梄
𫐚	言十梄一乙
𨀻	口卜七竹大
𠀪	十三言添
𢭷	寸添二一言
𬴑	三一十卜目
𠁝	米一曲一口
𤋵	米人人二寸
𡅌	口一竹又月
𢭳	寸添梄寸
𫇥	十卜卜寸
𣼾	添添三十儿
𬓞	言一人二巛
𨇬	口卜曲斤儿
𩙹	之一儿乙广
𩄨	梄添目之
𩅙	梄添巛人斤
𪻟	三一乙大目
𠺟	口一广大梄
𥷻	竹言梄之米
𪰿	曲一一之乙
𠲨	口一添添乙
㒷	目寸人一人
𪽱	广一之人乙
𫔯	又寸广寸十
𣜷	梄一竹米之
𧣳	儿添月人口
𬏻	广一儿巛竹
𡋁	二一米一目
𬮜	又寸一添大
𥊠	目一目之二
㮲	梄一儿儿巛
𬉆	添添又米巛
𧐖	口巛之一梄
𬋟	米人曲十儿
𡃿	口一寸二米
𬛉	广卜儿人巛
𠲖	口一言儿
𪡇	口一川儿曲
𫥊	广寸儿大乙
𡥥	乙一儿言儿
𤞧	月竹口寸梄
臁	月一广曲人
𥾘	巛一二一
𢥇	米卜口一七
𥻮	米梄之寸言
𫥘	广寸人二口
𫹊	竹寸一一斤
諪	言寸言之一
𪾆	又卜儿添卜
𫶳	二卜目曲二
𬖽	米梄添人人
腀	月一人目十
夦	十三巛儿儿
疪	广一儿儿儿
𪿘	大一巛言口
𬁊	曲一人人竹
𢵯	寸添目曲目
𠛣	曲一一添曲
𢖖	米梄巛巛儿
𣵵	添添目乙人
㑍	川添三卜梄
𪰂	言乙乙川目
𫬮	二卜又人十
𢬄	寸添广寸曲
𣒴	梄一竹乙竹
𡸇	目目儿卜梄
𪅧	二一川卜儿
𢯟	寸添二曲一
𬈭	添添竹二乙
𫥌	广寸三一十
𬪐	米一人曲乙
𫑾	梄寸言口二
𬧡	川三言一人
㐌	竹一乙卜
𢞅	米卜梄口巛
𬄅	梄一添曲二
揂	寸添米寸梄
𪥉	一添大寸乙
𥌀	目一之又二
𪢒	口一米巛竹
𧑃	口巛三乙竹
𦞔	月一米曲一
𧋉	口巛人人口
𡖵	言一川卜口
𢖺	米卜七言
𬸴	卜寸口口竹
𫤡	曲人一曲巛
龱	口寸人言
𠅍	一添梄一言
𣑁	梄一言巛儿
𠼪	口一竹儿儿
𫸷	乙巛卜三十
𡨹	之寸寸之一
𠖿	广寸月二
𢸵	寸添又言二
𱟦	之一儿之言
𣋨	三人川之又
𧌀	口巛一大口
𪓫	梄一斤三之
𡑖	二一乙米大
𥌙	又竹目广梄
𦛻	月一梄一寸
𡍚	二一梄一梄
𤐚	米人言曲儿
𩯂	三七斤七儿
𩩪	曲一曲一目
𬋰	竹言竹七斤
𢭮	寸添乙乙竹
𣦓	一添卜卜目
𪻈	月竹乙巛口
𱘅	二一口儿口
𩵾	儿一十寸又
𬷩	川卜又言儿
𤮿	十二一儿
逎	之一梄寸
𠀿	一添卜口儿
𤃢	添添广口竹
𡆚	口一人目川
𬰆	梄添添儿又
𧹅	二一二乙目
㝹	曲人竹儿言
𠴘	口一梄一寸
䱊	儿一米梄
𢷄	寸添添一米
𤠷	巛曲一口大
𣉎	曲一梄曲一
𣑻	梄一竹一十
𥶳	竹言巛一口
𡀦	口一添曲目
𠺦	口一川十曲
𤞒	月竹十一人
𧣲	儿添月曲人
𪱂	曲一月竹二
𬒧	大一又川二
痶	广一目十人
㤳	米卜大卜口
𬇏	竹乙梄一
𢴉	寸添十人竹
𣼶	添添又寸口
𡂷	口一之目言
𫥏	广寸梄一竹
𣗿	梄一二曲目
𫹗	人卜曲一言
𬘊	巛一目儿儿
𬖪	米梄又米十
𬊽	又二米二又
𨦧	斤一竹一十
𥮊	竹言梄一二
𠱄	口一目梄
𪣠	二一言人口
𬘀	巛一添川二
𨍦	梄曲米梄巛
𫁫	言米乙儿十
𣍁	又竹竹七曲
𬞰	十卜卜米巛
𦀵	巛一口一口
𨇹	口卜言川一
𫻈	巛竹又又口
𢴌	寸添又寸口
𫡀	米一曲言川
𥋒	目一竹口曲
𫏥	口卜言一一
𩛄	人又一目人
𧐼	口巛寸曲十
𢣃	米卜大人十
𬠓	口巛竹梄乙
𤻭	广一言又口
䟢	口卜儿添曲
𬜌	竹卜言竹乙
𪡆	口一寸言又
𨃼	口卜二竹卜
𩚩	人又十寸口
𦠶	二人乙人人
𱸣	竹言巛儿曲
𥶀	竹言巛口曲
𤉘	米人言寸
𢴝	竹寸十一一
𪡾	口一竹言竹
𦺓	十卜十十月
𢩛	之竹二卜目
𫺾	人一乙又口
烣	米人大寸米
𡀴	口一寸添儿
𫿨	言乙竹言曲
𩽉	儿一广卜又
𪡍	言人口儿卜
𫍕	言寸乙竹十
𧁸	十卜巛曲梄
䏧	月一儿言儿
𣶈	添添目米言
𦖻	三十曲卜之
𪢏	大七口添乙
𣾵	添添巛儿乙
𬐩	大卜目一口
𠫅	十卜巛曲乙
𧞋	之广广曲人
𨄁	口卜三之儿
𡃖	口一卜曲之
𠢞	寸添月目乙
𧋻	口巛言人口
𡥤	乙一三卜梄
𤒛	米人三大寸
𬁉	又竹儿又曲
𠽖	口一之一大
𥻣	米梄寸二寸
𤂪	添添梄添大
冡	之之一添大
𪠢	二一巛曲人
𫗾	竹梄曲十目
𫷐	目卜十曲二
𫽑	月又寸添曲
𠂪	乙添竹言卜
𪵬	添添竹添月
𫱪	巛竹乙目口
𡑲	二一梄梄二
𩻑	儿一米梄言
𪳞	梄一二乙竹
𣝅	梄一儿又卜
𥕊	大一十大十
𫅤	乙广乙人之
𢯖	寸添米二巛
𪜉	口口一米十
𫚱	儿巛儿乙巛
𤹗	广一人乙乙
𦑅	一添目乙乙
𫂪	竹言竹梄又
𤻾	广一乙曲一
𩻔	儿一之寸斤
𪬶	米卜巛竹巛
𥊚	目一广梄梄
𠉠	川添斤月
𬄞	二寸梄月二
𫂨	竹言二口曲
𣱾	添添又乙
𡐗	二一儿广十
𦟣	月一川人儿
𫻽	七大乙竹十
𬘂	巛一又卜大
𢚳	梄一寸言之
𡐘	二一添川二
𪡈	口一川添川
㨄	寸添月二口
𬙺	米三大巛十
𢅅	目卜大巛儿
𬚎	巛一梄二儿
𬦨	口卜口一乙
䱑	儿一寸添斤
𢧲	竹寸七儿二
㭽	梄一广儿言
樑	梄一添人梄
𱐾	三米儿乙斤
𣒱	梄一口一儿
𢹾	寸添竹之目
𡦧	竹梄乙人十
𥱰	竹言人卜二
𢷳	寸添儿目儿
𬁚	曲一竹川人
𱡵	十卜月二言
粚	米梄竹一乙
𦠲	月一二巛之
䇮	竹言川竹二
𬌥	竹二米梄巛
𦃿	巛一目二巛
𡂇	口一口人儿
𨆶	口卜十添梄
𪖺	川曲曲七儿
𤞔	月竹七言二
𭖌	目目曲一一
揁	寸添卜寸目
𬌕	川又川梄一
㗖	口一斤添川
𥗽	大一七目目
㳻	添添十一曲
𢞃	米卜巛一二
𣾼	添添二七巛
𥰊	竹言人一卜
𣍂	人一人口曲
𢹽	寸添竹儿曲
𢺳	寸添言巛口
𬝡	十卜曲乙竹
𡤠	巛竹二口米
𡮬	曲人又寸之
𦹹	十卜添二二
𩽸	儿一人二一
𦖡	三十川儿言
𪣅	二一十一巛
𠄜	一添口人竹
𠰉	口一乙寸口
𩳊	川口儿言口
𠾽	口一又寸三
𪞽	言一人曲大
𬜞	儿添乙曲曲
𫲢	乙一儿乙口
𢀲	七添又儿目
淃	添添米二乙
𣉏	曲一十人之
𪊅	卜寸口梄二
𦨢	斤乙儿七言
𫃖	米梄竹又乙
攎	寸添卜曲目
𦀅	巛一竹一十
盌	儿言乙目目
𬲈	月寸二口人
𦼇	十卜二巛之
㧡	寸添言巛人
𧋟	口巛竹一巛
𥋷	目一十儿口
𫀟	二曲乙人竹
𠶖	口一梄一三
𫽡	竹寸人乙目
𡊰	二一曲卜
𪴄	竹一梄二乙
𦊛	目曲乙一口
𤯨	竹三三一十
鈼	斤一竹一卜
𩽤	儿一梄寸川
𡓾	二一二口米
𬔑	之人卜米寸
𥈯	目一川曲二
𠌨	川添七添曲
𣃱	言乙七添三
𦟖	目寸人人三
𢺤	寸添十梄目
𨃸	口卜言米曲
熶	米人曲三又
𫏦	口卜巛儿二
𤊒	米人巛又曲
𦠰	之竹月曲十
𩧍	三米大大大
𠸞	口一米卜口
𢫞	寸添又言二
呭	口一十一巛
𬛝	月一巛大斤
𪂳	儿巛曲儿儿
𧞣	之广大月大
𨂘	口卜斤竹二
𬈴	添添三月口
𬓗	二曲又儿卜
𤞕	月竹一目二
䧹	广大川添川
𦞐	月一卜七一
𬚼	月一三一十
𤢬	月竹二之七
鐒	斤一米之乙
𣯡	言米曲梄竹
𪧿	目寸人寸曲
𣃣	言乙又卜
𫃤	巛一添添巛
𠾒	口一七卜川
𤯺	竹三十三乙
𤇳	米人七竹大
𩄒	梄添言米曲
𡆑	口一目三竹
䔅	十卜一一口
𤑬	米人竹人曲
𨯷	斤一十口米
𬰌	梄添人口曲
𬔌	之人七卜竹
𬩅	之一添添二
𫴵	又二寸一三
𢷅	寸添口儿口
𩙋	月卜之月曲
𦈽	竹一十之又
𣟃	梄一十一儿
𦇇	巛一二一二
𢸞	寸添又米乙
𥨧	之人米巛竹
𤈪	米人七竹十
𫑅	之一梄人之
𬒸	二曲巛十人
𨫄	斤一三曲三
𡄾	口一言口三
𪟂	卜寸口一乙
𫉳	十卜巛月乙
𩹯	儿一十七口
𦅴	又竹竹儿言
𧵤	目人之寸寸
捤	寸添又竹竹
橺	梄一又寸曲
㤓	米卜梄一一
𡑒	二一又三竹
𠖰	广寸乙二
𡏛	二一斤巛大
𣾹	添添之儿言
菛	十卜又寸
𬐐	川曲之一斤
𬫂	斤一大大乙
𬖩	米梄儿儿卜
𠸩	口一卜寸目
𱔢	口一月竹二
𨄠	口卜斤梄之
𠼹	口一目人斤
𠹴	口一又口乙
鞵	十十斤巛大
𫅁	目曲川添儿
𠲹	口一乙乙之
𠦺	曲寸二人米
𩟢	人又十添梄
𧛞	之广十口月
𪟡	曲卜乙一口
𡎡	二一十二梄
𬚍	二竹二竹
𠯪	口一一添儿
𠟀	乙寸儿巛
㳄	添添儿人
𫠿	卜一又口米
𫑀	之一曲人二
𬉵	大寸米言
𤻐	广一言曲儿
𧕚	口巛言川曲
𣴙	添添儿言儿
䗅	口巛三七
𩈪	又添口巛二
𫄐	巛一人寸曲
㺧	月竹口口口
𤌄	米人二竹
𪽕	儿乙乙曲乙
𦂽	巛一之人大
圚	口寸口一目
𠡚	二寸儿广乙
襵	之广三三三
𥆼	目一曲卜二
𤻑	广一广曲人
𤀗	添添竹口口
𫡻	言七口一月
𨁋	口卜一口米
𡲈	又竹竹七言
𫻠	米卜口又月
𪟤	三一十曲乙
𩍣	十十十巛梄
𡉎	二一二卜
𡓋	二一川又竹
𠎊	川添梄梄梄
𡄫	口一言曲人
𣼴	添添梄曲儿
𤡛	月竹之目一
𬕌	竹言广大梄
𧉚	口巛儿乙斤
𢄂	目三乙言目
𨆢	口卜梄添曲
𪜚	添添梄竹乙
𢲣	寸添言米曲
𦝇	月一米曲一
𠽌	口一梄添又
𣈗	曲一一寸曲
汵	添添人言又
𠾿	口一二卜大
𧻐	二人言人寸
𫳘	之寸乙之一
𪴉	梄一巛人儿
𠽉	口一添人梄
𩄱	梄添言米曲
𫃘	米梄曲人米
𢭸	寸添广又卜
𧋼	口巛三一十
𬏒	曲卜巛言又
𣰏	竹七目目川
𠀲	一卜儿言儿
𫚶	竹添米寸儿
𢹅	寸添添儿口
𠁀	十一巛川七
𩂁	梄添一儿
𤐝	米人梄添曲
𪪅	一添米大曲
𬗓	巛一米一目
𣈢	曲一川口十
𱘔	二一乙儿十
𩠧	米一川乙口
𬈤	添添又儿竹
𬑦	目一川七儿
𫽗	寸添大卜目
𫥴	乙曲乙寸
𨄶	口卜米言曲
𣽆	添添竹二月
𤷒	广一曲卜竹
𨗮	之一川人十
𣛨	梄一十十月
𠮾	口一一儿
𪸊	添添斤二一
𡀔	口一口儿口
䏠	月一言米
𥯪	竹言三一大
𣊍	曲一广梄梄
𨤮	曲卜二米米
𣖗	梄一之又儿
𬆞	月又言七
𢁊	乙曲寸七二
𪰹	曲一二曲二
𪽁	竹三卜寸
𠅼	言七竹竹人
𦾥	十卜曲之梄
𠖨	之之一一大
𣜲	梄一之十目
𢫈	寸添十寸口
𪾮	目一斤竹二
𨮎	斤一十儿口
𣹖	添添一儿目
瀐	添添十曲一
𬢗	人一人儿月
𤳢	曲卜乙二目
𠓻	人寸三目十
𫖀	又添口一梄
𣋂	曲一十十月
𦄼	巛一斤三大
𩠸	米一川竹三
𢫟	寸添川添二
𪠿	口一竹言
𢩜	之竹言竹竹
𢤟	米卜梄添大
𧲼	斤月儿乙乙
𦢠	月一卜人
䴌	儿巛十一大
𢫜	寸添人寸卜
𡏦	二一米三二
𣘓	梄一目二巛
𪤸	儿言卜儿卜
𠏭	川添三又大
𩝻	人又十目人
懙	米卜川卜人
媠	巛竹大二月
𤠶	月竹十目人
𡸏	目目川添言
𬙼	米三大人十
𡙴	言米曲儿大
𬰅	梄添人月曲
𬨴	之一十巛口
𧍋	口巛曲一寸
𤓺	斤添广寸十
埬	二一梄一曲
𥆾	目一乙言之
𦢟	月一寸曲米
𣈓	曲一寸添又
𪄥	儿巛目之
𨔈	之一竹目曲
𤹕	广一口大之
墛	二一又二寸
𠾹	竹添大人十
𠄻	二卜又梄梄
𤷳	广一目目大
𪆼	梄添曲卜儿
𤖡	巛大之曲曲
𫌵	又言又言言
𣜋	梄一口一三
𪱐	言米曲竹目
𠐸	人寸竹二川
𣖚	梄一十乙口
𠱈	口一竹大
𤠤	月竹十言川
𥃑	斤乙目人儿
𨬈	斤一广梄梄
𠣶	儿乙乙乙曲
𫒾	斤一巛目人
𡒻	二一斤斤目
𥴛	竹言梄一川
𫏱	川三人目曲
𣼷	添添十十乙
𣐝	梄一七添目
𫖿	月寸二米大
𣠩	梄一十竹目
𢟐	米卜三竹梄
𠲏	口一川竹二
䘃	口巛目米二
𩺥	儿一儿儿巛
㖽	口一大人
𢷀	寸添人曲之
𠚯	一儿曲寸
𢭺	寸添斤月
𬈫	添添人一寸
𤒢	米人广口竹
𩽥	儿一又梄目
𠶏	口一竹梄又
𧜘	之广口一目
𣊿	曲一十十月
𬃱	梄一十曲一
𤄋	添添巛儿之
𣻄	添添人人竹
𫷤	巛巛乙竹乙
𩼸	曲米米寸儿
櫈	梄一又米月
𪥻	巛竹一竹之
𨙛	之一梄目大
𢺹	人一乙十又
𱠳	寸添曲人二
溳	添添口一目
𬯰	川卜又二巛
𢷆	竹寸言曲一
𠃷	竹梄乙一乙
𦢷	月一口口三
𢯑	寸添米又二
𡓈	二一竹儿曲
𧕀	口巛又言二
𠶇	口一目言曲
㗈	口一又月乙
𣼲	添添口一川
𱍧	又二二一卜
𤊫	米人二一又
𠼸	口一川曲巛
䈜	竹言川之又
𬑩	目一竹竹十
𫫤	口一之口竹
𤉓	大大米人曲
𬠫	口巛十曲月
𠎫	川添十十月
𥊀	目一巛人斤
𫴱	又二寸竹巛
𠯻	口一巛巛乙
𣹙	添添大月乙
𫑇	之一斤寸十
𣍗	人寸言巛曲
𦬂	十卜一儿
𫻎	言米曲儿之
𪚚	言卜口口
𫡐	乙添竹儿卜
𫺶	米卜乙口梄
𠻄	口一十言川
𬠱	竹一巛言口
𬚲	目寸人人之
崊	目目梄一梄
𪘵	卜人二人儿
焝	米人儿七曲
𫣿	目曲目人米
佊	川添又卜
𨒒	之一一乙十
𦞒	月一人二寸
𱔫	口一之竹口
𪯗	十一月人乙
𠴓	口一川儿言
𣠒	之寸斤竹梄
𦇒	巛一大大大
𠓔	川二儿之儿
𤾔	川曲十之梄
𦢩	月一十川巛
𲇣	斤一十儿米
𫧦	言一巛儿卜
𭉩	口一川言口
𫊴	口巛寸竹七
𠁔	米一曲曲一
𢨃	十卜曲大七
𤞘	月竹川竹二
𩿘	儿巛竹七
㽿	广一斤言
𢥢	米卜言口三
𣔲	梄一之目口
㘉	口一竹又乙
𢿼	又二二寸竹
𤷯	广一又目曲
𢫠	寸添乙巛巛
𡌽	二一广卜口
𪤲	二二又儿卜
𡃕	口一之川乙
𢲵	寸添一曲曲
𨃴	口卜目之
𧅕	十卜月人巛
鐰	斤一口口梄
𪮳	寸添言曲口
𪄧	儿巛之米巛
𠲕	口一广大二
𠹽	口一十巛人
𫽌	寸添月儿斤
𣹘	添添人二寸
㭼	梄一曲添曲
𧊌	口巛二卜一
𥸆	竹言月人巛
𦀼	巛一目目人
𢄹	目卜竹目口
𪩤	七添又儿曲
𢴑	寸添斤梄之
𬢱	言寸米三又
𧧀	言寸一巛
𩅺	梄添斤三大
𪩧	言一口七又
㴜	添添之目十
𫖾	人寸一月二
𣑵	梄一又大二
𱜘	人寸一七又
𠬃	二一巛言梄
𢤣	米卜竹月曲
帀	一添目卜
𣳡	添添七大
𧸺	目人之川乙
𣂃	二竹广寸十
𣨭	一添儿之乙
𩊽	十十人大目
𣛦	梄一添竹乙
𫯖	儿言儿米大
鵶	二巛儿巛
𡳩	又竹竹二曲
𨓢	之一斤寸一
𪰨	曲一米卜之
𡗎	儿言儿斤曲
𦀫	巛一广大大
𠑕	川添川又口
𢩊	之竹曲人一
𣊾	曲一曲三之
𠶯	口一寸巛巛
𪵯	添添斤添
𫐾	之一大月大
𦲹	十卜言儿言
𡓥	二一口一七
𢲝	巛一一巛竹
啱	口一目目大
𬗰	巛一一竹梄
𡢐	米梄巛一口
𤳆	曲卜乙人人
𡍣	二一言曲又
𧙀	之广言米
𥝽	竹梄一卜巛
𫿴	广寸十斤乙
𠶗	口一十寸目
𤔽	斤添十一大
𩲡	二曲川口
㫼	曲一竹目曲
𠇽	川添七添目
𡄯	口一月曲之
𧋸	口巛口一三
𬬌	斤一七梄一
𥣐	竹梄曲之梄
𪀆	川添二二儿
𨨦	斤一梄一竹
𨯃	斤一曲巛竹
𣔓	梄一人卜又
𫨫	巛言卜寸目
㗅	口一十口月
𨨧	斤一言米巛
𪆤	目曲二米儿
𪇴	十卜目言儿
𡮫	儿言大米曲
𫆍	三十言又月
𪧚	之寸乙之寸
𫆘	月一一添卜
𠺳	口一大儿曲
𥶲	竹言大大大
𦧽	竹卜巛口口
𡳽	竹言三又七
𪽄	竹三曲目口
𥖓	大一又口口
𤴏	曲卜十巛川
𣜿	梄一十巛梄
𬟼	口巛一添梄
𢴔	寸添目斤又
𥘷	二曲巛曲竹
𨄷	口卜大人人
𫇳	十卜人寸卜
𬄃	梄一竹七又
𣷷	添添言曲又
𬷤	斤添一口儿
𬀰	曲一一儿曲
𧛌	言儿寸大又
𬄮	梄一十曲一
𢯓	寸添十卜乙
𠚐	巛曲巛卜梄
𤯆	十二言寸
𠾻	口一添十巛
𤷴	广一川添言
𦾣	十卜寸之川
𫪥	口一川儿儿
筙	竹言三卜梄
扖	寸添人寸
𨮹	斤一之十口
㾞	广一梄寸
𣭒	竹七目一
𩇅	梄添言曲大
呞	口一乙一口
𥊴	目一曲三又
梖	梄一目人
𤇲	川添竹二米
𢝸	米卜目口
恗	米卜大一一
𬏯	广一斤月
𡅧	口一十二川
𬇸	添添一梄一
𧄳	十卜曲目口
𫶷	口一口一乙
哠	口一竹二口
萶	十卜三人
𪰬	曲一一竹曲
𥙧	二曲巛儿曲
𤍎	米人言又乙
𣔥	梄一人一卜
㗚	口一梄口梄
𪳘	梄一之之大
𪲝	梄一广大梄
練	巛一梄一曲
爛	米人又梄曲
蘭	十卜又梄曲
欄	梄一又梄曲
攔	寸添又梄曲
瀾	添添又梄曲
闌	又寸梄一曲
煉	米人梄一曲
斕	言人又梄曲
讕	言寸又梄曲
鑭	斤一又梄曲
籣	竹言又梄曲
灡	添添十梄曲
襴	之广又梄曲
暕	曲一梄一曲
鰊	儿一梄一曲
鶫	梄一曲一儿
朄	曲梄梄一曲
瑓	三一梄一曲
糷	米梄十梄曲
萰	十卜梄一曲
𡔔	二一十梄曲
𪩱	乙曲又梄曲
𫲴	乙一十梄曲
𡄮	口一斤梄曲
𫇡	斤乙十梄曲
㘓	口一又梄曲
𢦂	米卜十梄曲
𠣂	言寸梄曲乙
㦨	米卜又梄曲
囒	口一十梄曲
䃹	大一又梄曲
𬵿	儿一十梄曲
𥈵	目一梄一曲
𫋨	口巛言梄曲
𢒞	梄一曲一斤
欗	梄一十梄曲
𢺤	寸添十梄曲
𩽥	儿一又梄曲
墨	曲卜二米二
濹	添添目米二
層	又竹米曲曲
贈	目人米曲曲
僧	川添米曲曲
憎	米卜米曲曲
誤	言寸口巛大
誤	言寸口一人
虞	卜七口巛大
虞	卜七口一人
蜈	口巛口巛大
蜈	口巛口一人
麌	广又口巛大
鋘	斤一口巛大
噳	口一卜巛大
茣	十卜口巛大
澞	添添卜巛大
𣮇	口一巛大竹
画	一添曲二巛
鰩	儿一儿十巛
徭	人卜儿十巛
傜	川添儿十巛
愮	米卜儿十巛
颻	儿言竹巛月
媱	巛竹儿十巛
猺	月竹儿十巛
嗂	口一儿十巛
䁘	目一儿十巛
𡏟	二一儿十巛
謡	言寸斤一巛
瑶	三一斤一巛
遥	之一斤一巛
埓	二一儿言寸
将	广卜斤添寸
蒋	十卜广斤寸
直	十寸目一巛
置	目曲十目巛
植	梄一十目巛
殖	一添儿目巛
矗	十寸目目巛
埴	二一十目巛
淔	添添十目巛
稙	竹梄十目巛
犆	竹二十目巛
𫤁	川添曲目巛
𫕾	目曲十巛曲
𤣡	月竹目目巛
𥊣	曲人目目巛
𤊧	米人十目巛
𫗾	竹梄曲目巛
𠶗	口一十目巛
𨁷	口卜十目巛
滇	添添儿巛人
嗔	口一儿巛人
癲	广一儿人大
縝	巛一儿巛人
禛	二曲儿巛人
闐	又寸儿巛人
瞋	目一儿巛人
稹	竹梄儿巛人
寘	之寸儿巛人
瑱	三一儿巛人
傎	川添儿巛人
搷	寸添儿巛人
鬒	三七斤巛人
窴	之人儿巛人
磌	大一儿巛人
蹎	口卜儿巛人
衠	人卜儿巛人
鷏	儿儿目人儿
齻	卜人儿巛人
𤄱	添添斤巛人
𧜖	之广儿巛人
𬹙	儿儿目二米
𠆍	言一月巛人
𡂌	口一儿曲竹
𡻗	目目儿巛人
𬉌	添添口巛人
𤛇	竹二儿巛人
𢅬	川曲目巛人
𩝻	人又儿巛人
𤠶	月竹儿巛人
具	目一一添人
真	十寸目一人
鎮	斤一十一人
填	二一十一人
慎	米卜十一人
槙	梄一十一人
黰	目曲二一人
你	川添竹一曲
您	川添竹曲之
妳	巛竹竹一曲
珎	三一竹一曲
称	竹梄竹一曲
猕	月竹乙竹曲
尔	竹一曲人
迩	之一竹一曲
弥	乙巛竹一曲
狝	月竹竹一曲
玺	竹一曲三言
祢	二曲竹一曲
𨤰	竹一曲曲二
𥜡	二曲竹曲二
𦼜	十卜二竹曲
𨤧	曲卜二竹曲
𠦿	竹梄竹竹十
趂	二人竹一曲
𫒂	竹一曲曲二
𫵇	又竹目竹曲
𥅘	目一竹一曲
𠺰	口一竹竹曲
𠰚	口一竹一曲
𢘝	米卜竹一曲
𨃾	竹梄竹曲口
𡮠	竹一曲又目
𪮭	寸添二竹曲
𫐪	之一乙竹曲
𪡇	口一川竹曲
䟢	口卜竹一曲
𥙧	二曲巛竹曲
𬎽	月二竹一卜
𬪽	竹十曲竹卜
𫎑	目人竹一卜
𪝪	川添又竹卜
𬨻	之一梄竹卜
𪥾	巛竹大竹卜
𫢖	川添乙竹卜
𪸄	添添七竹卜
𬞮	十卜之竹卜
𫎚	目曲目竹卜
𬢞	言寸竹一卜
𬂆	言添又竹卜
𫕸	三卜月竹卜
𬌣	竹二二竹卜
𪰰	曲一二竹卜
𪲣	十二梄竹卜
𫁞	言米竹一卜
𪯊	巛卜竹竹卜
𬕺	竹言言竹卜
𪫶	人寸言竹卜
𪮯	寸添口竹卜
𪝱	川添目竹卜
𬕳	竹言三竹卜
𫋶	之广乙竹卜
𪰇	曲一竹一卜
𩵜	儿一竹一卜
𬪄	乙寸二竹卜
𫶜	目目言竹卜
𬋱	斤米竹一卜
𬋫	斤添一竹卜
𬐸	卜七曲竹卜
𪶏	添添二竹卜
𫴬	言人寸竹卜
𬂨	梄一寸竹卜
𪡉	口一竹竹卜
𬬃	斤一川竹卜
𪩬	乙曲竹一卜
𪬫	言米曲竹卜
𪣱	二一言竹卜
𫡔	竹一卜卜巛
𫧣	十寸目竹卜
𬋆	米人梄竹卜
𬎻	言人大竹卜
𪫓	人卜又竹卜
𪿸	大一大竹卜
𬆒	一添儿竹卜
𪱕	曲一三竹卜
𪟳	竹一十竹卜
𪠉	大大卜竹卜
𬑅	目一竹一卜
𪥯	竹一卜巛又
𫆡	言一巛竹卜
𪞀	曲人一竹卜
𫉼	十卜目竹卜
𪾆	又卜竹一卜
𪡍	言人口竹卜
𬓗	二曲又竹卜
𬖩	米梄儿竹卜
𪤸	儿言卜竹卜
𫡐	乙添竹竹卜
𫧦	言一巛竹卜
𪤲	二二又竹卜
類	米梄大寸大
臭	川目大寸
突	之人大寸
莽	十卜大寸十
懶	米卜梄乙目
賴	梄一口乙目
瀨	添添梄乙目
癩	广一梄乙目
籟	竹言梄乙目
獺	月竹梄乙目
嬾	巛竹梄乙目
藾	十卜梄乙目
𱜝	七添又乙目
𣡙	曲卜梄乙目
𡚚	大寸梄乙目
𣡚	曲卜梄乙目
𬯩	乙口一乙目
𢁑	乙曲梄乙目
𢀲	七添又乙目
鄑	二寸巛曲乙
低	川添儿七一
底	广大儿七一
抵	寸添儿七一
牴	竹二儿七一
邸	儿七一添乙
祗	二曲儿七一
骶	目之儿七一
氐	儿七一添
砥	大一儿七一
胝	月一儿七一
羝	米三儿七一
鴟	儿七一添儿
詆	言寸儿七一
柢	梄一儿七一
坻	二一儿七一
厎	大大儿七一
袛	之广儿七一
秪	竹梄儿七一
菧	十卜广儿一
茋	十卜儿七一
蚳	口巛儿七一
軧	梄曲儿七一
岻	目目儿七一
泜	添添儿七一
阺	乙口儿七一
弤	乙巛儿七一
貾	目人儿七一
觝	儿添月儿一
𥓵	大一广儿一
𬺙	言米曲儿一
𢋠	言一米儿一
𧍉	口巛广儿一
𡌠	二一川儿一
𦝉	月一广儿一
𬇉	儿七一添乙
𤯰	竹三广儿一
𪂰	儿巛广儿一
𦰣	十卜川儿一
𣷳	添添广儿一
𡞖	巛竹广儿一
𪽅	广大儿一竹
𢋴	十一儿儿一
掋	寸添广儿一
㭽	梄一广儿一
𦨢	斤乙儿七一
𦅴	又竹竹儿一
𠴓	口一川儿一
界	曲卜人寸川
髮	三七斤大竹
拔	寸添大言竹
跋	口卜大言竹
魃	川口大言竹
鈸	斤一大言竹
紱	巛一大言竹
菝	十卜寸大竹
祓	二曲大言竹
黻	曲米目大竹
茇	十卜大言竹
犮	大言竹添
沷	添添大言竹
妭	巛竹大言竹
秡	竹梄大言竹
袚	之广大言竹
軷	梄曲大言竹
韍	又口口大竹
胈	月一大言竹
詙	言寸大言竹
帗	目卜大言竹
蛂	口巛大言竹
鼥	川二巛大竹
瞂	斤寸十大竹
翇	乙广乙大竹
𧛌	言儿寸大竹
響	巛人又言曲
饗	巛人又乙人
蠁	巛人又乙口
嚮	巛人又川口
營	米人米竹口
鋁	斤一口竹口
閭	又寸口竹口
莒	十卜口竹口
櫚	梄一又竹口
営	添寸之竹口
麿	广大梄竹口
瀯	添添米竹口
筥	竹言口竹口
梠	梄一口竹口
絽	巛一口竹口
郘	口一竹口乙
营	十卜之竹口
稆	竹梄口竹口
𣨕	一添儿竹口
𤞪	月竹口竹口
𡄀	口一竹十巛
𬩀	之一大竹口
捛	寸添口竹口
𫭐	口寸口竹口
𥓅	大一口竹口
𥺓	米梄口竹口
𠴊	口一口竹口
𥆻	目一口竹口
𡋿	二一口竹口
𱜗	口一竹七又
𠭤	口一竹斤又
𫡽	言一人竹口
𡳎	又竹竹竹口
𨓐	之一口竹口
𫤉	川添儿竹口
焒	米人口竹口
𠒦	曲人一竹口
𣳮	添添口竹口
𫶴	米三二竹口
𥖕	口一竹大又
𪡉	口一竹儿卜
𪁳	口一竹口儿
𤳧	口一竹十人
𫼴	竹寸口竹口
𡱶	又竹口竹口
𨹬	乙口口竹口
𢙲	米卜口竹口
㛎	巛竹口竹口
𤀗	添添竹竹口
𥖓	大一又竹口
𫶷	口一竹口乙
起	二人乙二
包	儿乙乙乙
巽	乙乙乙十人
异	乙乙十卜
次	二寸儿人
資	二寸儿人目
姿	二寸儿人巛
瓷	二寸儿人一
茨	十卜二寸儿
諮	言寸二儿口
恣	二寸儿人之
佽	川添二寸儿
咨	二寸儿人口
粢	二寸儿人米
絘	巛一二寸儿
趑	二人二寸儿
蠀	口巛二儿目
薋	十卜二儿目
楶	二寸儿口梄
秶	二寸儿人竹
羡	米三二寸儿
餈	二寸儿人人
盗	二寸儿人目
𣛯	梄一二儿目
𬅧	二寸儿人目
𪞼	言一人二儿
𬏗	斤梄曲二儿
𬚺	目寸人二儿
均	二一儿乙二
鈞	斤一儿乙二
筠	竹言二儿二
昀	曲一儿乙二
鋆	二一儿二斤
韵	言米曲儿二
盷	目一儿乙二
畇	曲卜儿乙二
荺	十卜二儿二
袀	之广儿乙二
肺	月一言一目
姉	巛竹一添目
熬	二二言竹米
傲	川添二言竹
敖	二二言乙竹
嗷	口一二言竹
獒	二二言竹大
鰲	二二言竹儿
贅	二二言竹目
螯	二二言竹口
鏊	二二言竹斤
驁	二二言竹三
遨	之一二言竹
嶅	二二言竹目
廒	广大二言竹
璈	三一二言竹
慠	米卜二言竹
聱	二二言竹三
摮	二二言竹竹
磝	大一二言竹
謷	二二言竹言
隞	乙口二言竹
蔜	十卜二言竹
嚽	口一二竹目
鼇	二二言竹之
𨎞	梄曲二言竹
𪵧	竹乙二言竹
𫗺	米一川言竹
𢳆	寸添二言竹
𧑃	口巛二言竹
熬	二一言竹米
敖	二一言乙竹
獒	二一言竹大
鰲	二一言竹儿
贅	二一言竹目
螯	二一言竹口
鏊	二一言竹斤
驁	二一言竹三
嶅	二一言竹目
聱	二一言竹三
摮	二一言竹竹
謷	二一言竹言
鼇	二一言竹之
總	巛一川言之
窗	之人川斤言
蔥	十卜川言之
聰	三十川言之
璁	三一川言之
驄	三米川言之
傯	川添川言之
蟌	口巛川言之
熜	米人川言之
摠	寸添川言之
謥	言寸川言之
𦪐	斤乙川言之
鏓	斤一川言之
𤄋	添添巛言之
蝉	口巛添曲一
惮	米卜添曲一
禅	二曲添曲一
箪	竹言添曲一
𱔩	口一添一七
敢	一卜三十竹
憨	一卜三竹之
闞	又寸一三竹
瞰	目一一三竹
橄	十卜一三竹
噉	口一一三竹
澉	添添一三竹
撖	寸添一三竹
譀	言寸一三竹
鬫	三三一三竹
𨅺	口卜一三竹
𥼲	米梄一三竹
𡑒	二一一三竹
騷	三米又广口
搔	寸添又广口
蚤	又言广寸口
瘙	广一又广口
溞	添添又广口
瑵	三一又广口
慅	米卜又广口
鼜	二二口广口
糔	米梄又广口
颾	月卜又广口
𦞣	月一又广口
𠋺	川添又广口
𦃐	巛一又广口
勤	十卜口三乙
堇	十卜口一三
覲	十卜口三目
鄞	十卜口三乙
懃	十卜口乙之
𫦽	十卜口乙竹
難	十卜口二川
歎	十卜口二儿
艱	十卜口二又
戁	十卜口川之
臡	十卜口人人
𬥮	十卜口乙目
𪪫	十卜口广梄
墟	二一卜七斤
覷	卜七斤二目
歔	卜七斤二儿
譃	言寸卜七斤
虡	卜七斤二人
魖	川口卜七斤
驉	三米卜七斤
鱋	儿一卜七斤
戯	卜七斤二七
𨼋	乙口卜七斤
𫣞	川添卜七斤
𪹣	米人卜七斤
純	巛一竹添巛
噸	口一竹巛大
頓	竹添巛曲大
屯	竹添巛曲
鈍	斤一竹添巛
囤	口寸竹添巛
扽	寸添竹添巛
盹	目一竹添巛
沌	添添竹添巛
肫	月一竹添巛
邨	竹添巛曲乙
飩	人又竹添巛
砘	大一竹添巛
窀	之人竹添巛
魨	儿一竹添巛
迍	之一竹添巛
忳	米卜竹添巛
坉	二一竹添巛
庉	广大竹添巛
軘	梄曲竹添巛
芚	十卜竹添巛
杶	梄一竹添巛
訰	言寸竹添巛
瓲	一巛竹添巛
吨	口一竹添巛
莼	十卜巛竹巛
炖	米人竹添巛
𢵶	寸添斤竹巛
𡶁	目目竹添巛
𣔝	梄一之竹巛
㹠	月竹竹添巛
𦟒	竹添巛大乙
𧉙	口巛竹添巛
𦡋	月一竹巛大
𡴢	竹添巛米曲
𥇈	目一口竹巛
𧿬	口卜竹添巛
𡴉	竹添巛曲月
𡚃	斤一竹巛大
𥂉	竹添巛儿目
𫃉	梄口米竹巛
𧘸	之广竹添巛
𩂄	梄添竹添巛
𦝊	月一之竹巛
𬙴	米三大竹巛
𡭻	曲人大竹巛
𤵊	广一竹添巛
𢲝	巛一竹巛竹
含	人寸一又口
今	人寸一添又
琴	三一三一又
念	人寸一又之
貪	人寸一又目
吟	口一人一又
黔	目曲二一又
岑	目目人一又
涔	添添目一又
矜	又言又一又
衾	人寸一又言
芩	十卜人一又
鈐	斤一人一又
衿	之广人一又
妗	巛竹人一又
頷	人寸一口大
紟	巛一人一又
盦	人寸一梄目
仱	川添人一又
梣	梄一目一又
棽	梄一梄一又
庈	广大人一又
霒	梄添二一又
耹	三十人一又
霠	梄添言一又
岒	目目人一又
敜	人寸一之竹
肣	月一人一又
韽	人寸一言曲
酓	人寸一又梄
坅	二一人一又
鳹	人寸一又儿
雂	人寸一又川
蚙	口巛人一又
靲	十十人一又
㖗	口一目一又
𥄯	目一人一又
𣵴	添添口一又
䰼	儿一人一又
𦛽	月一口一又
扲	寸添人一又
𪫶	人寸一儿卜
𫊍	十卜十一又
𠉞	人寸一又儿
𪑑	目曲二一又
𫕖	乙口一一又
埁	二一目一又
𦠴	月一三一又
𬇁	竹七目一又
𫴚	之寸之一又
𫢩	又竹儿一又
𥆽	目一口一又
𪡆	口一寸一又
汵	添添人一又
