的	川
時	曲
面	大
部	言
実	之
強	乙
機	梄
受	斤
経	巛
物	竹
国	口
会	人
政	一
感	七
理	三
真	十
発	又
前	米
事	寸
場	二
同	目
点	卜
度	广
学	添
解	儿
勝	月
題	曲一一
在	大寸卜
高	言一口
還	之一目
那	乙寸二
保	川添口
松	梄一人
爲	斤添竹
與	川二一
総	巛一人
等	竹言二
恩	口寸大
能	巛言月
想	梄一目
後	人卜巛
徐	人卜人
両	一添目
醬	巛大儿
僕	川添曲
識	言寸言
得	人卜曲
惑	七竹口
新	言米梄
於	言乙人
玩	三一二
最	曲一三
請	言寸三
開	又寸一
画	一添曲
快	米卜又
別	口一乙
京	言一曲
歎	十一儿
死	一添儿
賣	二二目
像	川添儿
使	川添大
岡	目寸米
無	竹一十
指	寸添儿
愛	斤添之
聽	三十三
喫	口一三
算	竹言目
探	寸添之
草	十卜曲
第	竹言乙
察	之寸二
花	十卜川
護	言寸十
殺	人言梄
鎮	斤一十
柴	卜卜儿
住	川添言
納	巛一目
睡	目二竹
裝	巛大二
抱	寸添乙
路	口卜儿
頭	一添口
府	广大川
類	米梄大
作	川添竹
道	之一米
書	又二二
法	添添二
技	寸添十
接	寸添言
絶	巛一乙
版	川又斤
儀	川添米
轟	梄曲梄
何	川添一
線	巛一川
黃	十一一
座	广大人
難	十一口
阿	乙口一
唱	口一曲
管	竹言之
定	之寸一
体	川添梄
様	梄一米
交	言一人
笑	竹言竹
形	一添十
黑	目曲二
慢	米卜曲
刷	又竹目
越	二人七
貴	口口一
選	之一乙
省	曲人竹
倒	川添七
説	言寸米
曾	米寸目
河	添添一
象	儿添口
陳	乙口梄
格	梄一儿
朝	十寸曲
修	川添卜
達	之一二
品	口一口
海	添添竹
勢	二一人
客	之寸儿
班	三一曲
流	添添言
持	寸添二
店	广大卜
坐	人寸人
続	巛一儿
飛	乙七广
留	儿七言
種	竹梄竹
歌	一卜口
報	二一米
若	十卜大
原	大大川
飯	人又斤
易	曲一儿
動	竹十曲
裸	之广曲
貼	目人卜
船	斤乙月
頰	大寸人
隊	乙口米
株	梄一曲
徹	人卜言
國	口寸七
費	乙巛川
境	二一言
周	月一二
超	二人乙
均	二一儿
昭	曲一乙
特	竹二二
英	十卜目
教	二竹乙
障	乙口言
既	又人七
建	乙言又
球	三一寸
練	巛一梄
注	添添三
提	寸添曲
険	乙口人
通	之一又
飾	人又竹
段	川添三
平	一添米
課	言寸曲
急	儿添又
城	二一七
羅	目曲巛
蔵	十卜七
懸	目三曲
常	曲人之
菜	十卜斤
較	梄曲言
消	添添曲
敢	又添三
操	寸添口
直	十寸目
徳	人卜十
局	又竹乙
雲	梄添二
頼	梄一口
華	十卜一
故	十寸口
跳	口卜添
養	米三言
團	口寸梄
深	添添之
樂	川曲巛
待	人卜二
求	寸言添
電	梄添曲
葉	十卜十
隷	二二二
育	言一巛
調	言寸月
議	言寸七
謝	言寸川
供	川添十
層	又竹米
週	之一月
情	米卜三
肉	目寸人
論	言寸人
痛	广一又
垣	二一二
冷	广寸人
派	添添斤
師	竹添乙
陽	乙口曲
樹	梄一二
合	人寸一
奧	川目竹
意	言米曲
科	竹梄广
翻	斤梄曲
帖	目卜卜
商	言一米
混	添添儿
造	之一竹
背	广卜儿
底	广大儿
業	曲米米
孫	乙一竹
変	言一川
認	言寸乙
落	十卜添
節	竹言又
輪	梄曲人
短	竹大一
今	人寸言
称	竹梄曲
許	言寸竹
板	梄一斤
秀	竹梄乙
博	十寸梄
語	言寸二
静	三卜月
燒	米人二
吾	二卜又
極	梄一又
茶	十卜人
案	之寸巛
野	曲乙二
絵	巛一巛
緊	七一又
服	月添乙
盡	又二一
警	十卜儿
康	广大又
夏	一添川
研	大一一
寒	之寸十
髪	三七斤
距	口卜七
挑	寸添添
織	巛一七
谷	人一人
源	添添大
戲	卜七一
寄	之寸大
権	梄一竹
燈	米人又
窮	之人川
粉	米梄人
爆	米人曲
増	二一曲
然	儿言大
御	人卜竹
芸	十卜二
満	添添十
獄	月竹言
蒸	十卜又
働	川添乙
猛	月竹乙
念	人寸之
望	言七月
囲	口寸二
祝	之言口
尊	米寸梄
界	曲卜人
賊	目人七
賞	曲人目
係	川添巛
福	之言一
違	之一十
煙	米人梄
親	言米目
賀	乙竹口
席	广大十
圏	口寸米
援	寸添斤
猫	月竹十
壊	二一十
済	添添川
院	乙口之
散	十一月
喜	二二口
治	添添巛
際	乙口儿
峰	目目儿
料	米梄广
結	巛一二
密	之寸之
醒	梄寸曲
精	米梄三
瘦	广一川
居	又竹十
興	川二目
鍵	斤一乙
制	竹二目
露	梄添口
昨	曲一竹
榮	米人米
弱	乙巛广
景	曲一言
替	二言二
陸	乙口二
策	竹言梄
味	口一二
温	添添目
藝	十卜巛
運	之一之
武	一添七
程	竹梄口
億	川添之
伝	川添二
鎖	斤一曲
衆	竹添目
雰	梄添人
環	三一目
森	梄一梄
厚	大大曲
答	竹言人
顧	之竹川
減	添添七
兼	米一又
況	添添口
娘	巛竹言
登	又口一
微	人卜目
瞭	目二人
麻	广大梄
司	乙添一
奇	大寸一
編	巛一之
盛	七大乙
后	斤寸一
圓	口寸口
害	之寸三
量	曲一二
宮	之寸口
酸	梄寸巛
仮	川添又
与	一添巛
更	一添人
皆	儿儿儿
琴	三一三
鈍	斤一巛
善	米三米
族	言乙竹
忍	乙寸言
聖	三十口
構	梄一十
遊	之一言
婦	巛竹又
腰	月添梄
彈	乙巛口
毎	竹一巛
義	米三竹
棒	梄一三
響	巛人言
校	梄一言
敬	十卜竹
醸	梄寸言
妹	巛竹二
銅	斤一目
幣	曲添目
証	言寸一
幾	巛巛巛
館	人又之
乘	竹添梄
酷	梄寸竹
返	之一斤
廳	广大三
側	川添目
具	目二一
威	七大一
劇	卜七大
暗	曲一曲
瓶	米一十
曳	曲一巛
移	竹梄儿
駄	三米大
術	人卜梄
禮	之言曲
容	之人人
輝	曲人大
智	竹大口
索	十寸之
臓	月添十
普	米一曲
鳳	月寸一
載	二一梄
彩	斤添梄
慶	广又又
駐	三米言
衛	人卜又
逃	之一添
症	广一一
浮	添添乙
蹴	口卜大
蛇	口巛之
購	目人十
噴	口一十
略	曲卜儿
授	寸添又
蓮	十卜之
撫	寸添竹
滅	添添米
拜	竹寸一
憶	米卜言
凱	目目一
銃	斤一言
税	竹梄米
募	十卜乙
勇	又言月
財	目人寸
鉢	斤一梄
質	斤寸斤
決	添添又
遇	之一曲
喬	竹添大
呼	口一竹
怒	巛竹之
揃	寸添米
頓	七寸巛
監	七一竹
確	大一之
賠	目人言
呪	口一儿
速	之一梄
雄	大寸巛
胸	月添儿
暴	曲一十
抜	寸添大
郎	言添又
珠	三一竹
携	寸添川
希	人言大
迂	之一一
嫌	巛竹米
稿	竹梄言
珍	三一人
妊	巛竹竹
鍛	斤一川
琳	三一梄
霜	梄添梄
染	添添月
肝	月添一
階	乙口川
置	目曲十
怪	米卜二
辣	言十梄
焼	米人十
慧	三卜三
蝦	口巛又
鵬	月添月
釣	斤一儿
軒	梄曲一
覆	梄口人
魂	二寸巛
益	米一人
庭	广大乙
粥	乙巛米
鼓	二二又
詰	言寸口
影	曲一斤
演	添添人
妻	一添又
盾	斤寸十
奔	大寸十
冠	之之二
婚	巛竹儿
摂	寸添三
閣	又寸儿
飽	人又儿
務	又言又
遠	之一儿
硫	大一言
承	又添曲
凌	广寸二
妙	巛竹曲
始	巛竹巛
篠	竹言川
似	川添人
啓	之竹竹
霧	梄添又
卓	卜寸曲
積	竹梄三
罰	目曲言
斜	人寸竹
渋	添添添
乎	竹添米
瀬	添添梄
翔	米三乙
異	曲卜十
餅	人又米
粘	米梄卜
繫	梄曲巛
脱	月添米
晴	曲一月
延	乙言竹
資	广寸儿
嶺	目目人
貧	人一乙
碧	三一川
籍	竹言三
習	乙广乙
苦	十卜口
担	寸添一
弟	米寸乙
督	卜一曲
航	斤乙言
薬	十卜梄
赤	二一川
畢	曲乙十
渡	添添广
奪	大寸川
乳	斤添乙
職	三十言
宅	之寸竹
耕	三寸曲
桜	梄一添
壁	又竹口
暫	梄曲斤
崎	目目大
脈	月添斤
蝶	口巛十
誇	言寸大
枕	梄一之
毀	川二二
材	梄一寸
翁	人一巛
固	口寸十
幅	目卜一
審	之寸斤
琉	三一言
屈	又竹巛
恐	二卜月
凍	广寸梄
複	之广竹
傷	川添斤
駅	三米又
熙	七一乙
忽	儿乙斤
胎	月添巛
糧	米梄曲
扇	之竹乙
卿	儿七竹
鶴	之之川
函	又乙添
群	又大口
緩	巛一斤
協	十寸乙
映	曲一目
鼻	川目曲
闘	又寸寸
藤	十卜月
膝	月添曲
窄	之人竹
訴	言寸斤
縁	巛一又
恭	十一人
腹	月添竹
触	儿添月
疑	儿儿竹
県	目二巛
慎	米卜十
踏	口卜曲
歩	卜卜曲
帽	目卜曲
猶	月竹米
典	目寸十
贈	目人米
腕	月添之
拒	寸添七
端	言米大
煎	米一月
弦	乙巛言
卵	儿七米
乗	竹十十
宿	之寸川
統	巛一言
慣	米卜巛
却	二一巛
疊	曲卜曲
砂	大一曲
域	二一一
筒	竹言口
吞	一添大
兜	川曲儿
秩	竹梄人
愉	米卜人
渉	添添卜
疎	又添卜
終	巛一广
験	三米人
糊	米梄十
捨	寸添人
吸	口一人
梨	竹梄梄
縄	巛一曲
遮	之一广
塔	二一口
賦	目人一
敷	梄二言
歷	大大竹
躍	口卜乙
趣	二人三
崇	目目之
裕	之广人
艦	斤乙七
荒	十卜言
筋	竹言月
鈴	斤一人
奎	大寸二
棚	梄一月
競	言米口
靖	言米三
奏	三人一
賜	目人曲
閥	又寸川
珊	三一月
鉛	斤一月
暢	曲梄曲
碑	大一川
燃	米人儿
愚	曲一之
柄	梄一一
誌	言寸之
復	人卜儿
窯	之人米
眠	目二乙
途	之一人
磁	大一米
輯	梄曲口
送	之一大
割	之寸曲
麟	广又米
祿	之言巛
崩	目目月
遺	之一口
郁	大寸月
導	之一寸
庶	广大米
獅	月竹竹
鞍	十十之
巫	二卜人
虞	卜七口
剝	巛又曲
削	曲人月
卸	竹二卜
慈	米一巛
靴	十十川
危	儿添大
襲	言卜言
喉	口一川
媛	巛竹斤
駿	三米巛
憎	米卜米
祕	之言之
巢	巛寸曲
燥	米人口
豹	斤月儿
冥	之之曲
媒	巛竹十
燦	米人卜
鐘	斤一二
皓	川曲竹
蜂	口巛儿
羞	米三又
瞳	目二言
挨	寸添巛
荘	十卜广
蠟	口巛巛
稲	竹梄斤
綺	巛一大
悔	米卜竹
勳	竹十目
簾	竹言广
鑑	斤一七
彌	乙巛一
貌	斤月川
訳	言寸又
模	梄一大
循	人卜斤
魅	川口二
跡	口卜言
瑛	三一十
腺	月添川
矯	竹大竹
瑠	三一儿
姿	广寸巛
閤	又寸人
彙	巛又之
簿	竹言添
胤	儿寸巛
廊	广大言
屑	又竹曲
販	目人斤
眺	目二添
寂	之寸卜
穂	竹梄一
螺	口巛曲
錠	斤一之
貿	儿七乙
療	广一大
矩	竹大七
慮	卜七曲
契	三卜乙
峻	目目巛
爵	斤添目
魁	川口广
晟	曲一七
艇	斤乙乙
巖	目目口
瞬	目二斤
窺	之人二
珂	三一一
慰	又竹二
履	又竹人
蟬	口巛口
鉄	斤一竹
呉	口一巛
読	言寸儿
燭	米人目
襖	之广川
吏	大寸口
羨	米三添
轄	梄曲之
録	斤一又
煌	米人川
給	巛一口
鱗	儿一米
竿	竹言一
稜	竹梄二
塚	二一之
坂	二一斤
隠	乙口斤
嬉	巛竹口
鞄	十十儿
酬	梄寸添
窟	之人又
狭	月竹二
嗣	口一目
嵩	目目言
穫	竹梄十
鯨	儿一言
窪	之人添
暖	曲一又
岸	目目十
鷗	七添口
械	梄一七
患	口一之
瓢	梄口二
売	二二之
鞘	十十曲
脅	乙竹乙
戚	七大卜
襟	之广梄
貯	目人之
禎	之言卜
睦	目二二
悼	米卜卜
憾	米卜七
蹟	口卜三
邸	儿七一
秘	竹梄之
雛	儿乙巛
箋	竹言七
勘	十三巛
駒	三米儿
飼	人又乙
狹	月竹大
凰	月寸川
凜	广寸言
怖	米卜大
磯	大一巛
舵	斤乙之
鯉	儿一曲
灸	儿添言
匿	七添十
輿	川二梄
諮	言寸广
羚	米三人
頑	二寸儿
脚	月添二
酌	梄寸儿
闇	又寸言
粹	米梄言
懇	斤月又
琶	三一乙
幡	目卜斤
怠	巛言口
稼	竹梄大
巽	乙乙乙
峨	目目竹
骸	目之言
驍	三米二
楽	川曲添
征	人卜一
嫉	巛竹广
傭	川添广
咲	口一米
円	目寸卜
癒	广一人
為	米寸又
曇	曲一梄
禱	之言二
痴	广一竹
耽	十三之
燎	米人大
狩	月竹之
関	又寸米
礎	大一梄
牒	川又十
戦	添寸曲
賄	目人大
鮎	儿一卜
堀	二一又
継	巛一米
児	卜添曲
竜	言米巛
磨	广大大
酵	梄寸二
懐	米卜儿
砲	大一儿
写	之之一
賂	目人儿
悪	二寸口
砧	大一卜
奮	大寸曲
裾	之广又
鋭	斤一米
覚	添寸之
憩	竹卜川
瘍	广一曲
毬	竹七寸
兎	竹添口
臆	月添言
銘	斤一口
崖	目目二
図	口寸广
炭	目目米
鯛	儿一月
撃	梄曲月
甥	竹三曲
歳	卜卜七
帰	曲寸又
聴	三十十
帯	十一之
転	梄曲二
脳	月添添
弾	乙巛添
鋳	斤一三
篇	竹言十
舎	人寸二
亀	儿添曲
慄	米卜梄
観	竹二川
悩	米卜添
鷄	斤添巛
雫	梄添一
歴	大大梄
従	人卜米
燿	米人乙
郷	巛人又
廻	乙言口
酔	梄寸月
斎	言人川
踊	口卜又
肺	月添目
軽	梄曲又
曽	米寸曲
聡	三十人
丼	二寸川
窓	之人巛
覇	梄口十
塩	二一竹
犠	竹二米
駆	三米七
砕	大一月
貰	十一巛
齢	卜卜米
厳	添寸大
袴	之广大
製	竹二儿
将	广卜斤
挙	添寸一
釈	斤梄又
拡	寸添广
峠	目目卜
粋	米梄月
醐	梄寸十
鉱	斤一广
鰯	儿一乙
猟	月竹添
塁	曲卜添
眞	儿儿目
粛	又二川
畳	曲卜之
巌	目目添
瑳	三一米
柳	梄一乙
髄	目之之
韓	十寸十
掛	寸添卜
雑	月乙梄
籾	米梄乙
祐	之言大
凄	广寸一
踪	口卜之
厩	大大又
励	大大一
叡	卜寸之
鶏	斤添二
埼	二一大
顔	言米竹
装	广卜二
数	米梄巛
瑶	三一斤
黄	十一曲
欧	七添人
吟	口一又
奥	川目米
績	米卜目
祷	之言三
窃	之人七
禅	之言米
属	又竹竹
昼	又竹言
弥	乙巛竹
参	巛言大
福	二曲一
都	二竹言
麺	三卜儿
寝	之寸广
祢	之言竹
禄	之言又
堕	乙口大
是	曲一卜
豪	言一大
從	人卜卜
再	一添二
將	巛大寸
或	七竹一
剛	目寸曲
些	卜卜二
應	广大之
轉	梄曲寸
侍	川添寸
劉	儿七曲
重	竹十二
裡	之广二
盤	斤乙目
往	人卜三
豊	曲一米
陪	乙口口
除	乙口竹
餓	人又七
縣	目三巛
南	十寸米
懲	人卜之
整	梄一卜
克	十寸儿
壱	二二儿
率	言一十
封	二一寸
胡	十寸月
章	言米十
剣	人寸曲
輸	梄曲曲
倉	人寸口
夜	言一言
詩	言寸寸
彗	三卜又
存	大寸乙
命	人寸乙
唐	广大口
硬	大一人
髮	三七言
欲	人一儿
効	言一乙
亮	言一月
獲	月竹又
催	川添川
戰	口一七
園	口寸儿
抗	寸添月
架	乙竹梄
熊	巛言米
圈	口寸乙
降	乙口十
峯	目目三
植	梄一巛
麗	一添广
展	又竹七
堂	曲人二
救	寸言竹
願	大大大
宝	之寸言
寛	之寸目
零	梄添之
歯	卜卜巛
充	言一儿
免	儿添儿
農	曲一大
勁	一添乙
施	言乙乙
敏	竹一竹
糖	米梄口
宇	之寸寸
薄	十卜寸
瑞	三一大
尋	又二寸
騒	三米口
燕	十一米
膜	月添大
陰	乙口巛
揺	寸添目
嫁	巛竹大
臨	七一口
吻	口一斤
賢	七一目
帝	言一目
陶	乙口目
玲	三一之
驚	十卜三
執	二一月
備	川添月
幽	巛巛目
童	言米二
顎	口一大
柔	又言梄
碎	大一十
勤	十一乙
旗	言乙十
符	竹言寸
亭	言一一
簡	竹言曲
預	又言大
罷	目曲儿
腎	七一月
朗	言添月
擊	梄曲竹
騰	月添三
盆	人一目
傘	人寸十
翼	乙广人
敵	言一竹
採	寸添梄
叔	卜一又
殿	又竹月
旅	言乙儿
翠	乙广十
予	又言卜
錫	斤一斤
謀	言寸梄
庸	广大月
耗	三寸竹
壽	二二寸
逢	之一三
縫	巛一三
菊	十卜米
凝	广寸卜
貪	人寸目
雀	曲人川
逆	之一巛
摩	广大竹
棄	言一梄
郡	又大乙
堅	七一二
態	巛言之
鼎	目二川
慌	米卜川
縦	巛一卜
默	目曲大
悟	米卜口
頻	卜卜大
旋	言乙卜
臟	月添七
毅	言米月
郵	竹十乙
劫	二一乙
疏	又添川
廷	乙言二
紗	巛一竹
禪	之言十
駕	乙竹三
叢	曲米又
墳	二一目
頒	人一大
纖	巛一一
鞭	十十人
醇	梄寸乙
堤	二一卜
塑	米一二
鑄	斤一寸
亨	言一又
弊	曲添十
稻	竹梄川
喪	十寸七
舜	斤添十
寢	之寸又
梯	梄一川
矛	又言川
努	巛竹乙
雌	卜卜川
禽	人寸巛
党	曲人儿
緯	巛一十
冶	广寸口
壘	曲卜二
膚	卜七月
痘	广一米
寡	之寸乙
寅	之寸人
劣	曲人乙
斧	人一斤
阜	竹添十
嘲	口一月
絹	巛一月
阪	乙口又
鬱	竹二斤
諦	言寸目
鞠	十十米
彦	言米斤
猿	月竹儿
誕	言寸卜
蹄	口卜目
褐	之广巛
丞	又添一
曜	曲一川
宵	之寸月
肇	之竹二
岐	目目又
癖	广一言
灼	米人言
麓	梄一广
縛	巛一寸
殻	二二月
璽	一添言
尉	又竹寸
肢	月添又
厘	大大二
勉	儿添乙
禰	之言人
虜	卜七乙
璃	三一巛
磐	斤乙大
釜	人一米
膳	月添口
墾	斤月二
訟	言寸巛
幌	目卜大
婿	巛竹月
酪	梄寸口
黒	曲乙米
饗	巛人人
笹	竹言巛
翌	乙广言
舷	斤乙巛
亙	二寸广
恣	广寸之
庵	广大巛
惰	米卜月
塾	言一二
肴	人言月
畿	巛巛曲
恵	一添之
亜	二寸曲
嘗	曲人曲
喋	口一梄
酢	梄寸卜
彫	月一斤
郞	言添乙
単	添寸十
鵜	米寸儿
専	一添寸
惇	米卜乙
隈	乙口七
営	添寸口
栄	添寸梄
袈	乙竹儿
剤	言人曲
姉	巛竹目
労	添寸乙
鱒	儿一寸
叙	人寸又
惣	竹二之
勲	竹十米
奨	广卜大
娯	巛竹人
飜	斤梄广
栞	一添梄
賛	二言目
噂	口一寸
皐	川曲十
顚	儿儿大
勧	竹二乙
献	十寸大
舗	人寸梄
凉	广寸曲
怜	米卜之
竪	七一言
粧	米梄二
厨	大大寸
奬	巛大大
卽	川曲乙
随	乙口月
断	米梄斤
殴	七添月
刹	人言曲
惨	米卜斤
誉	添寸言
尽	又竹广
戯	卜七七
恋	言一之
盗	广寸目
