的	川
我	竹
是	曲
在	大
说	言
来	二
要	梄
只	口
出	巛
到	七
没	添
这	之
那	乙
后	斤
个	人
事	寸
下	一
然	儿
眼	目
头	广
着	米
现	三
真	十
对	又
点	卜
脸	月
你	川一竹
和	竹梄口
有	大寸月
就	言一口
都	二竹乙
吧	口一乙
她	巛竹乙
他	川一乙
认	言寸人
去	二一巛
洛	添添儿
逻	之一目
凿	曲米米
保	川一口
看	竹寸目
呢	口一又
松	梄一人
吗	口一三
繇	斤添竹
命	人寸一
與	川二一
给	巛一人
等	竹言二
迹	之一言
把	寸一乙
因	口寸大
能	巛言月
很	人卜又
多	儿言儿
什	川一十
想	梄一目
黑	目曲二
被	之广又
地	二一乙
後	人卜巛
徐	人卜人
两	一添目
將	巛大儿
昧	曲一二
但	川一曲
打	寸一一
年	竹一十
魔	广大梄
啦	口一寸
以	巛言人
買	目曲目
该	言寸言
虽	口一口
得	人卜曲
先	竹二儿
或	七竹口
呀	口一七
找	寸一七
亲	言米梄
及	乙添人
跟	口卜又
於	言乙人
太	大寸言
嘛	口一广
才	寸言竹
可	一卜口
比	儿儿儿
玩	三一二
们	川一又
最	曲一三
吃	口一竹
發	又口乙
普	米一曲
它	之寸儿
话	言寸竹
请	言寸三
钱	斤一七
叫	口一巛
開	又寸一
谁	言寸川
哈	口一人
常	曲人之
向	川目口
家	之寸大
问	又寸口
更	一添曲
快	米卜又
前	米一月
变	言一曲
加	乙竹口
所	之竹斤
天	一添大
父	人一人
里	曲乙二
刚	目寸人
宿	之寸川
老	二竹儿
接	寸一言
帶	十一儿
如	巛竹口
死	一添儿
賣	二二目
晕	曲一之
像	川一儿
使	川一大
罔	目寸米
成	七大乙
指	寸一儿
爱	斤添之
回	口寸口
聽	三十三
少	曲人竹
元	二寸儿
卡	卜一卜
告	竹二口
封	二一二
算	竹言目
惊	米卜言
起	二人乙
各	儿卜口
臾	川二人
分	人一乙
兄	口一儿
维	巛一川
则	目人曲
张	乙巛三
改	乙乙竹
连	之一梄
放	言乙竹
全	人寸三
护	寸一之
匮	七添口
莫	十卜曲
梭	梄一巛
早	曲一十
弄	三一十
本	梄一一
迫	之一川
性	米卜竹
第	竹言乙
完	之寸二
同	目寸一
花	十卜川
怕	米卜川
计	言寸十
杀	人言梄
组	巛一目
错	斤一十
些	卜卜儿
住	川一言
名	儿言口
路	口卜儿
次	广寸儿
睡	目二竹
奘	巛大二
掉	寸一卜
正	一添卜
外	儿言卜
副	一添口
府	广大川
弘	乙巛巛
类	米梄大
道	之一米
聿	又二二
每	竹一巛
法	添添二
乖	竹十广
推	寸一川
市	言一目
摸	寸一十
美	米三大
表	三卜儿
未	二寸曲
辦	言十乙
级	巛一乙
即	又人乙
叶	口一十
差	米三二
版	川又斤
伙	川一米
么	竹添巛
收	巛卜竹
男	曲卜乙
字	之寸乙
朋	月添月
辅	梄曲梄
何	川一一
考	二竹又
堆	二一川
黃	十一一
座	广大人
豬	大月二
聊	三十儿
取	三十又
燕	十一口
味	口一二
兒	川二儿
包	儿乙乙
阿	乙口一
喝	口一曲
近	之一斤
管	竹言之
定	之寸一
体	川一梄
样	梄一米
离	言一人
李	梄一乙
笑	竹言竹
开	一添十
慢	米卜曲
眉	又竹目
穿	之人七
越	二人七
贵	口口一
部	言米口
稻	竹梄斤
處	卜七儿
边	之一乙
站	言米卜
倒	川一七
谈	言寸米
曾	米寸目
群	又大口
經	巛一一
數	曲口巛
變	言寸巛
累	曲卜巛
河	添添一
查	梄一曲
象	儿添口
阵	乙口梄
红	巛一二
格	梄一儿
五	二卜又
朝	十寸曲
语	言寸二
顶	一卜大
某	十二梄
候	川一卜
亂	斤添又
进	之一二
海	添添竹
熱	二一人
光	曲人大
林	梄一梄
满	添添十
理	三一曲
流	添添言
持	寸一二
關	又寸巛
梁	添添乙
店	广大卜
安	之寸巛
从	人寸人
绝	巛一儿
飞	乙七广
留	儿七言
度	广大十
称	竹梄竹
幸	二一米
若	十卜大
原	大大川
饭	人又斤
晚	曲一儿
量	曲一一
村	梄一寸
式	七言二
空	之人二
赚	目人米
重	竹十曲
主	言添三
间	又寸曲
袖	之广曲
贴	目人卜
血	竹添目
般	斤乙月
爽	大寸人
隘	乙口米
喜	二二口
往	人卜言
囤	口寸七
狗	月竹儿
歲	卜卜七
费	乙巛川
境	二一言
共	十一人
周	月一二
明	曲一月
妈	巛竹三
均	二一儿
期	十三月
照	曲一乙
切	七寸乙
特	竹二二
氧	竹乙米
神	之言曲
英	十卜目
罵	目曲三
防	乙口言
既	又人七
建	乙言又
懂	米卜十
雙	川卜川
球	三一寸
跃	口卜竹
缚	巛一梄
清	添添三
提	寸一曲
队	乙口人
通	之一又
酒	添添梄
貘	斤月十
饰	人又竹
飘	梄口二
咪	口一米
久	儿添言
段	川一三
平	一添米
摇	寸一斤
套	大寸三
课	言寸曲
急	儿添又
城	二一七
羅	目曲巛
令	人寸之
左	大寸二
藏	十卜七
懸	目三曲
色	儿添乙
抢	寸一人
菜	十卜斤
集	川卜梄
感	七大一
房	之竹言
较	梄曲言
消	添添曲
敢	又添三
臉	月添人
操	寸一口
直	十寸目
破	大一又
声	二二又
德	人卜十
雪	梄添又
局	又竹乙
雲	梄添二
响	口一川
整	梄一口
伯	川一川
葬	十卜一
克	十寸口
咦	口一大
瑞	三一目
跳	口卜添
羕	米三言
襟	之广梄
困	口寸梄
深	添添之
反	斤寸又
樂	川曲巛
待	人卜二
砸	大一七
烦	米人大
根	梄一又
求	寸言添
势	寸一月
雷	梄添曲
惡	二巛之
苦	十卜十
款	二二二
知	竹大口
配	梄寸乙
刻	言一巛
调	言寸月
试	言寸七
屏	又竹米
面	大一口
逛	之一月
北	广卜儿
份	川一人
记	言寸乙
趟	二人曲
情	米卜三
需	梄添大
痛	广一又
利	竹梄曲
冷	广寸人
派	添添斤
阜	竹添乙
付	川一寸
庙	广大曲
阳	乙口曲
标	梄一二
军	之之梄
奧	川目竹
意	言米曲
科	竹梄广
星	曲一竹
牌	川又川
模	梄一十
翻	斤梄曲
随	乙口之
戴	二一曲
帖	目卜卜
帝	言一米
害	之寸三
玉	三一言
體	目之曲
造	之一竹
瑙	三一巛
解	儿添月
室	之寸七
底	广大儿
孜	乙一竹
朱	竹二曲
夜	言一川
须	斤三大
汉	添添又
译	言寸又
铐	斤一二
落	十卜添
简	竹言又
轩	梄曲一
策	竹言梄
轮	梄曲人
短	竹大一
今	人寸言
爆	米人曲
菁	十卜三
丫	米寸卜
骗	三米之
静	三卜月
耍	大目巛
板	梄一斤
赢	言七口
姐	巛竹目
公	人一巛
秀	竹梄乙
博	十寸梄
烬	米人又
毒	三卜巛
存	大寸卜
烤	米人二
幽	巛巛巛
虧	卜七川
民	乙二七
眯	目二米
忘	言七之
茶	十卜人
冰	广寸曲
初	之广乙
丝	巛一巛
项	二卜大
脱	月添米
緊	七一又
服	月添乙
盡	又二一
百	一添川
兵	斤二人
警	十卜儿
嘴	口一卜
答	竹言人
墙	二一十
果	曲一梄
唐	广大又
妥	斤添巛
硬	大一一
寒	之寸十
鬟	三七斤
距	口卜七
挑	寸一添
线	巛一七
鬥	曲寸三
源	添添大
戲	卜七一
首	米一川
思	曲卜之
梅	梄一竹
屑	又竹曲
窗	之人川
粉	米梄人
典	目寸十
御	人卜竹
疼	广一儿
著	十卜二
租	竹梄目
狼	月竹言
萧	十卜又
狂	月竹三
布	大寸目
引	乙巛卜
厚	大大曲
隻	川卜又
员	口一目
宋	之寸梄
银	斤一又
猛	月竹乙
码	大一三
友	大寸又
够	儿乙口
斯	十三斤
哼	口一言
望	言七月
腿	月添之
澡	添添口
围	口寸二
祝	之言口
響	巛人言
牀	巛大梄
尊	米寸梄
界	曲卜人
步	卜卜曲
制	竹二目
贼	目人七
尚	曲人目
似	川一巛
福	之言一
必	之巛竹
遭	之一十
煙	米人梄
否	大卜口
端	言米目
秦	三人竹
秋	竹梄米
托	寸一竹
露	梄添口
呆	口一梄
基	十三二
圈	口寸米
踏	口卜曲
呵	口一一
猫	月竹十
乃	乙添竹
右	大寸口
激	添添川
惨	米卜巛
证	言寸一
散	十一月
淡	添添米
治	添添巛
隐	乙口儿
岁	目目儿
妖	巛竹竹
料	米梄广
闪	又寸人
密	之寸之
爬	斤添乙
醒	梄寸曲
狠	月竹又
精	米梄三
鹰	广一川
疯	广一月
踩	口卜斤
软	梄曲儿
支	十寸又
鞋	十十二
居	又竹十
興	川二目
茵	十卜口
键	斤一乙
餘	人又人
世	十一巛
守	之寸寸
冒	曲一目
烂	米人米
弱	乙巛广
影	曲一言
州	添寸川
替	二言二
逼	之一一
陆	乙口二
显	曲一曲
泪	添添目
药	十卜巛
遍	之一之
细	巛一曲
狀	巛大大
閒	又寸月
武	一添七
聯	三十巛
偏	川一之
印	儿七一
销	斤一曲
零	梄添人
勒	十十乙
岛	儿巛目
耶	三十乙
孔	乙一巛
社	之言二
懒	米卜梄
雇	之竹川
顺	川寸大
浅	添添七
歉	米一又
娘	巛竹言
登	又口一
闷	又寸之
微	人卜目
传	川一二
盼	目二人
雅	七卜川
司	乙添一
拔	寸一大
志	二二之
奇	大寸一
编	巛一之
冯	广寸三
台	巛言口
负	儿添目
囚	口寸人
煮	二竹米
良	言添又
蛋	又添卜
仙	川一目
宫	之寸口
碰	大一米
酸	梄寸巛
与	一添巛
丈	一添人
尼	又竹儿
永	言添曲
琴	三一三
锱	斤一巛
馒	人又曲
稀	竹梄人
專	梄曲寸
确	大一儿
视	之言目
斋	言人大
善	米三米
忍	乙寸言
肯	卜卜月
职	三十口
致	七二竹
怒	巛竹又
腰	月添梄
嫩	巛竹梄
肖	曲人月
罪	目曲曲
强	乙巛口
丑	又添十
羲	米三竹
棒	梄一三
臭	川目大
闻	又寸三
校	梄一言
衣	言一儿
末	一添梄
耐	大目寸
莉	十卜竹
醉	梄寸言
铁	斤一竹
妹	巛竹二
钢	斤一目
憋	曲添目
宜	之寸目
灰	大寸米
屋	又竹七
层	又竹二
馆	人又之
丹	月一言
乘	竹添梄
芒	十卜言
酷	梄寸竹
缠	大一广
廳	广大三
鲁	儿一曲
具	目二一
劇	卜七大
并	米一十
电	曲一巛
链	斤一之
摆	寸一目
移	竹梄儿
骑	三米大
術	人卜梄
炸	米人竹
祗	之言儿
甩	月添巛
容	之人人
射	川三寸
索	十寸之
拼	寸一米
脖	月添十
委	竹梄巛
乜	乙添巛
夙	月寸一
袁	二一口
胃	曲卜月
臨	七一竹
狈	月竹目
帘	之人目
赴	二人卜
载	二一梄
躲	川三月
孟	乙一目
甜	竹卜十
彩	斤添梄
甚	十三巛
顾	大大乙
粗	米梄目
慶	广又又
驻	三米言
帐	目卜三
逃	之一添
升	竹添十
姚	巛竹添
症	广一一
功	二卜乙
钟	斤一口
泰	三人曲
忠	口口之
跨	口卜大
虚	卜七曲
瞎	目二之
卷	米二乙
于	一添寸
井	二寸川
蛇	口巛之
寺	二一寸
赎	目人十
饮	人又儿
略	曲卜儿
据	寸一又
带	十卜之
拜	竹寸一
冬	儿卜广
屿	目目一
镜	斤一言
铺	斤一梄
节	十卜乙
勇	又言月
财	目人寸
質	斤寸斤
乐	儿七曲
遇	之一曲
乔	竹添大
巨	七添又
怎	竹一卜
赌	目人二
泉	川曲曲
嫁	巛竹之
贾	梄口目
顿	七寸巛
攻	二卜竹
祥	之言米
崔	目目川
碗	大一之
赔	目人言
失	竹二人
雄	大寸巛
胸	月添儿
柜	梄一七
碟	大一十
珠	三一竹
惠	梄曲之
谭	言寸梄
希	人言大
属	又竹竹
岸	目目大
限	乙口又
碴	大一梄
扁	之竹目
余	人寸竹
嫌	巛竹米
羽	乙广乙
稿	竹梄言
帮	三卜乙
珍	三一人
赵	二人人
锦	斤一川
琳	三一梄
匯	七添添
霜	梄添梄
染	添添月
肺	月添一
附	乙口川
置	目曲十
悟	米卜二
助	目三乙
欣	斤寸儿
慧	三卜三
辣	言十梄
煤	米人十
圍	口寸又
鲜	儿一米
蛹	口巛又
锋	斤一儿
斌	言人一
覆	梄口人
盃	大卜目
蝇	口巛口
杯	梄一大
动	二寸巛
益	米一人
庭	广大乙
晨	曲一大
塵	广又二
败	目人竹
机	梄一月
弹	乙巛米
识	言寸口
喧	口一之
暖	曲一斤
涂	添添人
妻	一添又
质	斤寸十
奔	大寸十
冠	之之二
躺	川三曲
鑫	斤一斤
售	川卜口
婚	巛竹儿
摄	寸一三
医	七添竹
阁	又寸儿
邱	斤二乙
邪	七卜乙
鼠	川二巛
双	又言又
迎	之一儿
碎	大一言
承	又添曲
牠	竹二乙
凌	广寸二
妙	巛竹曲
始	巛竹巛
符	竹言川
肇	之竹竹
桌	卜寸曲
韋	又一口
嗨	口一添
積	竹梄三
舔	竹卜一
罚	目曲言
歪	大卜一
勾	儿乙巛
岗	目目目
洲	添添添
乎	竹添米
轴	梄曲曲
翔	米三乙
異	曲卜十
阪	乙口斤
餐	卜寸儿
鸭	曲乙儿
饼	人又米
粘	米梄卜
炮	米人儿
戒	七竹十
矣	巛言竹
柏	梄一川
轧	梄曲巛
姜	米三巛
瞧	目二川
皇	川曲三
企	人寸卜
箭	竹言米
焦	川卜米
延	乙言竹
粮	米梄言
岭	目目人
碧	三一川
籍	竹言三
刮	竹卜曲
忽	儿乙斤
钉	斤一一
判	米二曲
宠	之寸言
统	巛一言
为	米寸乙
诅	言寸目
叔	卜一曲
肩	之竹月
驢	三米卜
旭	月乙曲
航	斤乙言
蕾	十卜梄
块	二一又
凶	人言巛
畢	曲乙十
岳	斤二目
介	人寸川
渡	添添广
奮	大寸川
拳	米二竹
龅	卜人儿
職	三十言
牢	之寸竹
孤	乙一斤
召	乙寸口
规	二言目
颇	又卜大
奸	巛竹一
讨	言寸寸
醋	梄寸十
朵	月寸梄
穆	竹梄川
姬	巛竹七
乏	竹添之
耗	三寸曲
息	川目之
塘	二一广
桃	梄一添
臂	又竹口
霍	梄添川
焯	米人卜
暂	梄曲斤
虹	口巛二
腻	月添七
兮	人一又
肜	月添斤
矮	竹大竹
蝶	口巛十
诙	言寸大
枕	梄一之
毁	川二二
帕	目卜川
绩	巛一三
怜	米卜人
抬	寸一巛
幻	巛巛乙
衫	之广斤
固	口寸十
幅	目卜一
宾	之寸斤
悲	曲三之
疑	儿儿竹
屈	又竹巛
怨	儿二之
痒	广一米
恐	二卜月
凇	广寸梄
袄	之广竹
俘	川一斤
骚	三米又
熙	七一乙
抖	寸一广
粿	米梄曲
垒	巛言巛
准	广寸川
裤	之广广
扇	之竹乙
脣	大七月
蹲	口卜米
卿	儿七竹
鹤	之之川
缓	巛一斤
协	十寸乙
珞	三一儿
骷	目之十
鬿	川口斤
鼻	川目曲
碍	大一曲
陲	乙口竹
闭	又寸寸
妝	巛大巛
仇	川一月
获	十卜月
磊	大一大
胆	月添曲
窄	之人竹
雯	梄添言
癌	广一口
猴	月竹川
诉	言寸斤
经	巛一又
胜	月添竹
鹅	竹寸七
眸	目二巛
忌	乙乙之
龚	言卜十
孩	乙一言
炫	米人言
帽	目卜曲
狄	月竹米
霸	梄添十
叉	又言言
奉	三人二
突	之人大
账	目人三
毅	言米大
弦	乙巛言
罩	目曲卜
尽	又竹言
途	之一人
垂	竹十十
还	之一大
彪	卜七斤
纍	曲卜曲
斗	广寸十
坪	二一一
篑	竹言口
涉	添添卜
牧	竹二竹
兜	川曲儿
饒	人又二
纩	巛一广
战	卜寸口
聰	三十川
砚	大一目
铃	斤一人
验	三米人
糊	米梄十
蚁	口巛言
祭	儿二二
庞	广大言
裴	曲三言
责	三卜目
趴	口卜人
穗	竹梄梄
虐	卜七七
遮	之一广
忒	七言之
赋	目人一
敷	梄二言
臥	七一人
歷	大大竹
趿	口卜乙
岚	目目月
趣	二人三
痴	广一竹
崇	目目之
裕	之广人
艦	斤乙七
贞	卜寸目
筋	竹言月
帆	目卜月
阻	乙口目
蹦	口卜目
趋	二人儿
艘	斤乙川
靖	言米三
奏	三人一
釋	斤梄目
盲	言七目
环	三一大
狐	月竹斤
砖	大一二
笼	竹言言
鲍	儿一儿
阀	又寸川
联	三十米
珊	三一月
蠢	三人口
征	人卜一
钥	斤一月
屍	又竹一
姨	巛竹大
災	巛寸米
幢	目卜言
暢	曲梄曲
龄	卜人人
粼	米梄儿
捕	寸一梄
舱	斤乙人
万	一添乙
驱	三米七
碑	大一川
听	口一斤
朴	梄一卜
诧	言寸之
姑	巛竹十
衡	人卜儿
窭	之人米
眠	目二乙
铸	斤一三
辩	言十言
脚	月添二
辑	梄曲口
凸	口寸目
审	之寸曲
麟	广又米
礼	之言巛
醮	梄寸川
厮	大大十
遗	之一口
聘	三十曲
过	之一寸
廉	广大米
猁	月竹竹
氩	竹乙一
鞍	十十之
巫	二卜人
虞	卜七口
疤	广一乙
剝	巛又曲
筐	竹言七
睿	卜寸之
凹	口寸巛
瞪	目二又
危	儿添大
卸	竹二卜
慈	米一巛
阔	又寸添
瞒	目二十
骆	三米儿
驰	三米乙
鞭	十十川
兌	人一口
袭	言卜言
媛	巛竹斤
骏	三米巛
悦	米卜米
禹	竹添口
辨	言十曲
祕	之言之
巢	巛寸曲
脾	月添川
罗	目曲儿
烟	米人口
允	巛言儿
畔	曲卜米
豹	斤月儿
冥	之之曲
坏	二一大
轨	梄曲月
镣	斤一大
皓	川曲竹
央	目寸大
氖	竹乙乙
农	之之儿
浙	添添寸
玻	三一又
辈	曲三梄
冉	目寸二
卑	川口十
蜂	口巛儿
勺	儿乙言
恥	三十之
匹	七添儿
曦	曲一米
羞	米三又
嫂	巛竹川
瞳	目二言
妾	言米巛
蒋	十卜广
夷	大寸乙
氢	竹乙又
祁	之言乙
虬	口巛巛
飙	大言大
绮	巛一大
篮	竹言曲
氨	竹乙之
愣	米卜目
闹	又寸言
贯	巛乙目
锐	斤一米
瓣	言十斤
熏	竹十目
簏	竹言广
巡	之一巛
胀	月添三
匪	七添曲
弼	乙巛一
爵	斤添目
狻	月竹巛
貌	斤月川
灯	米人一
颐	七一大
庄	广大二
瞬	目二斤
酮	梄寸目
贡	二卜目
黄	十一曲
籽	米梄乙
循	人卜斤
魅	川口二
庑	广大一
璐	三一口
襯	之广言
掰	竹寸人
婴	目人目
痣	广一二
蹄	口卜言
堕	乙口大
勻	儿乙二
欺	十三儿
肆	三七又
悉	斤梄之
冶	广寸巛
继	巛一米
皖	川曲之
糕	米梄米
彙	巛又之
盐	二一卜
簿	竹言添
甸	儿乙曲
胤	儿寸巛
畏	曲卜七
酌	梄寸儿
覃	梄口曲
嵌	目目十
贩	目人斤
眾	目曲川
袍	之广儿
臻	七二三
眺	目二添
寂	之寸卜
醣	梄寸广
秤	竹梄一
螺	口巛曲
芷	十卜卜
卬	儿七乙
痞	广一大
栗	梄口梄
筝	竹言儿
矩	竹大七
靳	十十斤
峻	目目巛
秃	竹梄月
秉	竹梄又
盞	七竹七
役	人卜月
灾	之寸米
髓	目之之
魁	川口广
斥	斤寸言
匡	七添三
疆	乙巛二
霆	梄添乙
鬵	七寸儿
晓	曲一七
艇	斤乙乙
炉	米人之
砭	大一竹
崮	目目口
祺	之言十
蚀	人又口
埠	二一竹
酗	梄寸人
珂	三一一
蛛	口巛竹
履	又竹人
驶	三米口
褡	之广十
胯	月添大
阚	又寸又
衍	人卜添
祈	之言斤
魄	川曲川
崽	目目曲
琛	三一之
闲	又寸梄
辱	大七寸
匠	七添斤
肘	月添寸
究	之人月
戚	七大卜
蝉	口巛米
坨	二一之
畦	曲卜二
粟	梄口米
询	言寸儿
灿	米人目
袱	之广川
羨	米三添
窸	之人斤
臧	巛大七
妄	言七巛
弧	乙巛斤
瞿	目二目
卞	言一卜
蛤	口巛人
肃	又二川
皂	川曲七
会	人寸二
汞	二卜曲
翘	七竹大
煌	米人川
阅	又寸米
织	巛一口
旨	儿儿曲
竿	竹言一
驷	三米目
秸	竹梄二
绰	巛一卜
垢	二一斤
淼	曲添曲
甭	大卜月
瞟	目二梄
舅	川二曲
轿	梄曲竹
旷	曲一广
睹	目二二
褪	之广之
鞠	十十儿
酬	梄寸添
睛	目二三
窟	之人又
褚	之广二
镰	斤一广
猪	月竹二
巍	目目竹
鸦	七卜儿
嵩	目目言
骄	三米竹
穑	竹梄十
疮	广一人
鲸	儿一言
砼	大一人
糙	米梄之
邬	儿川乙
产	言米竹
罕	之之人
笊	竹言斤
俯	川一广
窕	之人添
毋	巛乙大
暇	曲一又
怔	米卜一
爻	人言人
乞	竹一乙
凋	广寸月
聋	言卜三
卉	十寸十
仄	大大人
箍	竹言寸
鸠	月乙儿
躁	口卜口
蛊	口巛目
瘩	广一十
鞘	十十曲
骤	三米三
踪	口卜之
醢	梄寸大
雋	川卜目
叽	口一月
勰	乙竹乙
馍	人又十
睏	曲一口
睁	目二儿
躬	川三乙
饵	人又三
屄	又竹之
尐	曲人言
阉	又寸大
贮	目人之
祯	之言卜
盅	口口目
尬	大儿人
趾	口卜卜
瘴	广一言
悼	米卜卜
脑	月添言
憾	米卜七
孓	又乙言
蹑	口卜三
町	曲卜一
麒	广又十
烩	米人人
珉	三一乙
冼	广寸竹
毯	竹七米
炙	儿言米
翊	言米乙
亢	言一月
羌	米三儿
惚	米卜儿
躯	川三七
启	之竹口
骥	三米广
枭	儿巛梄
弛	乙巛乙
秘	竹梄之
廁	广大目
瘟	广一曲
嶓	目目斤
颳	月卜竹
歧	卜卜十
肏	人寸目
碁	十三大
矶	大一月
丢	竹添二
叛	米二斤
糯	米梄梄
饲	人又乙
犹	月竹大
凰	月寸川
酡	梄寸之
厥	大大米
凉	广寸言
跺	口卜月
忻	米卜斤
绷	巛一月
晗	曲一人
蚂	口巛三
辫	言十巛
贻	目人巛
貂	斤月乙
踱	口卜广
怀	米卜大
彝	巛又米
础	大一巛
琰	三一米
舵	斤乙之
孬	大卜巛
罡	目曲一
桩	梄一广
匾	七添之
舀	斤添川
匝	七添目
顷	儿儿大
饥	人又月
狮	月竹曲
烧	米人七
簸	竹言十
胫	月添又
鳍	儿一二
匿	七添十
崴	目目七
眷	米二目
驯	三米川
舆	川二梄
垄	言卜二
諮	言寸广
覈	梄口川
羚	米三人
蝨	乙七十
帛	川曲目
眶	目二七
处	儿卜卜
皋	川曲大
穢	竹梄卜
鸢	七言儿
叟	川二卜
懇	斤月又
翡	曲三乙
轼	梄曲七
郅	七二乙
糗	米梄川
骐	三米十
垛	二一月
疽	广一目
尻	又竹月
孑	又乙一
隼	川卜十
幡	目卜斤
聆	三十人
骡	三米曲
颱	月卜巛
冪	之之十
稽	竹梄大
恙	米三之
徙	人卜卜
祢	之言竹
巽	乙乙乙
氰	竹乙三
羥	米三一
闺	又寸二
骊	三米一
饺	人又言
桀	儿言十
瘆	广一巛
骸	目之言
彿	人卜乙
驖	三米二
陨	乙口口
饷	人又川
辄	梄曲三
戍	七大言
蝗	口巛川
鲭	儿一三
楽	川曲添
愕	米卜口
乒	斤二竹
峡	目目二
骼	目之儿
飒	言米月
扉	之竹曲
嫉	巛竹广
篆	竹言巛
裱	之广三
晁	曲一添
氬	竹乙二
孢	乙一儿
円	目寸卜
為	米寸又
吝	言人口
穷	之人乙
袅	儿巛言
徊	人卜口
唇	大七口
罘	目曲大
趺	口卜二
汆	人寸曲
饴	人又巛
弌	七言一
癞	广一梄
崭	目目梄
疃	曲卜言
亍	一添一
氛	竹乙人
紊	言人巛
龋	卜人竹
嶙	目目米
雉	竹大川
舸	斤乙一
蛭	口巛七
畸	曲卜大
耽	十三之
疵	广一卜
霾	梄添斤
虔	卜七言
斓	言人又
熠	米人乙
让	言寸卜
囝	口寸乙
畈	曲卜斤
凯	目目乙
购	目人儿
狞	月竹之
衲	之广目
蠡	巛又大
晌	曲一川
彧	七言口
虾	口巛一
氦	竹乙言
脏	月添广
刈	人言曲
氓	言七乙
豢	米二大
惋	米卜之
対	言人寸
璨	三一卜
续	巛一十
鸳	儿二儿
轻	梄曲又
羯	米三曲
邕	巛寸口
骰	目之月
氡	竹乙儿
殓	儿言人
祟	巛卜目
皰	又卜儿
収	巛卜又
氤	竹乙口
牒	川又十
戦	斤添曲
贿	目人大
鲈	儿一卜
牋	川又七
孖	乙一乙
卍	乙添卜
凄	广寸一
廡	广大竹
数	米梄巛
戾	之竹大
亟	又乙口
鲫	儿一又
糰	米梄口
乓	斤二言
阈	又寸七
鱿	儿一大
纣	巛一寸
旧	卜添曲
胄	曲二月
韭	曲三一
凼	曲添巛
馗	月乙米
孺	乙一梄
菈	十卜寸
掱	竹寸竹
皎	川曲言
慷	米卜广
惢	之巛之
崛	目目又
庆	广大大
冑	曲二目
乄	竹添言
卐	巛添一
转	梄曲二
卢	卜寸又
酝	梄寸二
匈	儿乙人
酲	梄寸口
龌	卜人又
蠕	口巛梄
闿	又寸目
斫	大一斤
弁	巛言十
鞯	十十十
赊	目人人
虢	斤添寸
邯	十二乙
压	大大二
雠	川卜言
肿	月添口
鸵	儿巛之
発	又口二
爰	斤添一
卮	斤寸一
氷	曲添言
匦	七添梄
魑	川口言
蟠	口巛斤
妗	巛竹人
霂	梄添添
処	儿卜月
禄	之言又
禛	二曲儿
牘	川又二
写	之之一
鞅	十十目
赜	七一三
迓	之一七
罹	目曲米
鲠	儿一一
遽	之一卜
獭	月竹梄
舂	三人川
瑶	三一斤
帔	目卜又
冲	广寸口
冗	之之月
龊	卜人口
雎	目三川
酊	梄寸一
瘠	广一添
褛	之广米
亜	二寸口
阌	又寸斤
舐	竹卜儿
凫	儿巛月
砧	大一卜
窠	之人曲
蜒	口巛乙
褻	言一二
袜	之广一
蚩	巛卜一
奋	大寸曲
窈	之人巛
骈	三米米
魈	川口曲
颀	斤寸大
飕	月卜川
学	添寸之
嵴	目目添
憩	竹卜川
胪	月添卜
鞣	十十又
龆	卜人乙
犊	竹二十
麝	广又川
龇	卜人卜
囟	川口人
鲽	儿一十
团	口寸寸
龉	卜人二
氪	竹乙十
魃	川口大
艉	斤乙又
稣	儿一竹
蚪	口巛广
赒	目人月
豺	斤月寸
废	广大巛
珧	三一添
鞒	十十竹
帚	又二之
鲵	儿一川
羋	卜添卜
舻	斤乙卜
坝	二一目
鳕	儿一梄
褥	之广大
牖	川又之
徨	人卜川
魉	川口一
虺	大儿口
毬	竹七寸
骠	三米梄
雾	梄添儿
巣	添寸曲
忖	米卜寸
龃	卜人目
堃	言乙言
窣	之人言
厾	乙七二
蛎	口巛大
砻	言卜大
腆	月添目
瘢	广一斤
遨	之一三
尷	大儿七
宄	之寸月
饶	人又七
陟	乙口卜
魍	川口目
鲩	儿一之
粳	米梄一
朮	十寸儿
図	口寸广
氚	竹乙川
禳	之言言
彘	巛又儿
堊	二巛二
骱	目之人
鸨	儿儿十
赳	二人巛
跆	口卜巛
癍	广一三
骺	目之斤
皈	川曲斤
鲷	儿一月
奁	大寸七
鸸	大目儿
畋	曲卜竹
髀	目之川
盖	米三目
砉	三卜大
夤	儿言之
跗	口卜川
艨	斤乙十
裎	之广口
冢	之之大
瑭	三一广
蜚	曲三口
甥	竹三曲
犧	竹二米
夬	又添大
紧	曲寸又
皁	川曲十
轭	梄曲大
聴	三十十
帯	十一之
酹	梄寸斤
雩	梄添一
帙	目卜竹
独	月竹口
艏	斤乙米
国	口寸三
艄	斤乙曲
瞠	目二曲
钻	斤一卜
朓	月添添
庐	广大之
穸	之人儿
弾	乙巛添
氙	竹乙目
炘	米人斤
犏	竹二之
辵	斤三卜
舾	斤乙梄
飔	月卜曲
纤	巛一竹
舯	斤乙口
参	巛言大
帜	目卜口
糅	米梄又
龟	儿添曲
乸	乙卜巛
聃	三十目
凪	月寸卜
飓	月卜目
観	竹二川
恌	米卜添
醵	梄寸卜
矬	竹大人
徉	人卜米
舴	斤乙竹
麂	广又月
忆	米卜乙
毽	竹七乙
燹	大月大
屮	巛卜卜
蕲	十卜米
辘	梄曲广
厢	大大梄
尥	大儿儿
禸	目寸巛
庢	广大七
郷	巛人又
鳏	儿一目
豨	大月人
舨	斤乙斤
廻	乙言口
酔	梄寸月
齐	言人川
髑	目之目
飑	月卜儿
伞	人寸米
匐	儿乙一
鼡	添寸月
牁	巛大一
佻	川一添
敉	米梄竹
陬	乙口三
厎	大大儿
甡	竹三竹
囷	口寸竹
趼	口卜一
眚	竹三目
聒	三十竹
臸	七二七
虮	口巛月
黼	曲米曲
毐	二二巛
奓	大寸儿
褦	之广巛
囮	口寸川
貊	斤月一
犴	月竹一
匍	儿乙梄
单	米寸曲
祐	之言大
犒	竹二言
粄	米梄斤
皯	又卜一
臬	川目梄
靺	十十一
犷	月竹广
髎	目之乙
躰	川三梄
麈	广又言
祷	之言三
赶	二人一
琊	三一七
毳	竹七竹
轺	梄曲乙
覊	梄口十
躇	口卜十
尨	大儿斤
铫	斤一添
舭	斤乙儿
夛	又二儿
鲀	儿一七
邡	言乙乙
减	广寸七
牂	巛大米
趄	二人目
应	广大添
尪	大儿三
阗	又寸十
划	七竹曲
匜	七添乙
卆	月乙十
袤	言一又
赙	目人梄
鄜	广又乙
睚	目二大
觏	十二目
甁	竹添一
扂	之竹卜
祫	之言人
歭	卜卜二
祧	之言添
襤	之广七
趱	二人竹
狨	月竹七
舁	川二十
歯	卜卜米
茻	巛卜巛
颎	儿儿米
鏖	广又斤
图	口寸儿
厳	添寸大
辋	梄曲目
飮	人又卜
酎	梄寸寸
贶	目人口
幪	目卜十
矧	竹大乙
魆	川口七
虓	月乙卜
妀	乙乙巛
箎	竹言卜
墚	二一添
晫	曲一卜
竝	言米言
忐	卜一之
麇	广又竹
厌	大大大
区	七添人
颻	儿言竹
将	广卜斤
齮	卜人大
恧	大目之
弸	乙巛月
猞	月竹人
瓞	斤言竹
兴	添寸一
祔	之言川
鮻	儿一巛
尰	大儿竹
婓	曲三巛
輗	梄曲川
释	斤梄又
补	之广卜
朢	七一月
赃	目人广
帴	目卜七
厹	月乙巛
婥	巛竹卜
鳄	儿一口
韁	十十三
辚	梄曲米
匂	儿乙儿
峠	目目卜
鞐	十十卜
罥	目曲口
罠	目曲乙
盘	斤乙目
豋	儿二一
禋	之言梄
冞	之之米
墬	乙口巛
巟	言七川
麤	广又广
醑	梄寸又
甽	曲卜川
鷉	斤寸卜
忞	言人之
鞡	十十寸
徧	人卜之
醰	梄寸梄
粋	米梄月
氕	竹乙竹
夹	二寸米
耵	三十一
戽	之竹广
轳	梄曲卜
焌	米人巛
幓	目卜巛
皊	川曲人
舡	斤乙二
帏	目卜二
圣	又言二
覅	梄口巛
歃	竹十川
凧	月寸目
飐	月卜卜
繺	巛巛儿
帨	目卜米
餥	曲三人
幰	目卜之
瓟	斤言儿
顢	十一目
馕	人又一
毪	竹七巛
鲃	儿一乙
磲	大一添
瓨	二卜一
轱	梄曲十
猟	月竹添
寖	之寸添
圞	口寸言
眢	儿二目
熈	竹添七
牓	川又言
斲	曲米斤
厗	大大言
鲙	儿一人
犰	月竹月
覩	二竹目
犄	竹二大
粔	米梄七
孲	乙一二
塁	曲卜添
眞	儿儿目
廌	广又一
岊	乙曲目
趑	二人广
赆	目人又
齵	卜人曲
秬	竹梄七
窉	之人一
頴	儿儿二
彉	乙巛十
鳐	儿一斤
罛	目曲斤
靰	十十大
飏	月卜乙
麀	广又儿
祴	之言七
丱	巛卜二
桊	米二梄
矰	竹大米
廞	广大斤
羖	米三月
頄	月乙大
录	又二曲
豗	大儿大
覤	卜七目
鳦	儿巛乙
霢	梄添月
耎	大目大
夆	儿卜三
瓬	言乙一
窫	之人三
鄕	巛人川
虩	曲人曲
魋	川口川
鮡	儿一添
夘	儿言乙
齰	卜人十
廼	乙言梄
匊	儿乙米
癹	又口月
崝	目目三
尃	梄二寸
瓥	斤言大
颲	月卜一
褭	言一三
裯	之广月
詧	儿二言
矱	竹大十
訄	月乙言
罞	目曲又
戉	七竹巛
耏	大目斤
麕	广又口
捄	寸一寸
豤	大月又
臮	川目川
斶	斤寸目
鵻	儿巛川
疟	广一七
虤	卜七卜
蠪	言卜口
颿	三米月
郙	梄二乙
騨	三米添
虖	卜七竹
瓩	一巛竹
龂	卜人斤
丏	一卜巛
鞙	十十口
帊	目卜乙
瞶	目二口
靿	十十巛
蝋	口巛添
毇	川二米
醧	梄寸七
畷	曲卜又
躾	川三米
杂	月乙梄
豝	大月乙
齸	卜人米
猇	月竹卜
廘	广大广
牼	竹二一
氲	竹乙曲
爌	米人广
帢	目卜人
罧	目曲梄
髆	目之梄
犌	竹二又
徛	人卜大
誂	言寸添
壿	二二米
剕	曲三曲
貤	目人乙
阤	乙口乙
霉	梄添竹
齯	卜人川
嶊	目目寸
姗	巛竹月
郋	川目乙
扅	之竹儿
彃	乙巛曲
册	月一月
翈	曲乙乙
覂	梄口竹
骭	目之一
呇	曲添口
飋	月卜三
駈	三米斤
牉	川又米
豽	斤月目
鴗	言米儿
扊	之竹米
彄	乙巛七
斨	巛大斤
鴀	大卜儿
虑	卜七之
鞧	十十米
魖	川口卜
牏	川又人
趬	二人二
耾	三十大
豶	大月十
幖	目卜梄
舑	竹卜目
羢	米三七
禂	之言月
隶	又二添
奫	大寸添
趮	二人口
剚	寸言口
幨	目卜儿
矲	竹大目
仑	人寸儿
鹱	儿巛十
歍	儿川儿
趡	二人川
聝	三十七
朄	曲梄梄
鼏	之之目
鵔	儿巛巛
砀	大一乙
骴	目之卜
垹	二一三
盭	巛巛二
鵏	梄二儿
鵄	七二儿
蠦	口巛卜
齖	卜人七
貍	斤月曲
燄	儿添川
鵖	又人儿
貣	七言目
齝	卜人巛
蹅	口卜梄
諅	十三言
镺	三七竹
豥	大月言
尳	大儿目
狾	月竹寸
牄	巛大人
鞈	十十人
罭	目曲七
貆	斤月二
矌	目二广
鸃	儿巛米
鄳	之又乙
蠽	曲人川
雟	巛卜川
舝	又一巛
麁	儿添广
絭	米二巛
豜	大月一
庪	广大寸
麆	广又目
皹	又卜之
筴	竹言大
餟	人又又
刌	寸言曲
韏	米二又
甝	卜七十
顈	儿儿巛
忰	米卜月
甹	曲二又
麎	广又大
陈	乙口七
骋	儿巛曲
鳺	二言儿
帗	目卜大
鞹	十十言
杗	言七梄
髐	目之二
髅	目之米
隿	七言川
鸗	言卜儿
烑	米人添
皫	川曲广
衁	言七竹
齱	卜人三
飉	月卜大
羵	米三十
軈	川三广
彋	乙巛目
舕	竹卜米
嵣	目目广
羺	米三梄
趪	二人十
皏	川曲米
鳭	乙寸儿
痯	广一之
趓	二人月
麜	广又梄
毰	竹七言
屔	斤二又
蝁	二巛口
邞	二言乙
趥	二人米
齴	卜人言
颬	月卜七
鵌	儿巛人
餪	人又大
蛷	口巛寸
鲞	米二儿
髍	目之广
顝	目之大
麠	广又三
豟	大月之
氁	竹七十
芈	卜寸卜
貀	斤月巛
弤	乙巛儿
犣	竹二巛
麙	广又七
镽	三七大
豱	大月曲
貁	斤月之
貕	斤月斤
犥	竹二广
羳	米三斤
豯	大月斤
齤	米二卜
瓲	一巛七
惷	三人之
眦	目二卜
甪	竹添月
虱	乙七竹
攷	又乙竹
尔	竹一曲
决	广寸又
异	乙二十
隽	川卜乙
厩	大大又
邮	曲二乙
羡	米三广
垦	又人二
耻	三十卜
厉	大大一
鶏	斤添二
厕	大大目
寻	又二寸
劝	又言乙
灵	又二米
䶮	言卜一
袰	巛乙言
敌	竹卜竹
銶	斤一寸
匋	儿乙竹
棊	十三梄
馇	人又梄
备	儿卜曲
关	米一大
貙	斤月七
毌	巛乙十
发	巛添竹
时	曲一寸
当	曲人又
县	目三巛
条	儿卜梄
装	广卜二
总	米寸口
实	之寸广
观	又言目
难	又言川
买	又添广
办	乙竹人
阴	乙口月
寿	三卜寸
丧	十寸米
夺	大寸寸
牵	大寸之
卧	七一卜
东	七寸曲
盏	七竹目
虏	卜七乙
师	曲寸一
畴	曲卜三
帅	曲寸目
临	曲寸竹
尘	曲人二
邺	曲米乙
畅	曲梄乙
毡	竹七卜
乱	竹卜巛
辞	竹卜言
粤	川口米
奥	川目米
创	人寸乙
彻	人卜七
鷈	儿巛斤
鴃	儿巛又
务	儿卜乙
匀	儿乙广
亵	言一寸
刘	言人曲
义	言添人
状	广卜大
妆	广卜巛
兰	米一二
誊	米二言
养	米三川
劲	又添言
怼	又言寸
戏	又言七
欢	又言儿
恳	又人之
卫	乙目一
孙	乙一曲
弥	乙巛竹
导	乙二寸
𠙶	又乙巛
飨	巛人人
𤭯	一巛川
福	二曲一
神	二曲曲
祥	二曲米
击	二寸目
都	二竹言
赍	十寸人
尴	大儿曲
𬌗	七卜人
𬺓	卜人梄
𬱖	曲二大
觃	目儿乙
牺	竹二梄
氇	竹七儿
囱	川口儿
馉	人又目
凤	月寸又
颾	月卜又
鳙	儿一广
鳼	言人儿
㶲	米人月
窝	之人口
窦	之人十
衬	之广寸
书	又添乙
𩲵	川口竹
𦄇	巛一添
𫼔	竹寸乙
𬦼	二竹巛
𠁂	二竹一
𬎽	月二儿
𫵀	曲人米
𨐮	言十十
𫡸	二寸梄
𫖽	月寸二
𤭷	一巛人
𧱺	大月川
𩿠	儿巛七
𪯯	大大卜
𥦝	之人梄
𥏿	竹大又
𤽶	川曲又
𬎶	竹三又
𣰙	竹七梄
𩯹	三七巛
𪵌	月又川
𫶸	乙曲川
𩃳	梄添三
𡮌	曲人人
𩆾	梄添卜
𪥤	卜一巛
𪭩	竹寸川
𱜞	乙曲二
𪵟	竹七又
𨲅	三七乙
𬔦	言米添
𨉞	川三二
𪅥	川卜儿
𧼍	二人又
𫡦	人寸斤
𤘓	七卜之
𠁵	口口曲
𠝗	乙寸米
𫠺	卜一又
𫯝	卜一一
𠀖	十一言
炐	米人三
𪩱	乙曲又
鴼	儿巛儿
𫲴	乙一十
艔	斤乙广
𣭯	竹七大
厛	大大口
𤿭	又卜梄
𬇒	竹乙大
𪨃	曲人寸
𡭉	米二川
𡥴	乙一川
𣥱	卜卜大
𠟲	川目斤
𫤾	广寸乙
㓟	又卜曲
𪿐	竹大梄
𫕡	梄添广
𪤷	儿言目
𨈒	川三卜
𫶮	二卜十
𠙅	月寸言
𩖫	月卜言
𡳥	又竹大
𠁹	口口川
𫹰	之巛又
𤮄	一巛一
𫏪	川三口
𧳇	斤月人
𤾷	川曲寸
𥉭	目二寸
𪯾	言乙口
𠟹	乙寸又
𧰦	乙七大
𤮑	一巛曲
𪭘	之竹七
𪅦	儿巛口
𤬀	斤言人
𢲱	竹寸十
𫹄	又卜又
𫕲	梄添之
𫕨	梄添巛
𫘴	目之又
𬎳	竹三梄
𦧷	竹卜广
𠄦	二寸乙
𬹷	卜人之
𠀫	十三竹
𨉓	川三人
𪛇	儿添之
𫶼	乙曲言
𥀪	又卜言
𣀟	乙曲曲
𪨀	曲人巛
𬔙	乙寸二
𡮛	曲人添
𫫞	竹卜人
𪜀	十寸巛
𪃲	儿巛二
𪺦	川又月
斍	言人目
𩩩	目之三
𨃌	口卜寸
𪮏	竹寸曲
𧥔	乙曲儿
𠥈	七添二
𢁋	乙曲乙
𪽐	竹添曲
𫶻	乙曲七
𡚚	大寸梄
𧸓	目人添
𡰏	大儿添
𩘫	月卜添
𪥌	川目人
𬮌	言人二
𢬣	竹寸梄
𠞠	乙寸竹
𫡾	言七米
𠤧	儿儿寸
𱻛	十三乙
𪀐	儿巛竹
𬀺	乙乙曲
𠃩	月乙人
𫼜	竹寸卜
𣼪	人一添
𩲥	川口巛
𪺬	竹二月
𫇈	七一言
𩵝	儿一寸
𢩉	之竹十
𬌘	七卜目
𬇆	竹七二
𬏧	广一寸
𠀗	十一竹
𪽃	竹三三
𪽡	乙曲斤
𩘄	月卜梄
𪮽	竹寸斤
𫼠	竹寸言
𥀌	又卜十
𥏍	竹大儿
𢖮	乙七之
𫷆	目卜目
𬎹	竹三月
𩘬	月卜之
𩪽	目之巛
𪤘	巛言二
𥺕	米梄寸
𤽴	川曲二
𧴋	斤月梄
𨵣	曲寸二
𠃣	乙七曲
𪩯	乙二言
𨖧	竹七之
䲼	竹三儿
𪩭	乙曲梄
𤳱	曲卜广
𩿚	儿巛广
𪺨	七卜言
𫠽	卜一米
𢪥	竹寸儿
𫚳	儿巛卜
𤮃	一巛目
𫠼	卜一寸
醝	梄寸米
𫠮	七二一
𤳨	曲二之
𪮩	竹寸米
𥐉	又人竹
𤯰	竹三广
𩄔	梄添寸
𫠻	大卜川
𠖘	之之巛
𬇑	竹乙梄
𪠗	斤寸曲
彣	言人斤
𥘑	之言寸
𢄃	目卜添
𠅒	言七一
𱫳	七竹儿
𩂟	梄添七
𥼳	米梄二
𫥸	乙寸卜
𠄽	二寸寸
𠡏	竹三乙
𫇐	七二又
𥸿	乙曲米
䲨	二卜儿
𩍢	十十梄
𫌢	目儿十
𠜭	乙寸寸
𠄳	二寸二
𨸾	乙口广
𬏌	曲二二
𠀧	乙曲三
𨱽	三七曲
𪓪	之又口
𪺤	川又口
𪟓	乙寸乙
𤗲	川又巛
𥢳	竹梄添
𩳳	川口梄
𢏿	乙巛之
𫯰	二言竹
𫼴	竹寸口
𨐸	言十又
𫢍	斤寸人
𤮒	一巛又
𠝕	乙寸曲
𦨑	斤乙寸
厔	大大七
𣎞	乙曲月
𦕳	三十二
𬇅	竹七七
𨱪	三七月
𫡔	儿添卜
𧢑	目儿又
𨴦	又言三
𠁙	大卜言
𤮠	一巛十
𤭵	一巛言
𫁧	言米人
𤮗	一巛口
𡮋	曲人梄
𦗝	三十梄
𢂜	又大大
𡥚	乙一一
𤮾	大儿十
𨲷	三七言
𠦻	米二二
𧼋	二人斤
𫉓	米一目
𫦬	月乙目
𡮭	乙二乙
𨊋	川三目
𥩰	言米七
𦤾	七二曲
𡮷	曲人七
𦒮	言卜乙
𩙍	月卜人
𤮟	一巛二
𤽗	川曲卜
𪭳	竹寸又
𫯿	二言又
𫠸	卜一添
𩿨	斤二儿
𦗽	三十广
𠅻	言七添
𤖶	川又一
𬇁	竹七目
𤗆	川又竹
𣒳	二卜梄
𦧜	竹卜大
𫖧	大人曲
𩄶	梄添米
𤗖	川又乙
𢽼	乙曲人
𫠷	卜一川
𩝺	人又寸
𫙍	川口乙
𤻓	十三广
𬧮	川三巛
𤘋	七卜竹
𣫲	巛乙川
𩴅	川口三
𡮪	曲人十
𫵍	曲人卜
𦥃	七二目
𪾉	又卜三
𩄨	梄添目
𫔯	又寸广
𬖽	米梄添
𬧡	川三言
𤮿	十二大
𢩛	之竹二
𡥤	乙一三
𫽑	月又寸
𫀟	二曲乙
𬔑	之人卜
𣃱	言乙七
𣃣	言乙又
𤯺	竹三十
𬚍	二竹二
𤻑	广一广
𧻐	二人言
𠀲	一卜儿
𬆞	月又言
𢁊	乙曲寸
𪽁	竹三卜
𤓺	斤添广
𤖡	巛大之
𣂃	二竹广
鵶	二巛儿
𤔽	斤添十
𩲡	二曲川
𫨫	巛言卜
𡮫	儿言大
𤯆	十二言
