的	白勹丶
了	了
我	手戈
是	日一止
在	大丨土
和	禾口
有	大月
不	不
就	亠口小尤
都	者阝
也	也
要	西女
好	女子
他	亻也
去	土厶
到	至刂
還	之四口𧘇
上	上
那	刀二阝
人	人
個	亻圍十口
看	手目
中	中
來	木人人
爲	爲
與	臼一丨八
給	絲人一口
等	⺮土寸
這	之言
用	用
把	扌巴
下	一卜
恩	圍大心
能	厶月匕匕
多	夕夕
想	木目心
被	衤皮
地	土也
而	而
一	一
後	行幺夂
又	又
從	行人人止
再	一冂土
將	爿夕寸
時	日土寸
但	亻日一
過	之咼
打	扌丁
大	大
年	𠂉㐄
以	厶人
買	四貝
讓	言衣口甘
着	羊目
小	小
得	行日一寸
先	牛儿
或	戈口一
新	立木斤
及	㇆人
於	方人冫
太	大丶
日	日
才	寸丿
可	丁口
比	匕匕
玩	王一兀
最	日耳又
月	月
真	十目一八
並	䒑业
其	其
話	言舌
請	言丰月
叫	口凵
開	門一艹
出	凵山
誰	言隹
向	自口
家	宀豕
問	門口
之	之
更	一日乂
該	言亠乡人
走	走
快	忄㇕大
別	口力刂
前	䒑月刂
由	由
高	亠口冂口
裏	衣田土
加	力口
所	户斤
天	一大
已	巳
里	田土
老	者匕
行	行
事	一口尹
帶	廿儿冖巾
如	女口
死	一夕匕
賣	士四貝
像	亻𠂊口豕
使	亻一口乂
剛	冂䒑山刂
成	戊㇆
無	𠂉廿灬
換	扌𠂊八大
只	口八
愛	爪冖心夂
回	圍口
聽	耳王一心
少	小丿
元	一兀
喫	口丰刀大
算	⺮目艹
者	者
忙	忄亡
起	走己
各	夂口
分	八刀
則	貝刂
水	水
張	弓長
改	己攵
三	三
見	見
連	之車
車	車
放	方攵
全	人王
按	扌宀女
萬	艹日冂厶
機	木幺戈人
早	日十
拉	扌立
弄	王艹
本	木一
偶	亻日冂厶
頁	頁
進	之隹
性	忄生
第	⺮弓亻
完	宀一兀
同	冂一口
花	艹亻匕
長	長
女	女
講	言甘冂土
殺	乂木殳
組	絲且
錯	金廿日
些	止匕二
住	亻丶王
名	夕口
次	冫欠
網	絲冂䒑亡
睡	目千艹二
裝	爿士衣
挺	扌廴丿士
王	王
路	足夂口
正	一止
外	夕卜
二	二
頭	一口䒑頁
應	广亻隹心
生	生
心	心
因	圍大
子	子
強	弓厶虫
類	米大頁
作	亻𠂉卜
送	之䒑大
書	尹二日
每	𠂉母
法	氵土厶
拍	扌白
市	亠巾
撒	扌廿月攵
至	至
接	扌立女
美	羊大
表	丰𧘇
未	二小
非	非
級	絲㇆人
即	艮卩
此	止匕
差	羊工
版	片斤又
併	亻䒑艹
副	一口田刂
系	丿絲
收	凵攵
男	田力
俺	亻大申
字	宀子
股	月殳
轉	車車寸
便	亻一日乂
考	者丂
塊	土鬼
線	絲白水
手	手
黃	廿一由八
道	之䒑自
米	米
座	广人人土
取	耳又
低	亻氏一
難	廿口夫隹
兒	臼儿
受	爪冖又
包	勹己
阿	阝丁口
喝	口日人乚
白	白
金	金
四	四
近	之斤
管	⺮宀㠯
定	宀一止
傳	亻車寸
門	門
樣	木羊丶水
交	亠八乂
李	木子
笑	⺮丿大
自	自
型	一艹刂土
黑	四土灬
慢	忄日四又
刷	尸巾刂
穿	穴牙
越	走戈乚
位	亻立
貴	中一貝
部	立口阝
選	之己己廿八
牛	牛
怪	忄又土
省	小丿目
倒	亻至刂
談	言火火
曾	丷四日
累	田絲
汗	氵一十
象	𠂊口豕
半	半
陳	阝木日
紅	絲工
格	木夂口
五	工㇕
幹	十日一十
方	方
頂	丁頁
某	甘木
條	亻丨夂木
馬	馬
遠	之土口𧘇
單	口口甲一
海	氵𠂉母
相	木目
熱	土八丸灬
光	小兀
風	風
且	且
林	木木
額	宀夂口頁
化	亻匕
班	王刂王
滴	氵亠十口
掛	扌土土卜
店	广卜口
安	宀女
坐	人人土
約	絲勹丶
飛	乙冫乙冫
劉	氏丶金刂
度	广廿又
種	禾千日二
俄	亻手戈
歌	丁口口欠
報	土半卩又
信	亻言
若	艹大口
原	厂白小
文	文
飯	食斤又
晚	日𠂊口儿
量	日一田土
村	木寸
式	弋工
空	穴工
山	山
毛	毛
重	千日二
主	丶王
間	門日
裡	衤田土
貼	貝卜口
入	人
伐	亻戈
血	丿皿
盤	舟殳皿
爽	大乂乂乂
隊	阝丷豕
楊	木日勹彡
往	行丶王
片	片
國	圍戈口一
費	弓川貝
壞	土衣四水
龍	龍
離	亠乂厶隹
共	廿八
西	西
周	周土口
超	走刀口
明	日月
均	土勹二
期	其月
達	之土羊
照	日刀口灬
切	七刀
留	氏丶刀田
動	千日二力
特	牛土寸
氣	气米
係	亻丿絲
神	示申
鳥	鳥
夢	艹四冖夕
教	者子攵
甘	甘
魚	魚
鎮	金十目一八
罵	四馬
陪	阝立口
既	艮七儿
力	力
建	廴尹二
洗	氵牛儿
口	口
指	扌匕日
東	木日
球	王寸氵丶
活	氵舌
練	絲木日
億	亻立日心
清	氵丰月
提	扌日一止
除	阝人禾
通	之又用
酒	氵酉
餓	食手戈
票	西示
六	亠八
病	疒一冂人
久	𠂊丶
段	亻三殳
平	一丷十
套	大長
課	言田木
急	𠂊彐心
藥	艹白幺木
城	土戊㇆
任	亻丿士
草	艹日十
羅	四絲隹
理	王田土
令	人之
雨	雨
貨	亻匕貝
唱	口日日
左	大工
藍	艹臣⺮皿
縣	且小丿絲
常	小冖口巾
色	𠂊巴
菜	艹爪木
集	隹木
感	戊一口心
房	户方
較	車亠八乂
混	氵日匕匕
敢	丁耳攵
火	火
操	扌口口木
南	十冂半
退	之艮
件	亻牛
破	石皮
德	行十一心
雪	雨彐
局	尸㇆口
雲	雨二厶
整	木口一止
華	艹一艹工
克	十口儿
現	王見
跳	足儿氵
養	羊丶艮
補	衤甫
團	圍車寸
沈	氵冖儿
反	斤又
樂	白幺幺木
篇	⺮户冂艹
待	行土寸
深	氵冖八木
煩	火頁
根	木艮
求	寸氵丶
投	扌殳
電	雨申
親	立木見
惡	亞心
葉	艹廿乚木
款	士示欠
知	矢口
八	八
配	酉己
器	口口大口口
何	亻丁口
率	亠幺氵十
調	言周土口
鬼	鬼
修	亻丨夂彡
試	言弋工
謝	言身寸
僅	亻廿口丰
層	尸丷田日
面	㇕圍目
週	之周土口
北	丬匕
木	木
記	言己
情	忄丰月
肉	冂人人
需	雨而
七	七
論	言人冂艹
流	氵亠厶川
招	扌刀口
痛	疒又用
列	一夕刂
石	石
香	禾日
封	土土寸
眼	目艮
易	日勹彡
冷	冫人之
借	亻廿日
派	氵斤氏
帥	丿㠯巾
付	亻寸
十	十
陽	阝日勹彡
樹	木士䒑寸
油	氵由
胡	十口月
排	扌非
停	亻亠冖丁
合	人一口
軍	冖車
身	身
奧	自丿釆大
章	立日十
科	禾冫十
星	日生
翻	釆田习习
場	土日勹彡
帖	巾卜口
商	亠丷八口
庫	广車
價	亻西貝
物	牛勹彡
泡	氵勹己
玉	王丶
追	之丿㠯
傷	亻𠂉勹彡
背	丬匕月
劍	人一人刂
解	𠂊用刀牛
室	宀至
底	广氏一
業	业丷三小
代	亻弋
孫	子丿絲
朱	𠂉木
亦	亠川八
須	彡頁
乾	十日𠂉乙
工	工
詞	言㇆一口
刀	刀
波	氵皮
推	扌隹
落	艹氵夂口
節	⺮艮卩
春	春
九	九
輸	車人月刂
江	氵工
短	矢一口䒑
含	人丶㇕口
千	千
徐	行人禾
秒	禾小丿
青	丰月
夜	亠亻夂丶
許	言𠂉十
吹	口欠
師	丿㠯一巾
板	木斤又
土	土
直	十目乚
公	八厶
苦	艹十口
秀	禾㇆丿
博	十甫寸
皮	皮
朝	十日十月
君	尹口
詩	言土寸
靜	丰月爪尹
利	禾刂
素	丰絲
立	立
存	大丨子
燒	火土土兀
吾	工㇕口
湯	氵日勹彡
民	巳七
極	木了又一
命	人一口卩
忘	亡心
茶	艹人木
供	亻廿八
案	宀女木
田	田
初	衤刀
品	口口口
抽	扌由
造	之牛口
抱	扌勹己
野	田土㇕丨
綠	絲彑水
項	工頁
緊	臣又絲
故	十口攵
服	月卩又
盡	尹一灬皿
百	一白
兵	丘八
英	艹冂大
蘇	艹魚禾
般	舟殳
演	氵宀由八
果	田木
保	亻口木
唐	广尹口
夏	一自夂
莫	艹日大
硬	石一日乂
寒	宀甘八冫
凡	凡
髮	長彡犬丿
言	言
題	日一止頁
防	阝方
街	行土土
距	足匚㇕
挑	扌儿氵
純	絲七凵
欲	八人口欠
源	氵厂白小
官	宀㠯
戲	虎一䒑戈
寄	宀大丁口
古	十口
首	䒑自
思	田心
橋	木丿冂口
燈	火癶口䒑
郭	亠口子阝
亮	亠口冖几
干	一十
窮	穴身弓
粉	米八刀
爆	火日八水
韓	十日口㐄
戴	十戈廿八
然	夕犬灬
衝	行千日二
雷	雨田
蓋	艹土厶皿
港	氵廿八己
租	禾且
狼	犭丶艮
蘭	艹門木日
狂	犭王
布	大巾
引	弓丨
亞	亞
齊	亠丷氏川
隻	隹又
員	口貝
佛	亻弓川
食	食
船	舟几口
今	人丶㇕
恨	忄艮
宋	宀木
銀	金艮
猛	犭子皿
客	宀夂口
友	大又
領	人之頁
句	勹口
斯	其斤
沙	氵小丿
戰	口口一戈
望	亡月王
沖	氵中
丁	丁
園	圍土口𧘇
祝	示口儿
鄭	丷酉大阝
界	田八川
抗	扌亠几
步	止小
河	氵丁口
賊	貝戈大
尚	小冂口
似	亻厶人
羊	羊
福	示一口田
必	心丿
遭	之艹日日
煙	火西土
否	不口
端	立山而
設	言殳
伊	亻尹
秦	春禾
秋	禾火
毒	丰母
架	力口木
熊	厶月匕灬
持	扌土寸
廣	广廿由八
折	扌斤
意	立日心
基	其土
困	圍木
圈	圍半卩
迷	之米
勝	月半力
史	口乂
甲	甲
搬	扌舟殳
獲	犭艹隹又
紙	絲氏
乃	㇆丿
右	大口
塔	土艹一口
準	氵隹十
院	阝宀一兀
訂	言丁
散	廿月攵
松	木人厶
喜	士口䒑口
洋	氵羊
語	言工㇕口
呈	口王
治	氵厶口
降	阝夂㐄
峯	山夂丰
漢	氵廿口夫
富	宀一口田
姓	女生
料	米冫十
結	絲士口
閃	門人
梅	木𠂉母
批	扌匕匕
足	足
寧	宀心皿丁
醒	酉日生
精	米丰月
瘦	疒臼丨又
槍	木人户口
軟	車欠
支	十又
杜	木土
麗	一冂丶鹿
展	尸艹展
興	臼冂口八
依	亻衣
倍	亻立口
康	广尹氵
堂	小冖口土
救	寸氵丶攵
鍵	金廴尹二
製	牛巾刂衣
筆	⺮尹二
音	立日
世	廿乚
著	艹者
仲	亻中
舞	𠂉廿夕㐄
守	宀寸
露	雨足夂口
冒	日目
昇	日丿艹
唄	口貝
榮	火火冖木
弱	弓冫弓冫
影	日亠小彡
州	⺍川
替	夫夫日
陸	阝土八土
曲	日刂
願	厂白小頁
牙	牙
箱	⺮木目
嚇	口土川八
測	氵貝刂
莊	艹爿士
寬	宀艹見丶
遍	之户冂艹
細	絲田
狀	爿犬
巴	巴
武	一弋止
湖	氵十口月
程	禾口王
柳	木氏丿卩
偏	亻户冂艹
實	宀母貝
印	亻二卩
味	口二小
鎖	金小貝
衆	丿皿乑
零	雨人之
環	王四口𧘇
角	𠂊用
紫	止匕絲
島	鳥山
耶	耳阝
熟	亠口丸灬
孔	子乚
寸	寸
標	木西示
厚	厂日子
答	⺮人一口
社	示土
顧	户隹頁
順	川頁
滅	氵戊一火
運	之冖車
輪	車人冂艹
兼	䒑彐刂八
溫	氵圍人皿
娘	女丶艮
登	癶一口䒑
微	行山几攵
佳	亻土土
瞭	目人日小
雅	牙隹
魔	广木木鬼
司	㇆一口
志	士心
奇	大丁口
編	絲户冂艹
瓦	瓦
居	尸十口
盛	戊㇆皿
虎	虎
后	斤一口
洞	氵冂一口
台	厶口
形	一艹彡
負	𠂊貝
川	川
圓	圍口貝
充	亠厶儿
害	宀丰口
免	𠂊口儿
景	日亠口小
擬	扌匕㇕止
曹	艹日日
曉	日土土兀
煮	者灬
良	丶艮
吐	口土
肥	月巴
仙	亻山
宮	宀口丿口
酸	酉厶八夂
侯	亻㇕矢
塞	宀甘八土
勁	一巛工力
欠	欠
創	人户口刂
擦	扌宀夗示
爾	一八乂乂
藏	艹戈爿臣
皆	匕匕白
永	丶水
夫	夫
琴	王王丶㇕
錄	金彑水
宏	宀大厶
例	亻一夕刂
專	車寸
視	示見
兄	口儿
善	羊䒑口
增	土丷四日
施	方𠂉也
淚	氵户犬
暗	日立日
忍	刀丶心
肯	止月
母	母
聖	耳口王
橫	木廿由八
遊	之方𠂉子
致	至攵
宗	宀示
偉	亻韋口㐄
麻	广木木
怒	女又心
爭	爪尹
腰	月西女
肖	小月
淨	氵爪尹
罪	四非
仔	亻子
彈	弓口甲一
丑	彐丨
減	氵戊一口
敏	𠂉母攵
義	羊手戈
棒	木春工
臭	自大
響	乡艮阝立日
聞	門耳
計	言十
校	木亠八乂
氏	氏
糖	米广尹口
吉	士口
押	扌甲
谷	八人口
衣	衣
宇	宀一寸
雜	亠人木隹
末	一木
告	牛口
耐	而寸
董	艹千日二
醉	酉亠人十
妹	女二小
鋼	金冂䒑山
蔣	艹爿寸
幣	水冂攵巾
宜	宀且
尼	尸匕
灰	大火
評	言一丷十
維	絲隹
屋	尸至
幾	幺幺戈人
楚	木木㇕止
館	食宀㠯
丹	周亠
乘	禾丬匕
認	言刀丶心
刻	亠乡人刂
俊	亻厶八夂
芳	艹方
抄	扌小丿
酷	酉牛口
京	亠口小
嚴	口口厂丁耳攵
返	之斤又
廳	广耳一心
魯	魚日
瑞	王山而
仁	亻二
註	言丶王
添	氵一大忄
催	亻山隹
具	目一八
威	戊一女
劇	虎豕刂
核	木亠乡人
農	日刂辰
瓶	䒑艹瓦
銅	金冂一口
犯	犭卩
族	方𠂉矢
季	禾子
尋	彐工口寸
顯	日幺灬頁
骨	骨
黎	禾勹人水
騎	馬大丁口
密	宀心丿山
士	士
術	行木丶
祇	示氏
洪	氵廿八
訊	言乙十
禮	示日口䒑
容	穴人口
輝	小兀冖車
射	身寸
智	矢口日
索	十冖絲
燕	廿口匕灬
撞	扌立田土
膜	月艹日大
普	䒑业日
竹	⺮
側	亻貝刂
諾	言艹大口
呂	口丿口
搭	扌艹一口
鳳	几一鳥
陰	阝人二厶
薄	艹氵甫寸
涼	氵亠口小
胃	田月
賴	木口刀貝
堆	土隹
赴	走卜
載	十戈車
孟	子皿
抵	扌氏一
彩	爪木彡
甚	其乚
厄	厂卩
粗	米且
傑	亻夕㐄木
慶	鹿㇕心夂
緣	絲彑豕
駐	馬丶王
申	申
衛	行韋口㐄
訓	言川
念	人丶㇕心
惹	艹大口心
帳	巾長
逃	之儿氵
嘉	士口力口
納	絲冂人
升	丿艹
倉	人户口
休	亻木
症	疒一止
斤	斤
功	工力
浪	氵丶艮
泰	春水
忠	中心
梁	氵刀八木
吸	口㇆人
貝	貝
跨	足大一丂
森	木木木
卷	半卩
井	二川
針	金十
蛇	虫宀匕
寺	土寸
購	貝甘冂土
導	之䒑自寸
飲	食欠
噴	口十十貝
虛	虎业
優	亻一心夂
埋	土田土
略	田夂口
掃	扌彐冖巾
目	目
蒙	艹冖一豕
託	言丿七
托	扌丿七
巧	工丂
淡	氵火火
拜	手一丰
冬	夂冫
懷	忄衣四水
池	氵也
凱	山一䒑几
鐘	金立田土
愁	禾火心
薩	艹阝丿生
揚	扌日勹彡
勇	又用力
財	貝寸丿
鍊	金木四
終	絲夂冫
質	斤斤貝
泥	氵尸匕
昏	氏日
遇	之日冂厶
喬	丿大冂口
欄	木門木日
鍋	金咼
巨	匚㇕
儀	亻羊手戈
磨	广木木石
呼	口丿丷寸
賭	貝者
液	氵亠夂丶
泉	白水
嫁	女宀豕
捲	扌半卩
豆	一口䒑
頓	七凵頁
旺	日王
攻	工攵
祥	示羊
委	禾女
佐	亻大工
臨	臣𠂉口口
隔	阝一丷丁
溝	氵甘冂土
碗	石宀夗
賠	貝立口
吻	口勹彡
健	亻廴尹二
速	之木口
失	牛人
雄	大厶隹
胸	月勹乂凵
暴	日廿八水
湊	氵春一大
陣	阝車
識	言立日戈
娃	女土土
唯	口隹
漏	氵尸雨
拔	扌犬丿
洛	氵夂口
探	扌冖八木
郎	丶艮阝
珠	王𠂉木
尿	尸水
透	之禾㇆丿
惠	車心
府	广亻寸
父	八乂
耳	耳
搜	扌臼丨又
希	乂大巾
患	口中心
尾	尸毛
播	扌釆田
岩	山石
逗	之一口䒑
賢	臣又貝
限	阝艮
帝	亠丷冖巾
昌	日日
模	木艹日大
嫌	女䒑刂八
陶	阝勹十凵
苗	艹田
羽	习习
哩	口田土
稿	禾亠冂口
棟	木木日
邦	丰阝
玲	王人之
驚	艹勹攵馬
坑	土亠几
備	亻廿丿用
袋	亻弋衣
妖	女丿大
錦	金白巾
琳	王木木
乙	乙
伴	亻半
尊	丷酉寸
霜	雨木目
沿	氵几口
伯	亻白
盜	氵欠皿
浩	氵牛口
剩	禾丬匕刂
域	土戈口一
祖	示且
肺	月亠巾
附	阝亻寸
制	牛巾刂
玄	亠幺
置	四十目乚
豪	亠口冖豕
恆	忄二夕
助	且力
幽	幺幺山
欣	斤欠
辣	辛木口
煤	火甘木
瓜	瓜
諸	言者
慧	丰丰彐心
墨	田土灬土
鮮	魚羊
鏡	金立日儿
蝦	虫㇕㇕又
犬	犬
鵬	月月鳥
誠	言戊㇆
賀	力口貝
險	阝人人人
飾	食𠂉巾
炎	火火
震	雨辰
鋒	金夂丰
遂	之丷豕
軒	車一十
控	扌穴工
覆	西行日夂
禁	木木示
盃	不皿
童	立田土
徵	行山王攵
杯	木不
晴	日丰月
魂	二厶鬼
益	䒑八皿
庭	广廴丿士
肝	月一十
濃	氵日刂辰
坊	土方
晨	日辰
紀	絲己
振	扌辰
割	宀丰口刂
敗	貝攵
消	氵小月
兆	儿氵
楓	木風
隆	阝夂一生
撤	扌亠月攵
粥	弓米弓
馨	士尸禾日
誤	言口乚一八
滑	氵骨
暖	日爪大又
己	己
止	止
柱	木丶王
塗	氵人禾土
妻	一尹女
盾	斤十目
奔	大十艹
潤	氵門王
政	一止攵
刺	木冂刂
冠	冖一兀寸
蓮	艹之車
獸	口口口犬
婚	女氏日
攝	扌耳耳耳
閣	門夂口
敬	艹勹口攵
潮	氵十十月
昂	日氏卩
飽	食勹己
邪	牙阝
促	亻足
葛	艹日人乚
串	口中
桑	又又又木
苑	艹夗
迎	之氏卩
弓	弓
碎	石亠人十
余	人禾
承	㇕水三
迪	之由
烏	烏
臣	臣
勤	廿口丰力
蒸	艹㇕一灬
凌	冫土八夂
辛	辛
旗	方𠂉其
妙	女小丿
始	女厶口
符	⺮亻寸
倫	亻人冂艹
亭	亠口冖丁
云	二厶
研	石一艹
俗	亻八人口
啓	户攵口
霧	雨又夂力
珍	王人彡
卓	卜日十
積	禾丰貝
捧	扌春工
鳴	口鳥
簡	⺮門日
罰	四言刂
晃	日小兀
斜	人禾冫十
預	又㇕丨頁
尤	尤
洲	氵⺍川
乎	丿丷寸
湘	氵木目
罷	四厶匕匕
軸	車由
翔	羊习习
異	田廿八
枝	木十又
逸	之𠂊儿丶
鴨	甲鳥
染	氵九木
餅	食䒑艹
粘	米卜口
藝	艹土二厶
鴻	氵工鳥
腎	臣又月
撲	扌业羊
晶	日日日
勾	勹厶
戒	戈艹
桂	木土土
朗	丶艮月
堵	土者
荷	艹亻丁口
畝	亠田𠂊丶
私	禾厶
擊	車凵殳手
貸	亻弋貝
傾	亻匕頁
鼓	士口十又
霞	雨㇕㇕又
皇	白王
企	人止
互	一彑
柏	木白
騰	月半馬
焦	隹灬
潔	氵丰刀絲
盟	日月皿
延	廴丿止
柔	又㇕亻木
資	冫欠貝
粒	米立
嶺	山人之頁
盆	八刀皿
檢	木人人人
護	言艹隹又
眉	尸目
傘	人人人十
碧	王白石
籍	⺮三廿日
勿	勹彡
汁	氵十
冊	冂艹
銘	金夕口
浴	氵八人口
翼	习习廿八
哲	扌斤口
菌	艹圍禾
敵	亠丷口攵
桶	木又用
抹	扌一木
判	半刂
寵	宀龍
紋	絲文
弟	丷弓亻
衰	衣日
叔	上小又
肩	户月
殿	尸廿八殳
番	釆田
旭	九日
訪	言方
勢	土八丸力
蒐	艹鬼
航	舟亠几
萊	艹木人人
旅	方𠂉氏
鷹	广亻隹鳥
赤	土川八
技	扌十又
韻	立日口貝
摘	扌亠十口
翠	习习人十
孝	者子
移	禾夕夕
搖	扌夕十凵
畢	甲艹二
予	又㇕丨
岳	丘山
融	一口丁虫
棋	木其
採	扌爪木
扶	扌夫
介	人川
渡	氵广廿又
芯	艹心
奪	大隹寸
采	爪木
乳	爪子乚
拳	半手
浜	氵丘八
錫	金日勹彡
淫	氵爪丿士
職	耳立日戈
宅	宀丿七
掌	小冖口手
培	土立口
莉	艹禾刂
損	扌口貝
握	扌尸至
謀	言甘木
廟	广十十月
孤	子瓜
壯	爿士
規	夫見
頗	皮頁
宣	宀二日
尖	小大
討	言寸
漸	氵車斤
耗	三小毛
息	自心
伍	亻工㇕
壽	士㇕口寸
逢	之夂丰
桃	木儿氵
壁	尸口辛土
漆	氵木人水
暫	車斤日
虹	虫工
丸	丸
券	半刀
縫	絲之夂丰
俱	亻且八
菊	艹勹米
奴	女又
岸	山厂一十
凝	冫匕㇕止
芝	艹之
脈	月斤氏
烈	一夕刂灬
貪	人丶㇕貝
婆	氵皮女
蝶	虫廿乚木
誇	言大一丂
枕	木冖儿
毀	臼土殳
避	之尸口辛
浮	氵爪子
枚	木攵
材	木寸丿
賞	小冖口貝
翁	八厶习习
幻	幺㇆
固	圍十口
耀	小兀习隹
槽	木艹日日
穴	穴
幅	巾一口田
審	宀釆田
斬	車斤
伸	亻申
悲	非心
萌	艹日月
斑	王文王
牽	亠幺冖牛
屈	尸凵山
怨	夗心
恐	工凡心
凍	冫木日
複	衤𠂉日夂
柴	止匕木
逆	之䒑凵
僞	亻爲
騷	馬又丶虫
熙	臣巳灬
忽	勹彡心
津	氵尹二
胎	月厶口
糧	米日田土
譜	言䒑业日
准	冫隹
摩	广木木手
縮	絲宀一白
漫	氵日四又
溜	氵氏刀田
棄	亠厶廿木
扇	户习习
憂	一白心夂
墓	艹日大土
鹿	鹿
彬	木木彡
卿	氏丿艮卩
鶴	冖隹鳥
函	㇕水凵
確	石冖隹
郡	尹口阝
奈	大示
茂	艹戊
緩	絲爪大又
協	十力力力
債	亻丰貝
肌	月几
薰	艹千二灬
映	日冂大
鼻	自田一川
育	亠厶月
候	亻丨㇕矢
堅	臣又土
閉	門寸丿
決	氵㇕大
適	之亠十口
策	⺮木冂
藤	艹月半水
雁	厂亻隹
俠	亻大人人
腸	月日勹彡
窄	穴𠂉卜
昨	日𠂉卜
務	又㇕夂力
爪	爪
拷	扌者丂
汝	氵女
撮	扌日耳又
幸	土半
醬	爿夕寸酉
舟	舟
訴	言斤丶
態	厶月匕心
繡	絲尹片爿
蜜	宀心丿虫
漂	氵西示
序	广又㇕丨
巷	廿八巳
梨	禾刂木
舌	舌
腹	月𠂉日夂
蟹	𠂊用牛虫
陷	阝𠂊臼
捉	扌足
蒼	艹人户口
疑	匕矢㇕止
鼎	目爿片
釣	金勹丶
慌	忄艹亡川
彼	行皮
辰	辰
執	土半丸
忌	己心
踏	足水日
捷	扌一彐止
腫	月千日二
縱	絲行人止
伏	亻犬
壇	土亠日一
默	四土灬犬
懸	且小絲心
悟	忄工㇕口
頻	止小頁
帽	巾日目
幼	幺力
旋	方𠂉㇕止
擁	扌亠乡隹
猶	犭丷酉
席	广廿巾
叉	又丶
繫	車凵殳絲
妃	女己
典	冂廿八
贈	貝丷田日
儒	亻雨而
裸	衤田木
奉	春工
御	行牛止卩
腔	月穴工
突	穴大
刑	一艹刂
痕	疒艮
賓	宀一小貝
午	𠂉十
蕾	艹雨田
臟	月艹戈臣
宰	宀辛
弘	弓厶
境	土立日儿
拒	扌匚㇕
毅	立豕殳
煎	䒑月刂灬
弦	弓亠幺
蓉	艹穴人口
憶	忄立日心
卵	氏丷卩丶
遷	之西大己
尺	尸丶
禍	示咼
垂	千艹二
郵	千艹二阝
惜	忄廿日
浦	氵甫
警	艹勹攵言
揭	扌日人乚
逐	之豕
謂	言田月
昭	日刀口
宿	宀亻一白
統	絲亠厶儿
裂	一夕刂衣
僧	亻丷田日
慣	忄母貝
彪	虎彡
淋	氵木木
束	木口
仕	亻士
劫	土厶力
拓	扌石
疊	田田冖且
律	行尹二
株	木𠂉木
砂	石小丿
斗	冫十
坪	土一丷十
揮	扌冖車
箇	⺮圍十口
吞	一大口
亡	亡
遙	之夕十凵
牧	牛攵
兜	白氏㇕儿
監	臣⺮皿
稀	禾乂大巾
恰	忄人一口
朕	月䒑大
淑	氵上小又
慕	艹日大忄
疏	㇕止厶川
膏	亠口口月
陵	阝土八夂
纏	絲广八土
驗	馬人人人
廷	廴丿士
糊	米十口月
儲	亻言者
楠	木十冂半
蚊	虫文
祭	夗示
拾	扌人一口
朋	月月
芸	艹二厶
吟	口人丶㇕
筒	⺮冂一口
丘	丘
責	丰貝
堯	土土土兀
繁	𠂉母攵絲
坦	土日一
穗	禾車心
紗	絲小丿
屯	七凵
虐	虎匚
紹	絲刀口
惟	忄隹
幕	艹日大巾
遮	之广廿灬
庚	广彐人
哉	十戈口
涉	氵止小
賦	貝一弋止
敷	甫方攵
禪	示口甲一
習	习习白
臥	臣人
釘	金丁
丙	一冂人
歷	厂禾禾止
躍	足习习隹
署	四者
範	⺮車卩
示	示
嵐	山風
夕	夕
議	言羊手戈
趣	走耳又
杭	木亠几
疾	疒矢
崇	山宀示
婦	女彐冖巾
裕	衤八人口
嘆	口廿口夫
艦	舟臣⺮皿
荒	艹亡川
貞	卜貝
筋	⺮月力
鈴	金人之
帆	巾凡
奎	大土土
駕	力口馬
阻	阝且
享	亠口子
棚	木月月
傲	亻土方攵
欽	金欠
召	刀口
徒	行走
脂	月匕日
競	立口口儿
靖	立丰月
奏	春一大
盲	亡目
姿	冫欠女
賜	貝日勹彡
湧	氵又用力
栽	十戈木
述	之木丶
籠	⺮龍
甫	甫
佑	亻大口
閥	門亻戈
咽	口圍大
袖	衤由
貧	八刀貝
激	氵白方攵
階	阝匕匕白
珊	王周周一
植	木十目乚
占	卜口
鉛	金几口
灘	氵廿夫隹
災	巛火
暢	申日勹彡
詠	言丶水
桐	木冂一口
謙	言䒑刂八
万	一力
織	絲立日戈
蒲	艹氵甫
芽	艹牙
昊	日一大
轟	車車車
碑	石鬼十
燃	火夕犬灬
輔	車甫
暉	日冖車
朴	木卜
碩	石頁
杖	木一乂
謎	言之米
刃	刀丶
墜	阝丷豕土
衡	行𠂊田大
櫻	木貝貝女
窯	穴羊灬
措	扌廿日
眠	目巳七
途	之人禾
叢	业羊耳又
禾	禾
磁	石䒑幺幺
沃	氵丿大
哀	衣口
浸	氵彐冖又
柄	木一冂人
輯	車口耳
凸	圍冂
遼	之大日小
宴	宀日女
堪	土其乚
麟	鹿米夕㐄
祿	示彑水
崩	山月月
醜	酉鬼
革	革
憲	宀丰四心
遺	之中一貝
喚	口𠂊八大
刊	一十刂
裁	十戈衣
郁	大月阝
逝	之扌斤
際	阝夗示
誌	言士心
崖	山厂土土
廉	广䒑刂八
獅	犭丿一巾
鞍	革宀女
墳	土十艹貝
巫	工人人
虞	虎口乚一八
拐	扌口力
築	⺮工凡木
剝	彑水刂
披	扌皮
削	小月刂
悠	亻丨攵心
凹	圍凵
葬	艹一匕艹
侃	亻口川
授	扌爪冖又
卸	牛止卩
頌	八厶頁
慈	䒑幺幺心
纖	絲人非一
馳	馬也
鞭	革亻日乂
危	𠂊厂卩
襲	龍衣
泊	氵白
喉	口亻㇕矢
溶	氵穴人口
撫	扌𠂉廿灬
媛	女爪大又
察	宀夗示
駿	馬厶八夂
憐	忄米夕㐄
昆	日匕匕
醇	酉亠口子
橙	木癶口䒑
暮	艹日大日
祕	示心丿
薪	艹立木斤
巢	巛田木
淵	氵片爿
愚	日冂厶心
堤	土日一止
傍	亻亠冖方
燥	火口口木
漁	氵魚
茜	艹西
允	厶儿
杏	木口
畔	田半
豹	豸勹丶
澄	氵癶口䒑
冥	冖日亠八
媒	女甘木
燦	火卜又米
枯	木十口
軌	車九
塑	䒑凵月土
卜	卜
構	木甘冂土
茅	艹又㇕亻
鑄	金士口寸
雀	小隹
亨	亠口了
詳	言羊
腐	广亻人人
皓	白牛口
央	冂大
据	扌尸十口
栓	木人王
輩	非車
卑	鬼十
誓	扌斤言
蜂	虫夂丰
勺	勹丶
迅	之乙十
虫	虫
恥	耳心
匹	匚儿
仰	亻氏卩
羞	羊彐丨
注	氵丶王
瞳	目立田土
黛	亻弋田土灬
拂	扌弓川
挨	扌厶矢
綱	絲冂䒑山
茨	艹冫欠
夷	大弓
慎	忄十目一八
汽	氵气
恭	廿八忄
弊	水冂攵艹
旦	日一
祁	示阝
蠟	虫巛乂巛
耕	三小二川
稻	禾爪臼
綺	絲大丁口
笛	⺮由
捕	扌甫
喪	十口口展
悔	忄𠂉母
敦	亠口子攵
葵	艹癶一大
渴	氵日人乚
曝	日日八水
梗	木一日乂
絡	絲夂口
貫	母貝
復	行𠂉日夂
濫	氵臣⺮皿
況	氵口儿
陀	阝宀匕
勳	千四灬力
惑	戈口一心
簾	⺮广刂八
巡	之巛
徽	行山絲攵
謹	言廿口丰
脹	月長
蓄	艹亠幺田
梓	木辛
鑑	金臣⺮皿
溢	氵䒑八皿
彌	弓一乂乂
蓬	艹之夂丰
薦	艹鹿乚灬
硫	石亠厶川
迫	之白
貌	豸白儿
弔	弓丨
舜	爪冖夕㐄
茄	艹力口
訣	言㇕大
炭	山大火
綿	絲白巾
萱	艹宀二日
岡	冂䒑山
誘	言禾㇆丿
泳	氵丶水
椅	木大丁口
遜	之子丿絲
侍	亻土寸
抑	扌氏卩
侵	亻彐冖又
妥	爪女
覽	臣⺮四見
概	木艮七儿
貢	工貝
援	扌爪大又
昔	廿日
逮	之尹氵
卒	亠人人十
峽	山大人人
寢	宀爿冖又
菱	艹土八夂
梯	木丷弓亻
腕	月宀夗
挫	扌人人土
膝	月木人水
循	行斤十目
矛	又㇕亻
努	女又力
乏	丿之
魅	鬼二小
徹	行亠月攵
凶	乂凵
掘	扌尸凵山
雌	止匕隹
伽	亻力口
跡	足亠川八
汀	氵丁
緒	絲者
芙	艹夫
棲	木一尹女
瑛	王艹冂大
禽	人亠冂厶
腺	月白水
迦	之力口
矯	矢丿冂口
欺	其欠
杉	木彡
党	小冖口儿
緯	絲韋口㐄
玖	王𠂊丶
悉	釆心
冶	冫厶口
絆	絲半
遣	之中一㠯
斐	非文
閤	門人一口
釀	酉衣口甘
彙	彑冖田木
簿	⺮氵甫寸
旬	勹日
丈	一乂
胤	儿幺月
廊	广丶艮阝
焰	火𠂊臼
壘	田田田土
淳	氵亠口子
畏	田展
屑	尸小月
販	貝斤又
泣	氵立
沫	氵一木
滯	氵廿冖巾
眺	目儿氵
寂	宀上小又
晏	日宀女
秤	禾一丷十
藻	艹氵口木
螺	虫田絲
錠	金宀一止
診	言人彡
涯	氵厂土土
滋	氵䒑幺幺
貿	氏刀貝
療	疒大日小
栗	西木
朔	䒑凵月
捻	扌人㇕心
勃	十冖子力
矩	矢匚㇕
描	扌艹田
膚	虎田月
契	丰刀大
峻	山厶八夂
爵	爪四艮寸
群	尹口羊
役	行殳
痘	疒一口䒑
募	艹日大力
析	木斤
魁	鬼冫十
斥	斤丶
匡	匚王
倦	亻半卩
蔓	艹日四又
樺	木艹艹工
牟	厶牛
靴	革亻匕
慮	虎田心
眸	目厶牛
巾	巾
殊	一夕𠂉木
晟	日戊㇆
艇	舟廴丿士
芹	艹斤
寡	宀頁刀
巖	山口口厂丁耳攵
瞬	目爪夕㐄
邑	口巴
庸	广尹用
渾	氵冖車
紡	絲方
窺	穴夫見
奮	大隹田
濁	氵四勹虫
珂	王丁口
嗅	口自犬
寅	宀一由八
慰	尸示寸心
履	尸行日夂
宛	宀夗
綸	絲人冂艹
獄	犭言犬
歎	廿口夫欠
蟬	虫口甲一
督	上小又目
違	之韋口㐄
絞	絲亠八乂
廿	廿
劣	小丿力
祈	示斤
斧	八乂斤
湛	氵其乚
償	亻小口貝
掠	扌亠口小
崎	山大丁口
辱	辰寸
匠	匚斤
肘	月寸
究	穴九
矢	矢
葦	艹韋口㐄
瞥	水冂攵目
錘	金千艹二
椰	木耳阝
梢	木小月
障	阝立日十
粟	西米
唆	口厶八夂
綜	絲宀示
詢	言勹日
札	木乚
燭	火四勹虫
襖	衤自米大
吏	一口乂
堰	土匚日女
棺	木宀㠯
胞	月勹己
羨	羊氵欠
阜	丿㠯十
剖	立口刂
寓	宀日冂厶
桔	木士口
轄	車宀丰口
妄	亡女
弧	弓瓜
撰	扌巳廿八
哨	口小月
鋸	金尸十口
芭	艹巴
蔭	艹阝二厶
肋	月力
煌	火白王
錐	金隹
絹	絲口月
昧	日二小
硯	石見
旨	匕日
鱗	魚米夕㐄
巳	巳
遵	之丷酉寸
摺	扌习习白
拙	扌凵山
竿	⺮一十
稜	禾土八夂
憤	忄十艹貝
緻	絲至攵
圭	土土
塚	土冖豕
衷	衣中
脊	氵人月
苔	艹厶口
鉢	金木一
坂	土斤又
阪	阝斤又
恕	女口心
繭	艹冂丨虫
鬱	𠂉十匕彡
諦	言亠冖巾
疲	疒皮
鞠	革勹米
釉	釆由
彰	立日十彡
綴	絲又又又
酬	酉⺍川
橘	木又八口
遁	之斤十目
晝	尹二日一
窟	穴尸凵山
鈍	金七凵
誼	言宀且
緋	絲非
紛	絲八刀
笙	⺮生
沸	氵弓川
儉	亻人人人
猿	犭土口𧘇
漠	氵艹日大
詐	言𠂉卜
絃	絲亠幺
俐	亻禾刂
楷	木匕匕白
侶	亻口丿口
迭	之牛人
詔	言刀口
嗣	口冂一口
嵩	山亠冂口
蹄	足亠冖巾
穫	禾艹隹又
潰	氵中一貝
褐	衤日人乚
丞	㇕水一
曜	日习习隹
鯨	魚亠口小
畜	亠幺田
宵	宀小月
戊	戊
糾	絲凵
濕	氵日幺灬
肇	户攵尹二
窪	穴氵土土
暇	日㇕㇕又
岐	山十又
郊	亠八乂阝
璧	尸口王丶
糸	絲
焚	木木火
鷗	匚口口鳥
癖	疒尸口辛
灼	火勹丶
麓	木木鹿
械	木戈艹
乞	𠂉乙
卯	氏丿卩
諧	言匕匕白
喧	口宀二日
汎	氵凡
瓢	西示瓜
裳	小冖口衣
妨	女方
綾	絲土八夂
括	扌舌
漬	氵丰貝
戟	十日十戈
椎	木隹
檀	木亠日一
葡	艹勹甫
縛	絲甫寸
垣	土二日
拘	扌勹口
篤	⺮馬
鳩	九鳥
穀	士冖禾殳
囚	圍人
鞘	革小月
瀨	氵木口刀貝
隙	阝小日小
莞	艹宀一兀
曆	厂禾禾日
伶	亻人之
謠	言夕十凵
璽	一八王丶
拭	扌弋工
鷺	足夂口鳥
脅	力力力月
戚	戊上小
頒	八刀頁
礁	石隹灬
餌	食耳
襟	衤木木示
尉	尸示寸
亥	亠乡人
肢	月十又
紐	絲彐丨
厘	厂田土
貯	貝宀丁
僕	亻业羊
憎	忄丷田日
禎	示卜貝
頰	大人人頁
睦	目土八土
渦	氵咼
藩	艹氵釆田
悼	忄卜日十
憾	忄戊口心
蹟	足丰貝
稚	禾隹
褒	衣亻口木
鍛	金亻三殳
町	田丁
麒	鹿其
蕉	艹隹灬
邸	氏一阝
柵	木冂艹
倭	亻禾女
笠	⺮立
勉	𠂊口儿力
暑	日者
疫	疒殳
汐	氵夕
績	忄丰貝
樟	木立日十
隅	阝日冂厶
禰	示一乂乂
弛	弓也
秘	禾心丿
渚	氵者
雛	勹凵凵隹
樽	木丷酉寸
椿	木春
箋	⺮戈戈
寮	宀大日小
碁	其石
壬	丿士
勘	其乚力
啄	口豕
駒	馬勹口
蔽	艹水冂攵
飼	食㇆一口
狹	犭大人人
凰	几白王
溺	氵弓弓冫
硝	石小月
凜	冫亠口禾
沓	水日
竺	⺮二
圃	圍甫
誕	言廴丿止
琢	王豕
酉	酉
虜	虎田力
苛	艹丁口
茸	艹耳
諒	言亠口小
恢	忄大火
磯	石絲戈人
孜	子攵
舵	舟宀匕
璃	王亠冂厶
荻	艹犭火
漕	氵艹日日
磐	舟殳石
漱	氵木口欠
庶	广廿灬
釜	八乂王丷
茉	艹一木
筑	⺮工凡
膳	月羊䒑口
濡	氵雨而
蕪	艹𠂉廿灬
閑	門木
梧	木工㇕口
侑	亻大月
頃	匕頁
鯉	魚田土
灸	𠂊丶火
牡	牛土
飢	食几
沼	氵刀口
懲	行山攵心
逞	之口王
曖	日爪心夂
赦	土川八攵
柚	木由
宙	宀由
柑	木甘
匿	匚艹大口
馴	馬川
嘲	口十十月
諭	言人月刂
偵	亻卜貝
鎧	金山口䒑
汲	氵㇆人
輿	臼車八
銑	金牛儿
諮	言冫欠口
炊	火欠
杵	木𠂉十
羚	羊人之
柿	木亠巾
頑	一兀頁
膨	月士䒑彡
琉	王亠厶川
酌	酉勹丶
闇	門立日
嬉	女士䒑口
殖	一夕十目乚
珀	王白
稼	禾宀豕
絢	絲勹日
粹	米亠人十
鳶	弋鳥
墾	豸艮土
珈	王力口
曳	申丿
豚	月豕
犀	尸水牛
摯	土半丸手
尻	尸九
槌	木之丿㠯
芋	艹一寸
萎	艹禾女
漣	氵之車
隼	隹十
訟	言八厶
幡	巾釆田
稟	亠圍口禾
怠	厶口心
曙	日四者
稽	禾尤匕日
巽	己己廿八
綻	絲宀一止
峨	山手戈
謁	言日人乚
愉	忄人月刂
捨	扌人舌
懇	豸艮心
宥	宀大月
骸	骨亠乡人
驍	馬土土兀
狙	犭且
庇	广匕匕
芥	艹人川
床	广木
楽	白氵木
伎	亻十又
紳	絲申
詣	言匕日
慨	忄艮七儿
征	行一止
詰	言士口
秩	禾牛人
颯	立風
蕃	艹釆田
朽	木丂
晦	日𠂉母
扉	户非
嫉	女疒矢
幌	巾日小兀
臼	臼
傭	亻广尹用
怖	忄大巾
嫡	女亠十口
哺	口甫
婿	女㇕止月
挽	扌𠂊口儿
氾	氵卩
閏	門王
酪	酉夂口
渥	氵尸至
黒	田土灬
饗	乡艮阝食
噌	口丷四日
円	冂丨一
癒	疒人刂心
為	爲
穹	穴弓
掬	扌勹米
皿	皿
纂	⺮目大絲
曇	日雨二厶
伺	亻㇆一口
榛	木春禾
禱	示士口寸
姥	女者匕
顎	口口丂頁
痢	疒禾刂
汰	氵大丶
濯	氵习习隹
煉	火木日
洵	氵勹日
気	气乂
惺	忄日生
締	絲亠冖巾
嘩	口艹艹工
僚	亻大日小
捺	扌大示
櫓	木魚日
箕	⺮其
壕	土亠冖豕
耽	耳冖儿
菅	艹宀㠯
詮	言人王
瀧	氵龍
蹴	足亠小尤
舶	舟白
燎	火大日小
檜	木人四日
泌	氵心丿
宕	宀石
狩	犭宀寸
殆	一夕厶口
鷲	亠口尤鳥
姻	女圍大
徳	行十四心
関	門䒑大
窒	穴至
翌	习习立
刈	乂刂
鍬	金禾火
舷	舟亠幺
雇	户隹
対	文寸
琥	王虎
紺	絲甘
缶	𠂉十凵
俸	亻春工
倖	亻土半
礎	石木㇕止
殉	一夕勹日
様	木羊水
収	凵又
箔	⺮氵白
牲	牛生
牒	片廿乚木
戦	⺍甲一戈
賄	貝大月
鮎	魚卜口
変	亠川八夂
菩	艹立口
諏	言耳又
堀	土尸凵山
憬	忄日口小
亙	二𠂊冫
脩	亻丨夂月
徠	行木人人
繕	絲羊䒑口
岬	山甲
売	士冖儿
恣	冫欠心
児	丨日儿
竣	立厶八夂
肪	月方
涙	氵户大
賑	貝辰
釧	金川
諺	言立丿彡
庵	广大申
咲	口䒑大
柘	木石
惰	忄大工月
斡	十日冫十
銃	金亠厶儿
蕨	艹厂凵欠
酵	酉者子
沢	氵尸丶
椋	木亠口小
唾	口千艹二
惚	忄勹彡心
蒔	艹日土寸
瀕	氵止小頁
妊	女丿士
櫛	木⺮艮卩
弁	厶艹
実	宀三人
摑	扌圍口一
蔑	艹四戊丶
圧	厂土
砥	石氏一
迄	之𠂉乙
塾	亠口丸土
発	癶二儿
県	目乚小
衿	衤人丶㇕
昴	日氏丿卩
氷	水丶
肴	乂大月
祉	示止
砦	止匕石
畿	幺幺戈田
箸	⺮者
稔	禾人㇕心
詫	言宀丿七
歩	止小丿
処	夂几
迂	之一寸
蕎	艹丿冂口
佃	亻田
琶	王王巴
笈	⺮㇆人
冨	冖一口田
桜	木⺍女
陛	阝匕匕土
萄	艹勹十凵
蔦	艹鳥
唇	辰口
冗	冖几
恵	一由心
満	氵廿冂山
侮	亻𠂉母
擢	扌习习隹
菓	艹田木
賂	貝夂口
亜	亞
堺	土田八川
伝	亻二厶
砧	石卜口
奄	大申
裾	衤尸十口
劾	亠乡人力
憧	忄立田土
鎌	金䒑刂八
覚	⺍冖見
瀬	氵木口頁
碓	石隹
憩	舌自心
壊	土十四衣
嘗	小冖匕日
譲	言衣八甘
沌	氵七凵
縞	絲亠冂口
喋	口廿乚木
増	土丷田日
団	圍寸
広	广厶
戸	户
彗	丰丰彐
淀	氵宀一止
簞	⺮口甲一
瘍	疒日勹彡
孃	女衣口甘
髪	長彡大又
毎	𠂉母十
鉄	金牛人
続	絲士冖儿
蓑	艹衣日
酢	酉𠂉卜
彫	周土口彡
偲	亻田心
毬	毛寸氵丶
兎	丿口儿丶
桁	木行
郞	丶艮阝
姫	女臣
値	亻十目乚
畑	火田
蕗	艹足夂口
梶	木尸毛
単	⺍甲一
俳	亻非
経	絲又土
験	馬人口人
込	之人
臆	月立日心
峰	山夂丰
訃	言卜
悪	亞心
絵	絲人二厶
瑚	王十口月
錮	金圍十口
崚	山土八夂
諄	言亠口子
竜	立申
謄	月半言
榊	木示申
図	圍冫乂
琵	王王匕匕
悌	忄丷弓亻
赳	走凵
黙	田土犬灬
嵯	山羊工
巻	半己
鯛	魚周土口
撃	車殳手
穰	禾衣口甘
価	亻西
甥	生田力
鵜	丷弓亻鳥
裟	氵小丿衣
歳	止戊一小
呉	口乚一八
読	言士冖儿
両	一冂山
帰	刂彐冖巾
嶋	山鳥
総	絲八厶心
聴	耳十四心
瑠	王氏刀田
剣	人一人刂
柊	木夂冫
帯	廿冖巾
穂	禾一由心
辻	之十
蔵	艹戊臣
賃	亻丿士貝
専	一由寸
転	車二厶
圏	圍半己
豊	日刂口䒑
惇	忄亠口子
萩	艹禾火
辺	之刀
脳	月⺍乂凵
応	广心
弾	弓⺍甲一
錆	金丰月
洸	氵小兀
仮	亻斤又
闘	門一䒑寸
笹	⺮廿乚
隈	阝田展
枇	木匕匕
隠	阝爪彐心
椛	木艹亻匕
霊	雨二业
舎	人土口
藁	艹亠口木
暁	日十艹兀
亀	𠂊日申
杷	木巴
篠	⺮亻夂木
凪	几止
済	氵文川
慄	忄西木
観	牛隹見
稲	禾爪丨日
悩	忄⺍乂凵
澪	氵雨人之
寛	宀艹見
険	阝人口人
鷄	爪幺大鳥
訳	言尸丶
乗	千艹木
荘	艹丬士
雫	雨一卜
効	亠八乂力
疋	㇕止
駅	馬尸丶
抜	扌大又
揺	扌爪十凵
薬	艹白氵木
醍	酉日一止
歴	厂木木止
従	行䒑止
燿	火习习隹
郷	乡艮阝
銭	金戈
焼	火十艹兀
滝	氵立申
菖	艹日日
廻	廴圍口
葺	艹口耳
酔	酉九十
検	木人口人
働	亻千二力
斎	文川示
萠	艹月月
栖	木西
穏	禾爪彐心
檎	木人冂厶
踊	足又用
槇	木匕乚八
囲	圍二川
懐	忄亠四衣
獣	⺍田口犬
戻	户大
薫	艹千二灬
斉	文川
営	⺍冖口丿口
栄	⺍冖木
袈	力口衣
叶	口十
喰	口食
胴	月冂一口
樋	木之又用
晩	日𠂊日儿
軽	車又土
徴	行山王攵
紘	絲大厶
頼	木口頁
毘	田匕匕
剤	文川刂
姉	女亠巾
渋	氵止氵
呪	口口儿
歓	牛隹欠
嬢	女衣八甘
継	絲米乚
曽	丷田日
権	木牛隹
剰	千艹木刂
聡	耳八厶心
榎	木一自夂
槻	木夫見
労	⺍冖力
娩	女𠂊口儿
痩	疒申又
巣	⺍田木
丼	二川丶
捜	扌申又
覧	臣⺮見
艶	日刂𠂊巴
繰	絲口口木
錬	金木日
汚	氵丂一
埴	土十目乚
窓	穴厶心
騒	馬又虫
拶	扌巛夕
覇	西革月
楯	木斤十目
塩	土𠂉口皿
犠	牛羊手戈
駆	馬匚乂
砕	石九十
冴	冫牙
滉	氵日小兀
浄	氵𠂊尹
隣	阝米夕㐄
椀	木宀夗
遅	之尸羊
貰	廿乚貝
麿	广木木口丿口
蛍	⺍冖虫
縁	絲彐豕
鱒	魚丷酉寸
娠	女辰
挿	扌千日
掲	扌日勹匕
扱	扌㇆人
庁	广丁
渉	氵止小丿
仏	亻厶
歯	止米凵
畠	白田
脇	月力力力
厳	⺍厂丁耳攵
敍	人禾卜又
衞	行韋一巾
廃	广癶二儿
拝	扌一丰
酎	酉寸
袴	衤大一丂
払	扌厶
楢	木丷酉
齢	止米人之
縄	絲日申
槙	木十目一八
惣	牛勹彡心
弐	一弋二
駄	馬大丶
勲	千日力灬
奨	丬爪寸大
娯	女口一八
択	扌尸丶
壱	士冖匕
勅	木口力
栃	木斤一力
辿	之山
樫	木臣又土
顕	日业頁
挙	⺍一八手
讃	言夫夫貝
飜	釆田乙冫
釈	釆尸丶
栞	一大十木
拠	扌夂几
匂	勹匕
拡	扌广厶
暦	厂木木日
晄	日小兀
臓	月艹戊臣
峠	山上一卜
陥	阝𠂊丨日
雰	雨八刀
隷	士示尹氵
渇	氵日勹匕
潟	氵臼勹灬
枠	木九十
粋	米九十
賛	夫夫貝
揃	扌䒑月刂
凧	几巾
醐	酉十口月
縦	絲行䒑止
噂	口丷酉寸
皐	白氵十
鉱	金广厶
鰯	魚弓弓冫
渓	氵爪夫
猟	犭⺍几工
摂	扌耳氵
妬	女石
疎	㇕止木口
塁	田氵土
顚	匕目八頁
粛	尹川氵
塡	土匕乚八
畳	田冖且
繊	絲十戈业
勧	牛隹力
巌	山⺍厂丁耳攵
瑳	王羊工
薗	艹圍口𧘇
緖	絲者日丶
塙	土亠冂口
鞄	革勹巳
梛	木刀二阝
筈	⺮舌
髄	骨之大月
醸	酉衣八甘
尭	十艹兀
鋳	金丰寸
壌	土衣八甘
捗	扌止小
喩	口人月巛
柾	木一止
穣	禾衣八甘
愼	忄匕乚八
桟	木戈
雑	九木隹
塀	土尸䒑艹
猫	犭艹田
澁	氵止止止
猪	犭者
薙	艹矢隹
駈	馬丘
匁	勹乂
机	木几
倹	亻人口人
楕	木大工月
籾	米刀丶
鎭	金匕乚八
号	口丂
逓	之斤二巾
祐	示大口
凄	冫一尹女
遡	之䒑凵月
証	言一止
晋	亞日
亘	二日
姪	女至
痴	疒矢口
砲	石勹己
舗	人土口甫
叙	人禾又
査	木且
倣	亻方攵
与	一乚一
国	圍王丶
却	土厶卩
担	扌日一
携	扌隹㇆丿
医	匚矢
踪	足宀示
脚	月土厶卩
胆	月日一
庄	广土
凉	冫亠口小
恒	忄二日
潜	氵夫夫日
苺	艹母
芦	艹户
厩	厂艮七儿
体	亻木一
怜	忄人之
竪	臣又立
灯	火丁
粧	米广土
厨	厂一䒑寸
凛	冫亠口示
奬	爿夕寸大
叡	卜冖目又
届	尸由
鶏	爪夫鳥
埼	土大丁口
眞	匕目乚八
埜	木木土
説	言丷口儿
俵	亻丰𧘇
献	十冂半犬
菫	艹一口丰
触	𠂊用虫
櫂	木习习隹
閲	門丷口儿
偽	亻爲
搾	扌穴𠂉卜
顔	立丿彡頁
浬	氵田土
絶	絲𠂊巴
卽	白匕卩
紬	絲由
殻	士冖几殳
謡	言爪一十凵
緑	絲彐水
録	金彐水
没	氵殳
来	二水
横	木廿由八
区	匚乂
点	卜口灬
旧	丨日
当	小彐
内	冂人
税	禾丷口儿
会	人二厶
独	犭虫
脱	月丷口儿
条	夂木
争	𠂊尹
装	丬士衣
将	丬爪寸
数	米女攵
学	⺍冖子
随	阝之大月
断	米乚斤
蚕	一大虫
画	一由凵
残	一夕戈
声	士尸
寿	丰寸
瑶	王爪一十凵
静	丰月𠂊尹
挟	扌二火
黄	廿由八
茎	艹㇕丶工
枢	木匚乂
楼	木米女
殴	匚乂殳
虚	虎业
𠮟	口七
践	足戈
嘱	口尸冂厶
晒	日西
峡	山二火
乱	舌乚
称	禾𠂉小
辞	舌辛
俣	亻口一大
奥	自米大
刹	乂木刂
鋭	金丷口儿
狭	犭二火
諸	言者丶
蛮	亠刂八虫
状	丬犬
壮	丬士
惧	忄且八
悦	忄丷口儿
惨	忄厶大彡
誉	⺍一八言
滞	氵艹冖巾
浅	氵戈
湿	氵日业
温	氵日皿
写	冖一乚一
祷	示丰寸
宝	宀王丶
窃	穴七刀
遥	之爪一十凵
礼	示乚
禅	示⺍甲一
属	尸丿冂厶
昼	尸丶日一
尽	尸丶冫
弥	弓𠂉小
参	厶大彡
福	示一口田
神	示申
祥	示羊
都	者丶阝
麺	丰夕圍目
麦	丰夂
桧	木人二厶
励	厂一力力
欧	匚乂欠
戯	虎业戈
径	行㇕丶工
猪	犭者丶
恋	亠刂八心
産	立丿生
彦	立丿彡
盗	冫欠皿
炉	火户
湾	氵亠八弓
寝	宀丬冖又
祢	示𠂉小
禄	示彐水
双	又又
堕	阝大月土
