的	白丶
是	日止
在	大土
你	亻小
就	亠尤
那	刀阝
呢	口匕
等	⺮寸
恩	圍心
能	厶匕
做	亻攵
想	木心
再	一土
但	亻一
啦	口立
嗯	口心
得	行寸
啊	口口
或	戈一
新	立斤
嘛	口木
玩	王儿
最	日又
真	十八
吃	口乙
更	一乂
快	忄大
前	䒑刂
高	亠口
您	亻心
所	斤斤
啥	口舌
招	扌口
事	寸彐
拿	人手
死	一匕
像	亻豕
使	亻丶
哪	口阝
靠	牛非
算	⺮艹
唉	口矢
接	扌女
偶	亻厶
第	⺮亻
完	宀儿
同	冂口
花	艹匕
些	止二
住	亻王
跑	足巳
睡	目二
哦	口戈
挺	扌士
掉	扌十
路	足口
作	亻卜
送	之大
法	氵厶
乖	千匕
撒	扌攵
咬	口乂
版	片又
副	一刂
俺	亻乚
便	亻乂
道	之自
座	广土
聊	耳卩
塔	口土
爱	爪又
阿	阝口
喝	口乚
管	⺮㠯
定	宀止
交	亠乂
笑	⺮大
黑	四灬
慢	忄又
剧	尸刂
越	走乚
部	立阝
站	立口
怪	忄土
省	小目
倒	亻刂
曾	丷日
湖	氵十
查	木一
象	⺈豕
格	木口
海	氵母
吓	口卜
班	王王
治	氵口
店	广口
坐	人土
度	广又
俄	亻戈
歌	丁欠
落	艹口
原	厂小
晚	日儿
量	日二
重	千二
爽	大乂
往	行王
狗	犭口
周	周口
超	走口
均	土冫
照	日灬
留	氏田
特	牛寸
教	者攵
哥	丁口
值	亻且
既	艮儿
哭	口丶
建	廴二
洗	氵儿
懂	忄二
指	扌日
球	王丶
仍	亻丿
跌	足人
清	氵月
提	扌止
除	阝禾
通	之用
假	亻又
段	亻殳
平	一十
急	⺈心
城	土㇆
任	亻士
草	艹十
理	王二
唱	口日
常	小巾
菜	艹木
感	戊心
混	氵匕
敢	㇕攵
探	扌木
南	十半
德	行心
居	尸口
器	口大
整	木止
傻	亻夂
克	十儿
呃	口巳
跳	足儿
砸	石巾
深	氵木
求	寸丶
款	士欠
何	亻口
率	亠十
修	亻彡
面	石丨
份	亻刀
情	忄月
肉	冂人
流	氵川
痛	疒用
封	土寸
影	日彡
冷	冫之
借	亻日
派	氵氏
朝	十月
停	亻丁
合	人口
章	立十
科	禾十
牌	片十
翻	釆习
帖	巾口
物	牛彡
港	氵巳
追	之㠯
背	丬月
解	⺈牛
底	广丶
亦	亠八
乾	十乙
喔	口至
笨	⺮一
短	矢䒑
炒	火丿
曹	艹日
徐	行禾
秘	禾丿
夜	亠丶
板	木又
博	十寸
存	大子
吾	工口
命	人卩
供	亻八
案	宀木
速	之口
抱	扌巳
野	甲丨
故	十攵
服	月又
若	艹大
演	氵八
嘴	口用
赤	土八
保	亻木
夏	一夂
硬	石乂
寒	宀冫
挖	扌乙
街	行土
距	足㇕
挑	扌儿
欲	八欠
竟	立儿
源	氵小
害	宀口
郭	亠阝
亮	亠几
粉	米刀
爆	火水
戴	土戈
然	夕灬
疼	疒冫
狼	犭艮
挂	扌土
佛	亻川
船	舟口
今	人㇕
猛	犭皿
沙	氵丿
哼	口了
望	亡王
腿	月艮
祝	礻儿
界	田川
抗	扌几
缺	牛大
尚	小口
似	亻人
福	礻田
遭	之日
端	立而
猜	犭月
架	力木
熊	厶灬
持	扌寸
插	扌臼
意	立心
圈	圍巳
踢	足彡
搬	扌殳
墙	土口
拖	扌也
换	扌大
院	阝儿
散	廿攵
松	木厶
爸	八巴
喜	士口
降	阝㐄
富	宀田
料	米十
梅	木母
批	扌匕
醒	酉生
逛	之王
精	米月
瘦	疒又
鞋	革土
展	尸展
别	口刂
依	亻𧘇
康	广氵
堂	小土
救	寸攵
舞	𠂉㐄
露	雨口
弱	弓冫
替	夫日
逼	之田
箱	⺮目
遍	之艹
武	一止
程	禾王
柳	木卩
偏	亻艹
印	氏卩
味	口小
零	雨之
紫	止絲
熟	亠灬
厚	厂子
答	⺮口
兼	䒑八
娘	女艮
登	癶䒑
微	行攵
佳	亻土
瞭	目小
魔	广鬼
司	㇆口
奇	大口
盛	戊皿
妙	女丿
后	斤口
形	一彡
充	亠儿
喂	口展
免	⺈儿
景	日小
蛋	㇕虫
碰	石业
酸	酉夂
候	亻矢
塞	宀土
擦	扌示
藏	艹臣
皆	匕白
屁	尸匕
琴	王㇕
宏	宀厶
善	羊口
增	土日
施	方也
暗	日日
忍	刀心
麻	广木
怒	女心
扔	扌丿
游	氵子
腰	月女
嫩	女攵
敏	𠂉攵
棒	木工
臭	自丶
拔	扌丶
蔡	艹示
校	木乂
糖	米口
吵	口丿
谷	八口
宇	宀寸
溜	氵田
旁	亠方
董	艹二
榜	木方
醉	酉十
妹	女小
乘	丿匕
刻	亠刂
酷	酉口
京	亠小
返	之又
瑞	王而
添	氵忄
催	亻隹
威	戊女
极	木人
瓶	䒑瓦
族	方矢
嘿	口灬
黎	禾水
密	宀山
炸	火卜
容	穴口
智	矢日
索	十絲
聚	耳乑
拼	扌艹
燕	廿灬
撞	扌二
朕	月大
普	䒑日
魏	禾鬼
范	艹巳
袁	土𧘇
彭	士彡
薄	艹寸
躲	身木
彩	爪彡
念	人心
惹	艹心
盒	人皿
远	之儿
姚	女儿
症	疒止
浪	氵艮
哈	口人
跨	足了
森	木木
瞎	目口
蛇	虫匕
屏	尸艹
灌	氵隹
埋	土二
略	田口
蒙	艹豕
托	扌七
淡	氵火
拜	手丰
娜	女阝
变	亠又
稳	禾心
勇	又力
运	之厶
怎	𠂉心
磨	广石
呼	口寸
洛	氵夂
嫁	女豕
稍	禾月
薛	艹辛
豆	一䒑
佐	亻工
隔	阝丁
碗	石夗
吻	口彡
健	亻二
雄	大隹
脑	月凵
柱	木王
暴	日水
娃	女土
漏	氵雨
碟	石木
郎	丶阝
珠	王小
透	之丿
府	广寸
吁	口一
窗	穴夂
报	扌又
希	乂巾
描	扌田
逗	之䒑
帝	亠巾
模	木大
扁	户艹
舒	人丨
嫌	女八
陆	阝山
剪	䒑刀
哩	口二
稿	禾口
玲	王之
坑	土几
趁	走彡
妖	女大
琳	王木
尊	丷寸
熬	丰灬
霜	雨目
剩	禾刂
型	土一
肺	月巾
附	阝寸
制	牛刂
置	四且
豪	亠豕
幽	幺山
辣	辛口
煤	火木
华	亻十
慧	丰心
墨	四土
娶	耳女
遂	之豕
斌	文止
控	扌工
覆	西夂
禁	木示
烤	火了
童	立二
暨	艮一
晴	日月
魂	二鬼
益	䒑皿
庭	广士
胡	月十
割	宀刂
隆	阝生
粥	弓弓
馨	士日
妻	一女
盾	斤目
莫	大艹
政	一攵
爹	八夕
廖	广彡
刺	木刂
冠	冖寸
躺	身口
婚	女日
奸	女十
兔	⺈丶
敬	艹攵
昂	日卩
葛	艹乚
柔	又木
迎	之卩
碎	石十
承	㇕三
勤	廿力
蒸	艹灬
凌	冫夂
旗	方其
始	女口
亭	亠丁
研	石艹
珍	王彡
卓	卜十
嗨	口母
舔	舌忄
喃	口半
漠	氵大
歪	不止
晓	日尤
斜	人十
乎	丿寸
湘	氵目
翔	羊习
迟	之丶
啸	口八
餐	卜食
炮	火巳
桌	卜木
芬	艹刀
桂	木土
朗	丶月
捐	扌月
棉	木巾
鼓	士又
霞	雨又
瞧	目灬
沉	氵几
箭	⺮刂
憋	水心
盟	日皿
延	廴止
盆	八皿
碧	王石
简	⺮日
翼	习八
涵	氵凵
萎	艹禾
桶	木用
弟	丷亻
傅	亻寸
哀	亠𧘇
叔	上又
殿	尸殳
悟	忄口
航	舟几
妮	女匕
旅	方氏
翠	习十
移	禾夕
予	又丨
融	一虫
漫	氵又
乳	爪乚
洁	氵士
宅	宀七
掌	小手
莉	艹刂
盼	目刀
握	扌至
宣	宀日
妍	女艹
醋	酉日
穆	禾彡
嘲	口月
耗	三毛
伍	亻㇕
逢	之丰
概	木儿
壁	尸土
漆	氵水
菊	艹米
岸	山十
凝	冫止
烈	一灬
矮	矢女
婆	氵女
剑	人刂
蝶	虫木
避	之辛
盈	㇆皿
材	木丿
翁	八习
枝	木十
固	圍口
耀	小隹
棵	木日
幅	巾田
殷	斤殳
菁	艹月
屈	尸山
娟	女月
恐	工心
楚	止木
逆	之凵
沫	氵一
熙	臣灬
忽	勹心
津	氵二
胳	月口
摩	广手
扇	户习
婷	女丁
淘	氵山
墓	艹土
杨	木彡
踏	足日
函	㇕凵
郡	尹阝
映	日大
鼻	自川
育	亠月
邀	之攵
佩	亻巾
策	⺮冂
莱	艹水
磊	石石
雁	厂隹
窄	穴卜
昨	日卜
倪	亻儿
癌	疒山
效	亠攵
挎	扌了
猴	犭矢
摇	扌山
蜜	宀虫
漂	氵示
序	广丨
巷	廿巳
梨	禾木
带	艹巾
腹	月夂
触	⺈虫
陷	阝臼
疑	匕止
鼎	目片
慌	忄川
瘤	疒田
罐	牛隹
默	四丶
孩	子人
帽	巾目
旋	方止
壹	士䒑
霸	雨月
席	广巾
典	冂八
儒	亻而
裸	衤木
御	行卩
腔	月工
突	穴丶
蕾	艹田
裂	一𧘇
境	土儿
扭	扌㇕
毅	立殳
煎	䒑灬
弦	弓幺
测	氵刂
罩	四十
卵	氏丶
逾	之刂
惜	忄日
警	艹言
掩	扌乚
昭	日口
宿	宀白
裙	衤口
劫	土力
扮	扌刀
律	行二
栋	木小
砂	石丿
埃	土矢
填	土十
吞	一口
霖	雨木
兜	白儿
稀	禾巾
牴	牛丶
棍	木匕
慕	艹忄
歇	日欠
疏	㇕川
陵	阝夂
碳	石火
廷	廴士
楠	木半
裴	非𧘇
媚	女目
吟	口㇕
繁	𠂉絲
蹲	足寸
遮	之灬
腐	广人
臂	尸月
敷	甫攵
伦	亻匕
两	一人
邢	一阝
萨	艹丿
趣	走又
杭	木几
崇	山示
挪	扌阝
荒	艹川
筋	⺮力
孕	㇆子
哲	扌斤
戮	习戈
享	亠子
棚	木月
蹦	足月
焊	火十
脂	月日
艘	舟又
靖	立月
奏	春大
咒	口几
姿	冫女
炫	火幺
缸	牛工
硅	石土
泛	氵之
卦	土卜
倩	亻月
糟	米日
激	氵攵
珊	王一
蠢	春虫
植	木且
姨	女弓
幢	巾二
痰	疒火
葡	艹甫
燃	火灬
磷	石㐄
脆	月巳
衡	行大
眠	目七
途	之禾
撇	扌用
磁	石幺
瓷	冫瓦
踹	足而
凸	丨一
瑜	王刂
磅	石方
宴	宀女
堪	土乚
麟	鹿㐄
翟	习隹
崩	山月
聘	耳了
郁	大阝
逝	之斤
塌	土习
崖	山土
廉	广八
婉	女夗
攀	木手
喘	口而
氮	气火
鞍	革女
巫	工人
虞	虎大
瑟	王丿
揪	扌火
势	扌力
削	小刂
睿	卜目
凹	冂一
葬	艹艹
咦	口弓
瞪	目䒑
詹	⺈言
卸	牛卩
慈	䒑心
瞄	目田
鞭	革乂
危	⺈巳
嫂	女又
拎	扌之
察	宀示
昆	日匕
丢	丿厶
娥	女戈
醇	酉子
橙	木䒑
辩	辛辛
薪	艹斤
巢	巛木
愚	日心
蜀	四虫
苔	艹厶
劈	尸刀
堤	土止
拱	扌八
夸	大了
傍	亻方
豹	豸丶
澄	氵䒑
冥	冖八
樱	女木
垮	土了
塑	䒑土
荷	艹亻
豫	又豕
亨	亠了
皓	白口
氟	气川
冤	冖丶
渐	氵斤
桥	木川
冀	丬八
彤	周彡
奕	亠大
誓	扌言
蜂	虫丰
迅	之十
曦	日戈
仰	亻卩
煞	⺈灬
羞	羊十
注	氵王
黛	亻灬
挤	扌川
挨	扌矢
泄	氵乚
惧	忄八
恭	廿忄
藤	水艹
涂	氵禾
氯	气水
孰	亠丸
耕	三川
稻	禾臼
氨	气女
愣	忄方
悔	忄母
磕	石皿
翅	十习
陀	阝匕
惑	戈心
赦	土攵
温	氵皿
寂	宀又
蓬	艹丰
硫	石川
貌	豸儿
舜	爪㐄
炳	火人
峡	山火
掀	扌欠
蹬	足䒑
甄	西瓦
抑	扌卩
敖	丰攵
毫	亠毛
逃	之氵
菱	艹夂
梯	木亻
腕	月夗
脉	月水
结	口絲
眨	目之
循	行目
侵	又亻
努	女力
黔	四㇕
魅	鬼小
雌	止隹
旱	日十
掰	手手
蛙	虫土
雕	周隹
瘾	疒心
随	阝月
瑛	王大
会	人厶
党	小儿
肆	長二
减	冫口
岑	山㇕
糕	米灬
咸	戊口
胤	儿月
磺	石八
瞅	目火
廊	广阝
焰	火臼
覃	西十
嵌	山欠
袍	衤巳
僵	亻田
臻	至禾
眺	目儿
晏	日女
螺	虫絲
恤	忄皿
污	氵了
涯	氵土
滋	氵幺
朔	䒑月
撼	扌心
勃	十力
矩	矢㇕
溺	氵冫
契	丰大
禧	礻口
峻	山夂
爵	爪寸
刨	勹刂
雍	亠隹
群	尹羊
燥	火口
强	弓虫
痘	疒䒑
髓	骨月
嫣	女灬
劳	艹力
魁	鬼十
倦	亻巳
疆	弓田
茅	艹又
霆	雨士
靴	革匕
眸	目牛
烟	火大
殊	一小
艇	舟士
裘	寸𧘇
寡	宀刀
瞬	目㐄
庸	广月
棠	小木
偕	亻白
宾	宀八
梵	木凡
蛾	虫戈
慰	尸心
履	尸夂
嫖	女示
督	上目
劣	小力
斧	八斤
簇	⺮矢
滞	氵巾
掠	扌小
嵩	山口
砌	石刀
瞥	水目
椰	木阝
障	阝十
揣	扌而
咯	口夂
拴	扌王
吏	大丶
堰	土女
棺	木㠯
腥	月生
阜	丿十
剖	立刂
羹	羊大
剃	丷刂
煜	火立
臧	爿臣
陌	阝白
瞿	目隹
蜘	虫口
抬	扌厶
懿	士心
翎	人习
煌	火王
瀚	氵习
辜	十辛
筐	⺮王
膊	月寸
遵	之寸
剁	几刂
竿	⺮十
憨	㇕心
毓	𠂉川
瞟	目示
舅	臼力
阪	阝又
啼	口巾
褪	衤艮
鞠	革米
彦	立彡
酬	酉川
啪	口白
睛	目月
遁	之目
哆	口夕
窟	穴山
愿	厂心
奚	爪大
腮	月心
唔	口工
猿	犭𧘇
撬	扌毛
巍	山鬼
擎	艹手
胆	月一
楷	木白
迭	之人
蹄	足巾
褐	衤乚
丞	㇕一
梭	木夂
畜	亠田
粽	米示
宵	宀月
嚷	口𧘇
絮	女絲
罕	冖十
肇	户二
岐	山又
睬	目木
璧	尸丶
犁	禾牛
怔	忄止
焚	木火
癖	疒辛
灼	火丶
荐	艹子
倔	亻山
麓	木鹿
嚎	口豕
摊	扌隹
茶	木艹
噗	口羊
筠	⺮冫
瓢	西瓜
裳	小𧘇
竭	立乚
担	扌一
谋	木言
戟	十戈
胥	㇕月
躁	足木
鞘	革月
凳	癶几
陈	阝小
姊	女亻
莞	艹儿
伶	亻之
墅	甲土
懵	忄目
碾	石展
榨	木卜
黯	四日
戚	戊小
怡	忄厶
礁	石灬
瞻	目言
脖	月子
襟	衤示
尉	尸寸
亥	亠人
厘	厂二
盔	大皿
睦	目土
炕	火几
嗷	口攵
尬	尤川
悍	忄十
憾	忄心
痔	疒寸
炼	火八
熄	火心
薯	艹者
逍	之月
毯	毛火
邸	氏阝
倭	亻女
勉	⺈力
璋	王十
咚	口冫
涌	氵用
歉	䒑欠
胰	月弓
隅	阝厶
岔	八山
痴	疒口
瘟	疒皿
树	木寸
歧	止又
确	石用
寐	宀小
硝	石月
咕	口十
叛	半又
捌	扌刂
勘	其力
樵	木灬
糜	广米
瑕	王又
糯	米而
茫	艹亡
噎	口䒑
凰	几王
霓	雨儿
囤	圍凵
靡	广非
厥	厂欠
嗓	口又
蚁	虫乂
瘸	疒人
桐	木冂
恍	忄尤
粱	米氵
瀛	氵凡
琅	王艮
苓	艹之
腌	月乚
橡	木豕
眩	目幺
弃	亠艹
貂	豸口
耙	三巴
跋	足丶
踱	足又
恢	忄火
彝	彑艹
旌	方生
舵	舟匕
璃	王厶
荧	艹火
懈	忄牛
潜	氵日
磐	舟石
漱	氵欠
庶	广灬
釜	八丷
匾	匚艹
筑	⺮凡
濡	氵而
痹	疒川
恃	忄寸
搔	扌虫
屹	山乙
灸	⺈火
熹	士灬
蹈	足臼
秧	禾大
狸	犭二
毗	田匕
炬	火㇕
箫	⺮八
斟	其十
匿	匚口
剔	日刂
癸	癶大
噤	口示
噩	王口
蝙	虫艹
燮	言又
满	氵人
滔	氵臼
姣	女乂
丐	一乚
敝	水攵
疹	疒彡
涕	氵亻
梁	木氵
羚	羊之
沥	氵力
墟	土业
蹙	戊足
氖	气丿
肠	月彡
琉	王川
抒	扌丨
酌	酉丶
濠	氵豕
殖	一且
眶	目王
稼	禾豕
喀	夂口
莓	艹母
稷	禾夂
祗	礻丶
褂	衤卜
叟	臼又
翡	非习
曳	日丿
羲	羊戈
沼	氵刀
蛹	虫用
烙	口火
熨	尸火
犀	尸牛
褶	衤白
栽	土木
髻	長口
嘶	口斤
昀	日冫
吮	口儿
茹	艹女
榻	木习
嗡	口习
妤	女丨
筹	⺮丰
聆	耳之
嗑	口皿
碌	石水
怠	厶心
曙	日者
稽	禾日
偎	亻展
敞	小攵
征	行止
赢	亡凡
祚	礻卜
巽	巳八
壑	卜土
峨	山戈
愉	忄刂
涛	氵寸
罔	冂亡
衙	行口
厝	厂日
桀	夕木
汤	氵彡
骸	骨人
煽	火习
惶	忄王
庇	广匕
蝗	虫王
陋	阝乚
摄	扌耳
愕	忄了
唧	口卩
烽	火丰
悦	忄儿
朦	月豕
渊	氵米
峙	山寸
畦	田土
逵	之土
秩	禾人
蛛	虫小
晦	日母
嫉	女矢
嗤	口虫
幌	巾尤
篆	⺮豕
怖	忄巾
扈	户巴
磬	士石
矗	十且
晰	日斤
鼬	臼由
揩	扌白
幔	巾又
渥	氵至
脏	月土
剿	巛刂
掣	牛手
俑	亻用
腋	月丶
羿	习艹
璜	王八
筵	⺮止
矛	又㇕
搂	扌米
纂	⺮絲
嗽	口欠
悸	忄子
耘	三厶
榴	木田
榛	木禾
筏	⺮戈
澹	氵言
辟	尸辛
痢	疒刂
泼	氵丶
萼	艹了
猥	犭展
惺	忄生
忿	八心
孵	氏子
罄	士山
髯	長土
膈	月丁
实	宀大
匆	勹丶
壕	土豕
涩	氵止
耽	其儿
菅	艹㠯
猩	犭生
瘪	疒匕
袄	衤大
霾	雨二
烁	火小
娱	一大
遏	之乚
隘	阝皿
衢	行隹
岷	山七
俘	亻子
狩	犭寸
蠡	彑虫
鬃	長示
睫	目止
蝠	虫田
靛	丰止
氦	气人
膀	月方
耆	者日
夙	几夕
嘱	口厶
翌	习立
夔	䒑夂
熏	千灬
舷	舟幺
氓	亡七
庖	广巳
埂	土乂
忝	一忄
怵	忄丶
僻	亻辛
瓤	亠瓜
羯	羊乚
翱	白习
奠	丷大
胎	月厶
邕	巛巴
茱	艹小
槛	木皿
祟	凵示
晋	一日
箔	⺮白
跤	足乂
牒	片木
玳	王弋
攘	扌𧘇
橄	艹㇕
药	艹丶
冽	冫刂
戾	户丶
亟	了一
蘑	艹石
惊	忄小
盹	目凵
盎	冂皿
哮	口子
狡	犭乂
蹶	足欠
蹋	足习
篱	⺮厶
恣	冫心
竣	立夂
倌	亻㠯
孺	子而
皎	白乂
橇	木毛
翳	匚习
崛	山山
庵	广乚
隧	阝豕
蟆	虫大
姒	女人
蚤	又虫
婊	女𧘇
斡	十十
蕨	艹欠
匈	勹凵
瑙	王乂
蜥	虫斤
螟	虫八
嬉	女士
嫦	女巾
慷	忄氵
寥	宀彡
砖	石丶
迄	之乙
梢	月木
咫	尸八
瞰	目攵
塾	亠土
旎	方匕
懦	忄而
盂	一皿
髦	長毛
芥	艹人
卮	斤巳
娓	女毛
跃	足大
肴	乂月
痿	疒女
湃	氵丰
睪	四半
旖	方口
疚	疒丶
窿	穴生
腱	月二
瘴	疒十
菰	艹瓜
袒	衤一
氛	气刀
琶	王巴
鞑	革大
踵	足二
罹	四隹
陛	阝土
萄	艹山
崆	山工
况	冫儿
侮	亻母
胱	月尤
乩	卜乚
鼾	自十
为	丷丶
葩	艹巴
赭	土者
枪	木巳
碉	石口
惨	忄彡
惘	忄亡
窠	穴木
裨	衤十
蜓	虫士
蚩	凵虫
榷	木隹
奄	大乚
窈	穴力
豉	一又
劾	亠力
荏	艹士
燧	火豕
砭	石之
蝉	虫十
蚓	虫丨
憩	舌心
鞣	革木
犒	牛口
麝	鹿寸
瑁	王目
骷	骨口
爨	臼火
譬	尸言
瞑	目八
璩	王豕
豺	豸丿
獐	犭十
柜	木㇕
俎	人且
静	丰彐
帚	彐巾
檄	木攵
逖	之火
靼	革一
吩	口刀
残	一戈
猓	犭木
褥	衤寸
菠	艹皮
跚	足一
牖	片甫
阶	阝川
皴	厶皮
黜	四山
磋	石工
鄹	耳阝
蓑	艹𧘇
蜒	虫止
蜡	虫日
滓	氵辛
娌	女二
憔	忄灬
雹	雨巳
楼	木女
奘	爿大
疙	疒乙
劬	勹力
恿	又心
裁	土亠
淹	日乚
侈	亻夕
屐	尸又
瞽	士目
氤	气大
徇	行日
胁	月八
匏	大巳
蝴	虫月
峰	山丰
窕	穴儿
鼙	士十
楫	木耳
咄	口山
麾	广毛
瑚	王月
瓮	八瓦
粳	米乂
歙	人欠
盐	土皿
悻	忄半
琵	王匕
悌	忄亻
圾	土人
滂	氵方
皈	白又
獗	犭欠
柩	木丶
夤	夕八
醺	酉灬
甥	生力
篾	⺮丶
滚	氵𧘇
霹	雨辛
蚣	虫厶
跎	足匕
嶝	山䒑
虾	虫卜
黠	四口
磴	石䒑
臃	月隹
恪	忄夂
霎	雨女
蜿	虫夗
簸	⺮皮
惋	忄夗
兕	冂尤
鄱	釆阝
墀	土牛
挈	丰手
瓠	大瓜
蠕	虫而
蹼	足羊
鬲	一丁
螳	土虫
擘	尸手
剽	西刂
砝	石厶
畚	厶田
桔	木士
坼	土丶
螂	虫阝
暹	之隹
瘠	疒月
毽	毛二
猎	犭日
孱	尸子
蓿	艹白
戡	其戈
痊	疒王
迹	之八
隍	阝王
黝	四力
蹉	足工
漯	氵絲
糢	米大
邂	之牛
岌	山人
赧	土又
幛	巾十
箝	⺮甘
凭	亻几
韵	立冫
踊	足用
髭	長匕
匐	勹田
陲	阝二
啃	口止
盥	臼皿
袈	力𧘇
耜	三㠯
袱	衤丶
遴	之㐄
妁	女丶
豌	一夗
瞌	目皿
酗	酉凵
貊	豸白
睽	目大
睥	目十
祐	礻大
螃	虫方
蟋	虫心
琊	王阝
躇	足者
慝	匚心
躅	足虫
肄	匕二
蜴	虫彡
褫	衤虎
籐	⺮水
蜢	虫皿
孳	䒑子
燐	火㐄
簷	⺮言
菩	艹立
够	勹夕
热	扌灬
嗳	爪口
勗	日力
聱	丰耳
猫	犭田
册	周一
垒	厶土
赶	走十
瞇	目米
柯	木丁
疮	疒巳
椁	木子
踫	足业
珮	王巾
叙	人又
离	亠厶
痲	疒儿
虱	乙虫
屉	尸乚
与	一一
国	圍丶
吨	口凵
却	土卩
撑	扌手
蝇	虫乚
咏	口水
踪	足示
网	冂乂
岭	山之
复	𠂉夂
众	人人
脚	月卩
凉	冫小
决	冫大
咤	口七
鼹	臼女
隽	隹丿
删	周刂
胶	月乂
泞	氵丁
姗	女一
芜	艹尤
毁	臼殳
肮	月几
怜	忄之
羡	羊欠
厨	厂寸
凛	冫示
厦	厂夂
厮	厂斤
徬	行方
厢	厂目
禀	亠示
鼇	丰黽
叠	又且
献	十丶
园	圍儿
拈	扌卜
丽	一丶
积	禾八
块	土大
貍	豸二
勦	巛力
说	言儿
发	乚丶
专	二丶
动	二力
联	耳大
帮	丰巾
横	木八
顾	厂頁
暂	車日
点	卜灬
贩	貝又
贴	貝口
税	禾儿
领	人頁
镇	金八
钻	金口
钢	金乂
铁	金人
腻	月貝
脱	月儿
讲	言川
语	言口
诉	言丶
该	言人
装	丬𧘇
闭	門丿
将	丬寸
应	广一
总	丷心
单	丷十
粮	米艮
数	米攵
泌	氵心
学	⺍子
宽	宀見
属	尸厶
验	馬⺍
买	㇕大
骗	馬艹
费	弓貝
弹	弓十
续	絲大
纯	絲凵
统	絲儿
断	米斤
编	絲艹
经	絲工
鹉	一鳥
严	一丿
恶	一心
画	一凵
歼	一千
殓	夕⺍
殁	一殳
殡	一八
迈	之力
坛	土厶
颉	士頁
进	之川
辇	夫車
颊	二頁
趋	走彐
壶	士业
壳	士几
场	土彡
韬	工臼
职	耳八
瑶	王山
麸	丰夫
艳	丰巴
聪	耳心
鬓	長八
聂	耳又
抚	扌尤
抠	扌乂
损	扌貝
挡	扌彐
捡	扌⺍
搀	扌冫
搅	扌見
拧	扌丁
挥	扌車
扬	扌彡
拾	扌人
苇	艹㇆
莲	艹車
蓝	艹皿
黄	廿八
蓦	艹馬
颠	十頁
蕉	艹隹
丧	十展
鄙	十口
荡	艹彡
苹	艹一
蟒	艹虫
萦	艹絲
茎	艹工
苏	艹八
卖	十大
飘	西風
梦	木夕
雾	雨力
档	木彐
枣	木冫
霉	雨母
检	木⺍
赖	木貝
霁	雨川
酿	酉艮
厉	厂力
压	厂丶
碍	石寸
厕	厂刂
赝	厂貝
袭	龍𧘇
态	大心
牵	大牛
础	石山
轩	車十
辆	車人
辕	車𧘇
贰	弋貝
转	車丶
辄	車乚
轰	車又
翘	戈习
辑	車耳
匮	匚貝
轿	車川
输	車刂
殴	匚殳
轮	車匕
载	車土
较	車乂
辙	車攵
辚	車㐄
辖	車口
轻	車工
辗	車展
顿	七頁
辐	車田
龉	齒口
蛲	虫尤
龇	齒匕
战	卜戈
蛤	虫人
卤	卜乂
频	止頁
龄	齒之
赀	止貝
蜕	虫儿
颅	卜頁
龌	齒至
哑	口业
贵	中貝
围	圍㇆
喷	口貝
团	圍丿
躏	足隹
跷	足尤
颚	口頁
圆	圍貝
骂	口馬
鹃	口鳥
图	圍冫
踯	足阝
姑	口女
呵	口丁
题	日頁
师	刂巾
畴	田寸
辉	小車
临	刂日
监	刂皿
览	刂見
鉴	刂金
凿	业凵
尝	小厶
晕	日車
赏	小貝
贤	刂貝
俞	刂月
竖	刂立
紧	刂絲
畅	申彡
赋	貝止
屿	山一
罢	四厶
财	貝丿
瞒	目人
巅	山頁
贼	貝大
贿	貝月
鸯	冂鳥
岗	山乂
崭	山斤
帧	巾貝
帜	巾八
刚	冂刂
赐	貝彡
婴	貝女
睁	目彐
购	貝厶
罚	四刂
赃	貝土
赠	貝日
赚	貝八
髅	骨女
贮	貝一
瞩	目厶
剀	山刂
觊	山見
凯	山几
悬	且心
乔	丿川
毡	毛口
鹄	牛鳥
篮	⺮皿
签	⺮⺍
颓	禾頁
称	禾小
赞	牛貝
鹅	手鳥
篓	⺮女
氢	气工
粤	鬼了
侠	亻火
伟	亻㇆
侧	亻貝
牍	片大
侥	亻尤
舆	臼八
躯	身乂
皑	白己
伤	亻力
俭	亻⺍
倾	亻頁
储	亻者
奥	自大
敛	人攵
馍	食大
弑	乂工
刹	乂刂
饶	食尤
彻	行刀
饨	食凵
馈	食貝
馄	食匕
饪	食士
饿	食戈
饰	食巾
饬	食力
饷	食口
饭	食又
丛	人一
耸	人耳
爷	八卩
馁	食女
馋	食冫
馅	食臼
馏	食田
饱	食巳
贪	人貝
饼	食艹
邻	人阝
馆	食㠯
颂	八頁
贫	八貝
铐	金了
铸	金寸
错	金日
质	斤貝
钵	金一
锚	金田
钓	金丶
铙	金尤
链	金車
锁	金貝
钞	金丿
销	金月
锡	金彡
铿	金土
铮	金彐
锄	金力
锹	金火
锻	金殳
镍	金木
锦	金巾
铨	金王
钤	金㇕
铃	金之
舱	舟巳
镀	金又
锋	金丰
钧	金冫
钩	金厶
镜	金儿
镑	金方
锲	金大
锑	金亻
镂	金女
锭	金止
释	釆工
锰	金皿
键	金二
肤	月人
狭	犭火
屑	月尸
猡	犭夕
脸	月⺍
飓	風八
飕	風又
鹏	月鳥
狰	犭彐
狱	犭丶
脐	月川
腾	月馬
狞	犭丁
脓	月𧘇
鳍	魚日
鲔	魚月
鳜	魚欠
鲢	魚車
鲈	魚尸
鲤	魚二
鳗	魚又
逊	之小
鳃	魚心
龟	⺈乚
奂	⺈大
鳏	魚水
颖	匕頁
鳅	魚火
毕	匕十
鲍	魚巳
贸	氏貝
鳞	魚㐄
鳝	魚口
鸵	鳥匕
雏	⺈隹
皱	⺈皮
邹	⺈阝
鲫	魚卩
许	言十
谢	言寸
诚	言㇆
请	言月
课	言木
读	言大
谏	言四
谈	言火
试	言工
诺	言艹
颤	亠頁
识	言八
蛮	亠虫
銮	亠金
弯	亠弓
挛	亠手
谅	言小
颜	立頁
诱	言丿
诲	言母
剂	文刂
谕	言刂
诠	言王
谶	言一
诊	言彡
论	言匕
谣	言山
诡	言巳
谗	言冫
询	言日
谄	言臼
谐	言白
鸾	亠鳥
议	言乂
谛	言巾
谤	言方
谜	言米
谴	言㠯
谊	言且
诧	言七
诵	言用
证	言止
痨	疒力
闺	門土
癞	疒貝
阑	門四
状	丬丶
阀	門戈
鹰	疒鳥
桨	丬木
奖	丬大
浆	丬水
资	冫貝
阎	門臼
癣	疒羊
净	冫彐
闹	門巾
阂	門人
阅	門儿
阐	門十
阔	門舌
阕	門大
瘫	疒隹
惯	忄貝
郑	䒑阝
烧	火尤
惭	忄斤
兑	丷儿
兽	丷口
恼	忄凵
悯	忄文
炀	火彡
递	之亻
兹	䒑幺
举	⺍工
兴	⺍八
誉	⺍言
鸿	氵鳥
溃	氵貝
浇	氵尤
浑	氵車
湿	氵业
溅	氵戈
澜	氵四
觉	⺍見
泽	氵工
涨	氵長
写	冖一
窍	穴了
窥	穴見
违	之㇆
祷	礻寸
宝	宀丶
赛	宀貝
骞	宀馬
窃	穴刀
祯	礻貝
遗	之貝
祸	礻人
褴	衤皿
裆	衤彐
鹤	冖鳥
遥	之山
额	宀頁
裤	衤車
禅	礻十
迳	之工
骊	馬丶
颈	㇕頁
劲	㇕力
骤	馬乑
骑	馬口
驶	馬乂
剥	彐刂
骡	馬絲
骄	馬川
肃	彐八
驻	馬王
昼	尸一
尽	尸冫
骇	馬人
骥	馬八
屡	尸女
驼	馬匕
驿	馬工
预	又頁
骆	馬夂
陕	阝火
贺	力貝
驾	力馬
弥	弓小
隐	阝心
妩	女尤
给	絲口
络	絲夂
纬	絲㇆
绘	絲厶
绩	絲貝
绑	絲阝
缚	絲寸
叁	厶三
缅	絲丨
参	厶彡
绕	絲尤
练	絲八
纽	絲十
缉	絲耳
继	絲乚
绷	絲月
纱	絲丿
缧	絲絲
纲	絲乂
缕	絲女
级	絲人
缎	絲殳
绵	絲巾
缴	絲攵
纶	絲匕
纷	絲刀
缓	絲又
绚	絲日
约	絲丶
终	絲冫
绝	絲巴
缠	石二
综	絲示
绽	絲止
婶	女申
缩	絲白
缝	絲丰
绾	絲㠯
绿	絲水
绋	絲川
丝	絲一
缘	絲豕
缫	絲木
芈	卜工
趸	一足
欤	一欠
韧	工丶
毂	士殳
赘	丰貝
琐	王貝
珲	王車
觐	廿見
鹊	廿鳥
韩	十㇆
贲	十貝
鸪	十鳥
萝	艹夕
藓	艹羊
荦	艹牛
莺	艹鳥
酝	酉厶
榄	木見
栏	木二
霭	雨乚
鹌	大鳥
砺	石力
靥	厂丨
魇	厂鬼
餍	厂食
龚	龍八
砾	石小
尴	尤皿
轭	車巳
欧	匚欠
鸥	匚鳥
瓯	匚瓦
蛎	虫力
颦	止十
蝈	虫丶
龋	齒厶
蝼	虫女
咖	口力
鹭	足鳥
坚	刂土
鳖	水魚
睐	目水
帼	巾丶
羁	四馬
逻	之夕
黩	四大
峥	山彐
贬	貝之
赊	貝示
赡	貝言
赅	貝人
鹦	貝鳥
矫	矢川
籁	⺮貝
筛	⺮巾
箩	⺮夕
衅	丿半
筝	⺮彐
氲	气皿
鸽	人鳥
觎	人見
径	行工
饺	食乂
钙	金乚
慇	斤心
镖	金示
钝	金凵
镯	金虫
铭	金夕
铄	金小
镶	金𧘇
镞	金矢
镳	金灬
鹞	金鳥
铎	金工
钮	金十
飏	風彡
腼	月丨
狮	犭巾
獭	犭貝
鳔	魚示
鳄	魚了
觞	⺈彡
毙	匕匕
鲸	魚小
惫	夂心
鲛	魚乂
袅	鳥𧘇
谨	言丰
峦	亠山
谒	言乚
恋	亠心
诈	言卜
讯	言乙
诿	言女
讼	言厶
诤	言彐
谆	言子
赣	立貝
盗	冫皿
癫	疒頁
鹧	广鳥
酱	丬酉
闱	門㇆
阁	門口
阗	門八
阖	門皿
痪	疒大
痉	疒工
恸	忄力
粪	米八
烩	火厶
炖	火凵
烂	火二
怆	忄巳
懔	忄示
濒	氵頁
鲨	氵魚
湾	氵弓
窜	穴中
窝	穴人
窦	穴大
禄	礻水
褛	衤女
骠	馬示
骋	鳥了
驸	馬寸
骛	又馬
骚	馬虫
书	㇕丶
陨	阝貝
险	阝⺍
缰	絲田
缭	絲小
缆	絲見
娇	女川
媪	女皿
嬷	女厶
驽	女馬
纥	絲乙
缢	絲皿
缪	絲彡
鸶	絲鳥
绌	絲山
据	口扌
按	女扌
哎	乂口
传	丶亻
受	又爪
刷	刂尸
咋	卜口
河	口氵
苦	口艹
操	木扌
局	口尸
沈	儿氵
篇	艹⺮
待	寸行
列	刂一
易	彡日
商	口亠
泡	巳氵
蔓	日艹
秀	丿禾
造	口之
赫	八土
唐	口广
客	口宀
捏	土扌
摸	大扌
嘎	戈口
偷	刂亻
咧	刂口
估	口亻
消	月氵
奶	丿女
侯	矢亻
抵	丶扌
潘	田氵
俊	夂亻
抄	丿扌
核	人木
洪	八氵
膜	大月
选	儿之
嘻	口士
敲	又亠
愁	心禾
泥	匕氵
遇	厶之
胸	凵月
技	又扌
患	心口
播	田扌
陶	山阝
袋	𧘇亻
俾	十亻
趟	口走
撤	攵扌
暖	又日
妞	十女
抖	十扌
符	寸⺮
吼	乚口
择	工扌
愈	心人
溪	大氵
晃	尤日
济	川氵
妳	小女
述	丶之
粘	口米
萍	十艹
籍	日⺮
裹	𧘇亠
恰	口忄
渡	又氵
薇	攵艹
域	戈土
邵	阝刀
桃	儿木
俗	八亻
创	刂人
浮	子氵
槽	日木
萌	月艹
汗	一氵
堡	土亻
彬	彡木
蹭	日足
卿	卩氏
薰	灬艹
拷	了扌
掏	山扌
幕	巾艹
蟹	虫⺈
捷	止扌
囊	𧘇一
滥	刂氵
垂	二千
拨	乚扌
僧	日亻
寨	木宀
搜	臼扌
膏	月亠
糊	月米
筒	口⺮
庚	人广
涉	小氵
货	匕亻
阮	儿阝
莎	丿艹
裕	口衤
傲	攵亻
椅	大木
潮	十氵
焉	灬一
蒲	甫艹
砰	十石
咐	寸口
杖	乂木
措	日扌
跪	巳足
仪	乂亻
抛	力扌
悠	心亻
价	川亻
楞	方木
喉	矢口
妓	又女
禹	厶丿
搏	寸扌
蒜	示艹
雀	隹小
浙	斤氵
梳	川木
瞳	二目
拂	川扌
慎	八忄
蕊	心艹
敦	攵亠
渴	乚氵
曝	水日
蒋	寸艹
墩	攵土
徽	攵行
蓄	田艹
溢	皿氵
寝	又宀
俏	月亻
炭	火山
泳	水氵
侍	寸亻
昧	小日
卒	十亠
膝	水月
痣	心疒
隋	月阝
禽	厶人
莹	丶王
遣	㠯之
皖	儿白
碘	八石
秤	十禾
捻	心扌
淤	冫氵
祠	口礻
黏	口禾
茄	力艹
棕	示木
埠	十土
茬	土艹
哟	丶口
佰	白亻
寅	八宀
沛	巾氵
澈	攵氵
霄	月雨
胞	巳月
寓	厶宀
撩	小扌
弩	弓女
拣	八扌
拟	厶扌
沟	厶氵
拦	二扌
媳	心女
彰	彡立
肝	一月
榆	刂木
郊	阝亠
捎	月扌
孽	子艹
岱	山亻
匙	匕日
携	隹扌
抹	一扌
烹	灬亠
柄	一木
坦	日土
隙	小阝
荼	禾艹
苍	巳艹
肢	又月
悄	月忄
恒	日忄
瘀	冫疒
悴	十忄
抿	七扌
炽	八火
枯	十木
窘	口穴
瘩	口疒
橱	寸木
寮	小宀
硼	月石
涤	夂氵
吭	几口
跺	木足
抢	巳扌
蛟	乂虫
沃	丿氵
蒂	艹亠
荻	火艹
瀑	日氵
簧	八⺮
沧	人氵
筷	大⺮
摹	手艹
渤	力氵
柿	巾木
膨	彡月
馥	夂禾
粹	十米
廓	阝广
冕	儿日
檬	豕木
槌	㠯木
徙	止行
嬴	凡亡
兢	儿十
啜	又口
溥	寸氵
渗	彡氵
膑	月宀
煦	灬日
蔬	川艹
壤	𧘇土
慨	儿忄
挽	儿扌
酪	口酉
膛	土月
娑	女氵
拄	王扌
徊	口行
悖	子忄
姥	匕女
汰	丶氵
滩	隹氵
峭	月山
倘	小亻
捺	示扌
寄	大宀
畸	口田
漩	止氵
疵	匕疒
遐	又之
袂	大衤
燎	小火
琍	刂王
姻	大女
搭	艹扌
腑	寸月
唆	厶口
潼	二氵
蚕	虫一
唾	二口
湍	而氵
俸	工亻
唷	厶月
楹	皿木
翩	习户
擅	日一
剜	刂宀
获	丶艹
憬	小忄
惬	火忄
洼	土氵
篡	厶⺮
僮	二亻
睨	儿目
蜇	虫扌
篁	王⺮
蜈	大虫
溯	䒑氵
栩	习木
藐	儿艹
酵	子酉
惚	心忄
蛀	王虫
黍	水禾
貉	口豸
淙	示氵
砥	丶石
蹊	大足
瘁	十疒
迂	寸之
膺	月广
鞅	大革
懊	大忄
遽	豕之
薜	辛艹
梆	阝木
菽	又艹
猷	丶丷
桅	巳木
碱	口石
惕	彡忄
憧	二忄
蟑	十虫
犄	口牛
汹	凵氵
彗	彐丰
茁	山艹
孀	目女
徨	王行
阱	川阝
臆	心月
腆	八月
遨	攵之
惴	而忄
骼	口骨
盍	皿土
棱	夂木
跆	口足
咆	巳口
翕	习人
浓	𧘇氵
蚱	卜虫
罟	口四
猬	月犭
刎	刂勹
枇	匕木
疥	川疒
猖	日犭
瞠	土目
蜻	月虫
噱	豕口
舨	又舟
逞	口王
嚅	而口
佻	儿亻
帑	巾女
伉	几亻
娩	儿女
陴	十阝
儡	田亻
圬	了土
霪	士雨
遘	土之
袜	木衤
崁	欠山
撚	灬扌
篛	冫⺮
窑	山穴
凄	女冫
疱	巳疒
构	厶木
蝎	乚虫
体	一亻
凑	大冫
瘉	刂疒
珐	厶王
榫	隹木
渺	目氵
啣	卩口
宪	儿宀
铜	口金
调	口言
废	丶广
层	厶尸
顽	頁二
挟	火扌
抡	匕扌
挚	手扌
挣	彐扌
掷	阝扌
掺	彡扌
协	八十
莴	人艹
蔼	乚艹
蕙	車艹
萧	八艹
荪	小艹
蕴	皿艹
栉	卩木
雳	力雨
槟	八木
厌	丶厂
奁	乂大
轫	丶車
辎	田車
踌	寸足
蹑	又足
蹒	人足
呓	乙口
嘘	业口
啰	夕口
呛	匕口
颗	頁日
赎	大貝
颛	頁山
岖	乂山
俩	人亻
侦	貝亻
馒	又食
颔	頁人
伞	丨人
饲	口食
颁	頁八
镭	田金
钗	丶金
锅	人金
锉	土金
铛	彐金
铲	丿金
镘	又金
锵	寸金
镰	八金
镁	大金
锐	儿金
鲳	日魚
迩	小之
燄	火⺈
评	十言
诗	寸言
讷	人言
词	㇆言
谎	川言
诙	火言
误	大言
谓	月言
诛	小言
诳	王言
谱	日言
诋	丶言
谬	彡言
谦	八言
译	工言
诞	止言
疠	力疒
冻	小冫
疡	彡疒
慑	又忄
愤	貝忄
焕	大火
焖	心火
渍	貝氵
涟	車氵
润	王氵
烫	火氵
驱	乂馬
坠	土阝
纭	厶絲
妪	乂女
绳	乚絲
织	八絲
绢	月絲
纳	人絲
绣	丿絲
纫	丶絲
殇	彡一
坜	力土
瑷	又王
琼	小王
撵	車扌
挠	尤扌
揽	見扌
荆	刂艹
桢	貝木
励	力厂
轲	口車
轼	工車
轶	人車
辍	又車
嘉	力口
哝	𧘇口
秽	夕禾
篑	貝⺮
箪	十⺮
俨	丿亻
偿	厶亻
伧	巳亻
鸰	鳥人
惩	心行
锤	二金
铢	小金
铰	乂金
玺	丶⺈
鹑	鳥亠
孪	子亠
诣	匕言
兖	儿亠
竞	儿立
闾	口門
愠	皿忄
恻	刂忄
懑	心氵
泾	工氵
鸩	鳥冖
绮	大絲
嫔	八女
嬝	𧘇女
纰	匕絲
绞	乂絲
缔	巾絲
绎	工絲
缀	又絲
缁	田絲
搞	扌亠
低	亻氏
滴	氵亠
陪	阝立
响	口自
喊	口戊
含	人丶
藉	艹三
英	艹冂
倍	亻立
洞	氵冂
吸	口㇆
框	木匚
浩	氵牛
曼	日四
奔	大十
桑	又又
捧	扌春
洲	氵⺍
逸	之⺈
哄	口廿
染	氵九
衰	亠日
培	土立
截	土隹
塘	土广
枕	木冖
斑	王文
柴	止匕
澳	氵自
伏	亻大
刑	一艹
蓉	艹穴
株	木牛
沾	氵卜
淑	氵上
穗	禾車
搓	扌羊
丙	一冂
渠	氵匚
撕	扌其
戳	习习
咽	口圍
碑	石鬼
嚼	口爪
浸	氵彐
授	扌爪
溶	氵穴
媛	女爪
辨	辛刂
脾	月鬼
媒	女甘
弊	水冂
葵	艹癶
蔚	艹尸
瓣	辛瓜
寇	宀二
寞	艹宀
翰	十日
晾	日亠
逮	之彐
捆	扌圍
臀	尸廿
掘	扌尸
腺	月白
掂	扌广
冶	冫厶
蘸	艹酉
茵	艹圍
簿	⺮氵
呸	口不
藩	艹氵
嘟	口者
稠	禾周
苟	艹勹
熔	火穴
迥	之冂
榕	木穴
潺	氵尸
湛	氵其
崎	山大
韶	立日
峪	山八
椒	木上
沌	氵七
拙	扌凵
衷	亠中
捶	扌千
垢	土斤
漾	氵羊
俐	亻禾
呐	口冂
俯	亻广
暇	日㇕
械	木戈
卯	氏丿
凋	冫周
晤	日工
檐	木⺈
坯	土不
拘	扌勹
婵	女丷
拭	扌弋
憎	忄丷
糙	米之
炯	火冂
悼	忄卜
褒	亠亻
烘	火廿
拗	扌幺
樟	木立
豁	宀丰
窖	穴牛
痞	疒不
樽	木丷
漪	氵犭
扼	扌厂
糠	米广
苛	艹丁
弈	亠川
潇	氵艹
膳	月羊
汲	氵㇆
杵	木𠂉
榭	木身
弼	弓一
擂	扌雨
漳	氵立
滨	氵宀
簪	⺮七
濂	氵广
庾	广臼
蕃	艹釆
嫡	女亠
婢	女鬼
婿	女㇕
偃	亻匚
蔗	艹广
汛	氵乙
坷	土丁
楔	木丰
涎	氵廴
殆	一夕
晌	日自
忱	忄冖
蠹	一中
喱	口厂
涸	氵圍
愀	忄禾
湮	氵西
寤	宀爿
俚	亻甲
秸	禾士
倏	亻丨
蛔	虫圍
箴	⺮戊
蔑	艹四
伫	亻宀
壅	亠乡
爰	爪一
萸	艹臼
啻	亠丷
姘	女䒑
唳	口户
篙	⺮亠
腊	月廿
淄	氵巛
倨	亻尸
砧	石卜
蟀	虫亠
惦	忄广
遑	之白
犊	牛十
懒	忄木
羸	亡口
攫	扌目
秣	禾一
僭	亻七
肫	月七
咨	冫欠
戛	一自
蚪	虫冫
倥	亻穴
惆	忄冂
揆	扌癶
坍	土周
蚵	虫丁
蕈	艹西
胭	月圍
嫘	女田
槁	木亠
愎	忄𠂉
螫	土川
酩	酉夕
揖	口耳
枸	木勹
迢	之刀
梃	木廴
侏	亻牛
佝	亻勹
胴	月冂
嗾	口方
捩	扌户
蝌	虫禾
淆	氵乂
埤	土鬼
褓	衤亻
啕	口勹
踟	足矢
跼	足尸
痺	疒鬼
栅	木周
搾	扌穴
浬	氵甲
赔	貝立
伪	亻丷
铬	金夂
滤	氵虎
垩	一业
摆	扌四
垫	扌丸
搁	扌門
蔺	艹門
啬	十䒑
营	艹冖
荫	艹阝
梱	木圍
橹	木魚
桩	木广
榈	木門
啧	口丰
呕	口匚
噜	口魚
唤	口⺈
暧	日爪
赂	貝夂
债	亻丰
贷	亻弋
侬	亻冖
饴	食厶
钠	金冂
锈	金禾
锾	金爪
铅	金几
锯	金尸
胪	月卜
诘	言士
摔	亠扌
谍	言廿
谭	言西
诫	言戈
诰	言牛
诟	言斤
谚	言立
诀	言㇕
诏	言刀
辫	辛絲
涣	氵⺈
逦	之一
驹	馬勹
骈	馬䒑
骏	馬厶
缄	絲戊
绰	絲卜
绸	絲周
绥	絲爪
娴	女門
缮	絲羊
掳	扌虎
捣	扌鳥
跶	足之
晖	日冖
锣	金四
镐	金亠
镕	金穴
讫	言𠂉
浏	氵文
泻	氵冖
堕	阝大
辔	車絲
缣	絲䒑
缤	絲宀
噢	自口
秒	小禾
拆	斤扌
液	亠氵
沿	几氵
菌	圍艹
淫	爪氵
俱	且亻
拒	匚扌
揍	春扌
掐	⺈扌
倚	大亻
潭	西氵
杆	十一
藕	三艹
援	爪扌
挫	人扌
茗	夕艹
伽	力亻
迦	力之
桓	二木
嗜	者口
涮	尸氵
沸	弓氵
柒	七氵
胚	不月
檀	亠木
垣	二土
娣	丷女
葱	勹艹
怯	土忄
啤	鬼口
棘	冂木
梧	工木
焙	立火
棣	彐木
垛	几土
篷	之⺮
淀	宀氵
澎	士氵
矜	㇕又
掬	勹扌
伺	㇆亻
濯	习氵
拯	㇕扌
苒	冂艹
仞	刀亻
僖	士亻
搪	广扌
佗	宀亻
稔	人禾
逅	斤之
溉	艮氵
榔	丶木
牯	十牛
婀	阝女
喋	廿口
悚	木忄
摒	尸扌
泱	冂氵
竽	一⺮
怏	冂忄
媲	鬼女
拮	士扌
柞	𠂉木
媾	甘女
泅	圍氵
狷	口犭
戢	耳口
祆	一礻
倣	方亻
偬	勹亻
秆	一禾
濬	卜氵
挞	之扌
荚	二艹
苎	宀艹
荣	冖艹
枢	匚木
堑	斤車
馊	臼食
钴	十金
惮	丷忄
涧	門氵
绫	土絲
缨	貝絲
绍	刀絲
掴	圍扌
擞	米扌
薮	米艹
贻	厶貝
俦	丰亻
脊	人月
讦	一言
讹	亻言
衮	八亠
谲	又言
绒	戈絲
哇	土土
例	夕刂
叼	㇆一
咳	乡人
拽	乚丿
喻	月刂
揭	人乚
佬	者匕
捂	㇕口
鄂	了阝
捅	又用
侃	口川
暮	大日
栓	人王
梗	日乂
喧	二日
嗦	冖絲
募	大力
滇	且八
扳	斤又
襄	甘𧘇
擒	冂厶
哨	小月
泓	弓厶
嗟	羊工
摧	山隹
苞	勹巳
荔	力力
渭	田月
荀	勹日
浚	八夂
蔽	冂攵
吱	十又
淞	八厶
沅	二儿
汾	八刀
啖	火火
芋	一寸
沱	宀匕
掖	夂丶
淅	木斤
拚	厶艹
俟	厶矢
肱	大厶
苣	匚㇕
惰	工月
妊	丿士
啾	禾火
佞	二女
莠	㇆丿
萋	彐女
嚏	㇕止
溘	厶皿
荸	冖子
柠	宀丁
栀	一巳
瑯	艮阝
偺	卜日
蘗	辛木
捞	冖力
荤	冖車
萤	冖虫
喽	米女
侨	大川
赁	士貝
傧	丘八
钹	又丶
讳	工㇆
亵	丸𧘇
沦	人匕
驳	乂乂
桧	二厶
嚣	頁口
勋	貝力
俪	冂丶
濑	⺈貝
撮	又耳
坪	十丷
仗	乂一
刊	刂十
淳	子口
嗅	丶大
撰	八廿
萃	十人
殃	大冂
漓	厶冂
殉	日勹
芍	丶勹
澧	䒑口
噫	心日
洌	刂夕
呎	丶尸
曷	乚人
抉	大㇕
喟	月田
莅	立亻
塭	皿日
櫂	隹习
涡	人冂
吴	大一
哗	十匕
咛	丁宀
唠	力冖
啭	丶乚
嘤	女貝
侩	厶二
