的	白
是	日
在	一
你	亻小
就	亠
說	言
沒	氵
還	空之
對	空业
那	刀
個	亻
呢	口匕
來	木
會	亼
與	臼一
給	糸亼
等	⺮寸
恩	圍心
能	厶
做	亻攵
想	木心
點	四
後	空行
從	行止
再	一土
將	爿
時	空日
但	亻一
麼	广
啦	口立
讓	言甘
嗯	口圍
得	行
啊	口阝
或	戈
新	立
於	方
嘛	口广
號	口虎
玩	王兀
最	日又
真	十
吃	口乙
發	癶
請	言月
錢	金
開	門
哈	口亼
當	小
更	一乂
該	言人
快	空心
別	空口
前	䒑
高	空亠
您	亻心
卻	空八
寫	宀火
搞	亠扌
事	空一
拿	亼手
帶	空廿
死	一匕
賣	士貝
暈	日車
像	亻豕
使	亻乂
剛	空冂
無	𠂉
換	扌大
哪	口刀
愛	爪
聽	耳
靠	牛非
幫	土巾
算	⺮艹
學	臼
咯	口夂
總	空糸
唉	口厶
按	扌女
區	空匚
萬	艹日
機	木人
偶	亻厶
第	⺮亻
完	宀兀
同	冂
花	艹
講	言土
殺	空乂
錯	金日
些	止
住	亻王
跑	空足
網	糸亡
睡	目
裝	空爿
哦	口手
挺	扌士
圖	圍口
掉	扌十
路	足
頭	一頁
應	广心
強	弓
類	空米
作	空亻
送	之大
書	尹
法	空氵
乖	千匕
撒	扌攵
接	空扌
辦	辛
級	糸又
哎	乂口
版	空片
併	亻䒑
副	一口
俺	亻申
兩	一人
轉	車
便	乂亻
線	糸水
黃	廿八
道	之
座	广土
低	亻氏
難	廿
受	空爪
阿	阝口
喝	口乚
管	⺮
定	空宀
傳	亻寸
樣	空木
夠	夕
交	亠乂
笑	空⺮
邊	之方
型	一艹
黑	空四
慢	心又
刷	尸刂
越	走
貴	中
部	立阝
稱	禾土
處	虎
選	之八
站	立口
怪	心土
省	小目
倒	亻至
談	言火
曾	八日
經	糸
據	扌豕
變	空言
查	木日
象	空𠂊
陳	阝日
格	木口
幹	十干
讀	言貝
條	亻丨
亂	爪乚
唔	口工
遠	之衤
單	口一
海	氵母
熱	土火
咋	口卜
滿	氵人
額	宀頁
班	王王
滴	亠氵
掛	扌卜
關	空門
漲	氵長
店	广口
坐	空人
約	糸丶
飛	乙
劉	卯
度	空广
種	禾
俄	亻手
歌	空丁
報	空土
若	艹𠂇
原	厂
飯	空食
晚	日儿
量	日土
賺	貝八
重	空千
裡	衤
貼	貝口
盤	空舟
爽	大乂
隊	阝豕
楊	木彡
臺	士
往	行王
國	圍
狗	犭口
歲	空止
費	空弓
壞	土水
離	亠隹
佔	亻卜
周	周
超	走口
均	土二
達	之羊
照	日火
動	千
特	空牛
係	亻糸
畫	空尹
夢	艹夕
教	者
哥	丁
蠻	言虫
值	亻且
鎮	金八
陪	阝立
既	艮
哭	口犬
建	廴
洗	氵牛
懂	心二
雙	隹
指	扌日
球	空王
仍	亻㇆
跌	足大
練	糸四
億	立亻
清	氵月
提	扌
除	阝木
通	之用
貓	空豸
餓	食戈
病	疒
假	亻又
段	厂殳
課	言木
急	𠂊心
藥	艹白
城	土㇆
任	亻士
草	十艹
羅	四隹
理	王
貨	亻匕
唱	口日
藍	艹皿
縣	且
常	空小
搶	扌人
菜	艹爪
喲	口丶
感	戊
較	車乂
混	匕氵
敢	丁攵
臉	月人
操	扌木
南	空十
吳	口大
聲	空士
德	行心
局	空尸
雲	空雨
噢	米大
整	木止
傻	亻囟
華	艹夫
克	十儿
呃	口厂
喊	口戊
跳	足⺍
養	空羊
團	圍寸
沈	氵冖
樂	空白
篇	⺮户
待	行寸
砸	石巾
深	氵木
求	一丶
親	立見
葉	艹木
款	士欠
器	口口
何	亻口
率	亠十
調	言口
修	彡亻
試	言弋
謝	言身
僅	亻丰
層	尸日
面	㇕
週	之周
份	亻刀
趙	走月
情	心
論	言艹
流	氵川
招	扌口
痛	空疒
列	一刂
封	土寸
易	日勹
冷	冫
借	亻日
派	氵氏
帥	丿巾
廠	广攵
陽	阝彡
樹	木寸
胡	十口
停	亻丁
奧	宀大
章	立十
科	空禾
倆	人亻
牌	片
權	木隹
翻	釆
隨	阝月
場	土
帖	巾口
商	亠口
價	亻貝
物	牛
泡	氵勹
寶	宀王
體	骨
追	之㠯
傷	亻彡
背	丬
腳	月卩
劍	亼刂
解	𠂊
底	广一
業	业
孫	空子
舊	艹臼
乾	十乙
詞	言㇆
喔	口至
證	言䒑
鐵	金王
落	艹口
節	⺮卩
輕	空車
笨	⺮一
輸	車刂
短	空矢
含	亼口
炒	火丿
藉	艹丰
徐	行木
騙	馬艹
秒	禾丿
夜	亠丶
師	丿
板	木又
贏	空亡
苦	艹十
秀	禾㇆
博	十寸
朝	十月
詩	言寸
爛	火四
靜	丰
存	一子
燒	火兀
斷	匕
吾	空工
虧	虎丂
湯	氵彡
極	木一
命	空亼
茶	艹人
供	亻八
案	宀木
品	口
造	之口
抱	扌巳
野	田予
綠	糸彑
獎	爿犬
緊	臣
故	十攵
服	月
盡	尹皿
英	艹大
蘇	艹禾
演	氵八
嘴	口用
簽	⺮人
填	土八
保	亻木
唐	广尹
雞	爪隹
夏	一夂
莫	大艹
硬	石乂
寒	宀冫
挖	扌乙
髮	空長
題	日頁
街	行土
距	足コ
挑	扌⺍
純	糸屮
鬧	鬥
欲	八欠
竟	立儿
源	氵厂
戲	空虎
寄	大宀
橋	木丿
燈	空火
郭	阝亠
亮	亠几
屬	尸虫
窮	穴弓
粉	米刀
爆	火水
韓	十㐄
刪	冂刂
戴	十八
然	䏑
衝	行千
疼	疒冫
蓋	艹土
港	氵巳
狼	犭艮
蘭	艹四
壓	厂土
捏	日扌
齊	亠川
賽	宀貝
佛	亻川
船	舟
猛	犭皿
客	宀口
黨	小火
雖	口隹
領	亼頁
沙	氵丿
戰	口戈
哼	口了
望	亡
腿	月艮
園	空圍
祝	示儿
鄉	空乡
鄭	八酉
界	田
抗	扌几
河	氵丁
缺	午
賊	貝𠂇
尚	小口
似	亻人
福	示
遭	之日
煙	火土
端	立而
猜	犭月
架	力
熊	厶火
持	扌寸
廣	广八
插	扌臼
歸	空丿
滾	氵衣
靈	雨
意	空立
圈	圍卩
趕	走干
踢	足彡
勝	月力
呵	丁口
搬	扌殳
獲	空犭
覺	空臼
塔	土艹
準	氵十
拖	扌也
摸	扌艹
院	阝
慘	心彡
散	廿攵
松	木厶
爸	八
喜	士口
語	言工
治	氵口
降	阝㐄
漢	氵夫
富	宀田
料	米十
嘎	戈口
結	糸口
咬	口乂
梅	木母
批	扌匕
寧	宀丁
醒	酉
逛	之王
精	米
瘦	疒又
踩	足木
槍	人木
偷	亻亼
麗	一鹿
鞋	革
展	尸
興	臼八
倍	亻立
康	广⺍
堂	小土
救	一水
觀	空艹
鍵	金二
製	牛衣
餘	食木
筆	⺮二
舞	𠂉㐄
露	雨口
冒	空冖
榮	火木
弱	弓冫
影	日彡
替	夫
逼	之田
陸	空阝
願	厂頁
箱	⺮目
嚇	口火
測	氵刂
莊	艹士
寬	宀丶
遍	之艹
武	一止
湖	十氵
聯	空耳
程	禾王
偏	亻户
實	宀
味	口木
鎖	金貝
零	雨龴
環	王衤
紫	止糸
熟	亠火
標	木示
歐	匚欠
厚	厂子
答	⺮口
懶	心木
顧	户
滅	火氵
運	之車
輪	車艹
兼	䒑八
溫	氵皿
娘	女艮
登	空癶
微	行攵
佳	亻土
瞭	目小
魔	广鬼
司	㇆
拋	扌力
奇	大
編	糸艹
居	尸口
憑	冫心
盛	戊皿
奶	女㇆
后	𠂆
洞	氵冂
形	一彡
檔	木田
圓	圍貝
牆	爿口
充	亠儿
害	宀丰
喂	口衤
免	𠂊儿
景	日小
擬	止扌
穩	禾心
曹	一日
曉	日兀
蛋	㇕虫
宮	口宀
碰	石业
酸	空酉
侯	亻コ
塞	宀土
脫	月儿
勁	一力
創	人
擦	扌示
爾	一八
藏	艹臣
皆	匕白
屁	匕尸
掙	扌尹
琴	王㇕
錄	金水
餵	食衤
稅	禾儿
宏	宀厶
例	亻刂
專	一寸
繼	糸幺
產	文
善	羊口
增	土日
施	方也
淚	氵犬
暗	日日
忍	空刀
聖	耳王
橫	木八
遊	之子
偉	亻㐄
麻	广木
怒	女心
扔	扌㇆
游	氵子
鄧	癶阝
腰	月女
嫩	女攵
淨	氵尹
彈	弓一
減	氵戊
敏	𠂉攵
義	羊
棒	木夫
響	乡
拆	扌丶
蔡	艹示
校	木乂
糖	米口
吵	口丿
谷	八口
麥	木夂
宇	宀一
雜	亠人
潘	氵釆
旁	亠方
董	艹二
榜	木方
醉	酉十
鍾	金千
妹	女木
鋼	金山
蔣	艹爿
幣	巾
評	言丁
絕	糸巴
幾	幺
楚	止木
屆	凵尸
館	食
乘	禾匕
認	言心
刻	亠刂
俊	夂亻
抄	丿扌
夾	大人
酷	酉口
京	亠小
嚴	口攵
返	之又
礦	石八
廳	广耳
瑞	王而
飄	空西
註	言王
添	氵心
催	亻隹
威	空戊
劇	虎刂
核	木亠
瓶	䒑瓦
銅	金口
族	空方
尋	彐
顯	日幺
嘿	口四
鏈	金車
擺	扌四
擠	扌川
黎	禾水
騎	馬大
密	宀山
術	行丶
炸	火卜
洪	氵廿
訊	言十
腦	空月
禮	空示
容	穴
輝	小車
智	矢
索	十糸
聚	耳亻
拼	扌䒑
燕	廿火
撞	扌土
膜	月大
普	䒑日
魏	禾鬼
澤	氵半
側	刂亻
諾	口言
呂	丿口
范	艹卩
搭	口扌
鳳	几
袁	衤土
鑽	金牛
彭	士彡
陰	阝厶
唸	口心
薄	艹寸
涼	小氵
鹽	臣𠂉
賴	木貝
獨	犭
載	十車
躲	身
抵	扌一
舉	臼夫
彩	爪彡
傑	亻夕
噸	頁口
慶	鹿
緣	糸豕
駐	馬王
衛	行㐄
念	亼心
蕭	艹尹
惹	心艹
勸	艹力
讚	言牛
盒	亼皿
逃	之⺍
嘉	口士
納	糸人
倉	人口
姚	女⺍
症	疒止
喇	刂口
浪	氵艮
梁	氵刀
吸	口又
跨	足丂
盧	虎皿
瞎	目口
蛇	虫匕
購	空貝
導	之寸
噴	口貝
屏	尸艹
優	亻夂
灌	氵隹
埋	土土
略	田口
掃	扌巾
吶	口冂
蒙	艹豕
託	言七
托	扌七
淡	氵火
賤	貝戈
拜	手
娜	女阝
懷	心水
敲	亠又
凱	山几
鐘	金土
愁	禾火
薩	艹生
揚	扌彡
勇	龴
財	貝
鍊	金四
終	糸冫
質	斤
泥	氵匕
遇	之厶
喬	丿大
欄	木四
儀	亻戈
遲	之牛
怎	空𠂉
磨	广石
呼	口丁
液	氵丶
嫁	女豕
捲	卩扌
稍	禾月
薛	艹辛
豆	一䒑
頓	一屮
儂	亻辰
佐	亻工
臨	空臣
隔	阝丁
繞	糸兀
輛	車人
溝	氵土
碗	石卩
賠	貝立
吻	口彡
健	亻二
速	之木
雄	𠂇
胸	月凵
框	匚木
暴	日水
湊	氵丰
識	言戈
娃	女土
漏	氵雨
拔	扌丿
洛	氵夂
探	扌冖
碟	石廿
郎	空丶
珠	王木
劑	刂亠
透	之㇆
惠	一心
譚	言西
營	火
府	广寸
叼	口㇆
殘	一戈
窗	空穴
搜	臼扌
希	乂
患	空中
播	扌田
逗	之䒑
廢	广殳
賢	臣貝
帝	亠巾
模	木大
磚	石寸
扁	户艹
舒	亼予
嫌	女八
陶	阝凵
剪	䒑刀
哩	口土
稿	禾口
棟	日木
撿	人扌
玲	王龴
驚	艹馬
坑	土几
備	亻用
撥	扌癶
袋	亻衣
趁	走彡
妖	丿女
錦	金巾
溼	土氵
淺	氵戈
尊	八寸
顏	空文
匯	匚隹
熬	士火
霜	雨目
沿	口氵
盜	氵欠
浩	牛氵
剩	禾刂
域	土一
肺	月巾
附	阝寸
制	牛刂
置	四且
豪	亠豕
恆	心冫
濤	氵寸
幽	空幺
豐	空丰
辣	辛口
煤	火甘
戀	言糸
圍	圍㐄
俾	十亻
慧	丰心
墨	四土
鏡	金儿
娶	耳女
蝦	虫又
鵬	月鳥
誠	言戊
賀	力貝
險	阝人
飾	食巾
撐	扌牙
鋒	金丰
遂	豕之
控	扌工
殼	士殳
擋	扌小
覆	西
趟	走小
禁	木木
烤	火丂
童	立土
蟲	虫
徵	行山
暨	空艮
晴	日月
魂	空二
益	空䒑
庭	广士
濃	氵辰
割	宀刂
消	氵小
隆	阝生
撤	攵扌
粥	弓弓
馨	士日
誤	言大
曼	日四
暖	日爪
滬	氵巴
柱	木王
塗	氵亼
妻	一女
灣	氵弓
盾	空𠂆
奔	大十
潤	氵門
政	一攵
爹	八夕
廖	广彡
刺	木刂
冠	冖
躺	空身
舍	十亼
蓮	艹車
獸	犬口
婚	女日
攝	扌耳
醫	匚
閣	門夂
妞	女丨
兔	𠂊丶
敬	艹攵
潮	月氵
昂	日卩
飽	食巳
咳	口人
鼠	臼⺍
葛	艹乚
桑	又
續	糸貝
苑	卩艹
迎	之卩
碎	石十
承	空㇕
膠	月彡
勤	廿力
摔	十扌
撈	力扌
蒸	艹火
凌	冫夂
旗	方其
妙	女丿
始	女
符	寸⺮
倫	亻艹
鋁	口金
亭	亠丁
吼	口子
研	石
俗	口亻
爺	八阝
霧	雨力
珍	王彡
卓	卜十
韋	空㐄
歡	艹欠
嗨	口母
積	禾貝
捧	扌夫
舔	空舌
贊	牛貝
喃	口半
簡	⺮日
豔	丰皿
愈	亼月
溪	氵爪
罰	四刂
歪	不
晃	兀日
斜	亼十
鄒	勹阝
洲	氵⺍
湘	目氵
罷	四匕
妳	女小
翔	羊习
異	空田
隱	阝心
枝	木十
逸	之𠂊
哄	口八
餐	卜
顆	田頁
染	氵九
餅	食艹
藝	艹厶
炮	火巳
桌	空卜
芬	艹刀
鴻	氵鳥
攜	扌山
腎	臣月
撲	扌羊
萍	艹䒑
桂	土木
朗	丶
捐	扌月
彎	言弓
薑	艹三
荷	艹亻
畝	丶亠
棉	木巾
擊	車手
貸	亻弋
傾	亻頁
鼓	士又
霞	雨又
瞧	目火
沉	氵几
箭	⺮刂
騰	月馬
潔	氵糸
盟	日皿
延	空廴
柔	空予
資	二
嶺	山頁
盆	八皿
檢	木亼
護	言又
傘	人十
碧	王石
籍	⺮丰
燙	彡火
銘	金夕
浴	八氵
翼	习八
哲	扌斤
涵	氵㇕
鈣	金乚
菌	艹圍
敵	亠八
桶	木用
抹	木扌
弟	八亻
傅	亻甫
衰	衣
譯	言半
柯	木丁
叔	上
殿	尸殳
驢	馬皿
怡	厶口
勢	土力
航	舟几
妮	女匕
萊	人艹
兇	乂儿
旅	方氏
鷹	广鳥
技	扌又
韻	立貝
摘	扌亠
翠	空习
邁	厶之
移	禾夕
搖	扌凵
畢	甲
融	一虫
勞	火力
採	扌爪
鈕	金丨
渡	氵广
奪	大寸
乳	爪子
齣	空齒
錫	金彡
薇	艹行
淫	士氵
拽	申扌
職	耳戈
宅	宀七
掌	小手
培	土口
莉	艹刂
損	扌貝
櫃	木匚
盼	目刀
握	扌至
謀	木言
廟	广月
截	十隹
邵	刀阝
墊	土半
宣	宀日
妍	女一
醋	酉日
膽	月言
穆	禾彡
啃	止口
漸	氵斤
耗	丰毛
伍	亻㇕
塘	土广
壽	士寸
逢	之丰
晉	二日
桃	木⺍
壁	尸土
爐	火皿
漆	水氵
暫	車日
辭	爪辛
縫	糸丰
俱	且亻
菊	艹米
岸	山
凝	空冫
膩	月貝
脈	月氏
烈	一火
矮	矢女
貪	亼貝
婆	氵女
俞	刂亼
蝶	空虫
誇	言丂
枕	木冖
毀	臼殳
避	之辛
綁	糸阝
悅	心儿
浮	子氵
盈	刀皿
材	木亻
賞	小貝
翁	八习
固	圍十
耀	小隹
槽	曲日
獻	虎犬
幅	空巾
審	宀釆
殷	𠂆殳
茲	艹幺
穎	匕頁
萌	月艹
斑	王文
牽	亠牛
屈	尸凵
怨	空夕
癢	疒艮
恐	工
凍	冫日
複	空衤
柴	止匕
逆	之屮
騷	馬虫
熙	臣火
抖	扌冫
忽	勹
津	氵二
胎	月口
糧	米土
濟	氵亠
參	空厶
譜	日言
褲	衤車
紮	木糸
摩	广手
縮	糸白
漫	氵又
溜	氵田
彥	文彡
棄	亠木
扇	户习
婷	女丁
菸	艹冫
憂	一白
堡	土亻
淘	氵凵
墓	日艹
嬌	口女
遞	之虎
彬	彡木
卿	丿卩
鶴	冖鳥
函	㇕凵
確	空石
郡	尹阝
緩	糸爪
協	十力
瓊	王夂
髒	空骨
債	貝亻
薰	艹千
映	日大
粵	空囟
鼻	自
銷	空金
育	亠月
澳	氵宀
候	亻矢
堅	臣土
邀	之攵
閉	門亻
佩	亻巾
決	氵大
適	之亠
策	⺮冂
藤	艹水
磊	石石
雁	厂隹
俠	亻大
腸	月日
窄	穴卜
昨	日卜
倪	亻儿
務	予
癌	疒山
效	亠攵
拷	扌丂
猴	犭矢
掏	扌勹
撮	耳又
揉	扌予
醬	爿酉
訴	言丶
態	厶心
繡	糸爿
蜜	宀虫
漂	氵示
巷	廿巳
梨	禾木
蒂	艹亠
腹	月夂
蟹	𠂊用
陷	阝臼
蒼	口艹
鵝	空手
疑	空匕
鼎	目片
釣	金丶
慌	心川
蔥	艹囟
瘤	疒田
執	土丸
踏	足日
龔	龍
捷	扌止
罐	午隹
腫	月二
縱	糸止
壇	土亠
觸	𠂊虫
默	四犬
懸	空且
瑩	王火
孩	子
咖	口力
幀	巾貝
悟	心口
頻	止頁
灑	氵鹿
燉	火攵
帽	巾目
旋	方止
擁	扌隹
聶	耳耳
猶	犭酉
壹	士䒑
霸	雨月
席	广巾
繫	車糸
擔	扌言
贈	貝日
儒	亻而
裸	衤木
御	行卩
腔	月工
刑	刂一
賓	貝宀
攤	隹扌
蕾	艹雨
頸	一巛
臟	月臣
囊	一衤
境	土儿
拒	扌コ
毅	立殳
煎	䒑火
弦	弓幺
渝	刂氵
罩	四十
蓉	艹穴
憶	心心
卵	空卯
遷	之西
逾	之刂
垂	千二
潛	氵日
郵	千阝
惜	心日
警	艹言
揭	扌乚
謂	言田
昭	日刀
宿	宀白
統	糸儿
裂	一衣
僧	四日
慣	心母
裙	衤尹
淋	木氵
齋	亠示
揍	扌丰
鉤	金勹
劫	土厶
扮	扌刀
疊	田且
喻	口刂
律	行二
株	木𠂉
砂	石丿
埃	土矢
坪	土䒑
揮	扌車
吞	一大
沾	氵卜
遙	之凵
壺	士亞
霖	雨木
兜	白儿
寨	宀甘
監	臣皿
稀	禾巾
恰	心亼
牴	牛一
棍	木匕
朕	月䒑
淑	氵上
饒	食兀
慕	艹心
歇	日欠
疏	㇕川
膏	月亠
陵	阝夂
壩	土月
纏	糸土
鹹	卜口
聰	耳心
碳	石火
銳	儿金
驗	馬
廷	廴士
糊	米月
翹	土习
儲	亻者
楠	木半
顛	十頁
祭	空䏑
拾	扌亼
媚	女目
吟	口㇕
筒	口⺮
堯	土兀
繁	𠂉糸
坦	日一
穗	禾一
紗	糸丿
虐	虎一
蹲	足寸
紹	口糸
幕	艹巾
澆	氵兀
搓	工扌
遮	之火
庚	广人
哉	戈十
涉	氵癶
賦	貝止
臂	尸月
樁	木臼
敷	甫
禪	示一
佬	匕亻
瑤	王凵
習	习
阮	阝兀
丙	一冂
歷	空厂
躍	足隹
範	⺮車
邢	一阝
擰	扌宀
莎	艹丿
糞	米八
濱	貝氵
議	言羊
趣	空走
渠	氵匚
閱	門儿
杭	木几
崇	山示
擴	扌八
傢	亻宀
婦	空女
裕	衤口
嘆	口夫
艦	舟皿
挪	扌阝
荒	艹川
筋	⺮力
孕	刀子
撕	扌其
鈴	金龴
戳	习戈
籌	⺮士
奎	大土
駕	空力
享	亠子
棚	木月
傲	攵亻
蹦	足月
焊	火干
脂	月匕
趨	走屮
艘	舟又
競	儿立
靖	立月
奏	丰大
咒	口几
釋	空釆
姿	二女
炫	火幺
賜	貝彡
湧	氵力
潑	氵殳
缸	空午
漿	爿水
栽	十戈
閻	門臼
攪	扌見
述	之丶
泛	氵之
佑	亻𠂇
鮑	魚巳
閥	門戈
卦	土卜
咽	大口
倩	亻月
貧	八貝
糟	米日
激	氵攵
階	阝白
珊	王一
潭	氵西
蠢	丰虫
植	木且
嘯	口爿
徑	行工
鉛	金几
屍	尸匕
倚	大亻
灘	隹氵
姨	女弓
幢	巾土
鈉	金冂
暢	申
詠	言水
齡	齒
焉	火一
桐	木冂
痰	疒火
捂	㇕口
鄰	米阝
揀	四扌
艙	舟口
謙	言八
織	糸戈
蒲	甫艹
驅	馬口
轟	車車
攔	門扌
碑	石囟
嚼	口寸
燃	火火
暉	日冖
杖	乂木
謎	言米
磷	石㐄
竄	穴⺍
脆	月𠂊
墜	阝土
姑	女口
衡	行大
皺	勹皮
擇	扌半
櫻	木女
鹼	卜人
窯	穴火
措	扌廿
眠	目七
途	之亼
鄂	丂阝
叢	业又
磁	石幺
錶	金衤
沃	大氵
辯	空辛
浸	氵彐
柄	冂人
跪	足卩
攬	扌臣
輯	車耳
瓷	二瓦
澀	氵止
踹	足而
瑜	王刂
磅	石方
豈	山䒑
瀉	宀氵
遼	之小
豎	臣䒑
宴	宀女
堪	土乚
擱	扌門
麟	空鹿
祿	示水
翟	习隹
仗	一亻
崩	山月
厲	厂厶
憲	宀心
遺	之貝
聘	耳丂
喚	口𠂊
裁	十衣
郁	空𠂇
逝	之斤
際	阝示
誌	言士
塌	习土
崖	山土
廉	广䒑
婉	女卩
攀	木手
獅	犭巾
喘	口而
氫	空气
氮	气火
鞍	革女
竇	穴貝
墳	土貝
巫	工人
虞	虎大
瑟	王丿
揪	扌禾
棵	田木
拐	刀扌
築	⺮木
癮	疒心
剝	彑
削	小刂
籃	⺮皿
悠	心亻
睿	卜目
葬	艹艹
咦	口弓
瞪	目䒑
詹	𠂊言
侃	川亻
授	又扌
卸	午卩
頌	八厶
慈	䒑心
闊	門舌
纖	糸一
瞄	目田
駱	馬夂
鞭	空革
楞	方木
兌	八儿
危	𠂊卩
喉	口矢
溶	氵穴
撫	扌火
媛	女爪
拎	扌龴
察	宀示
駿	馬厶
繪	糸日
黴	山行
鈞	勹金
憐	心㐄
昆	日匕
禹	丿厶
娥	女戈
醇	酉子
橙	木䒑
辨	辛辛
暮	大日
祕	示丿
薪	艹斤
煥	火大
巢	巛
脾	月十
淵	氵爿
愚	日心
蜀	四虫
裹	空衣
藕	丰艹
劈	尸刀
堤	土止
拱	廿扌
夸	大丂
傍	亻方
燥	火口
豹	豸丶
澄	氵䒑
冥	冖八
媒	女甘
燦	火米
垮	土丂
枯	十木
塑	䒑土
構	木土
茅	艹予
慾	八心
搏	扌甫
鑄	金寸
豫	予豕
蒜	示艹
亨	亠了
腐	广䏑
皓	白口
氟	气川
冤	冖丶
浙	氵扌
栓	人王
梳	木川
冀	空丬
餡	食臼
彤	周彡
卑	囟
誓	言扌
蜂	虫丰
迅	之十
曦	日丂
仰	亻卩
煞	𠂊火
羞	羊丨
注	氵王
嫂	女臼
瞳	目立
黛	亻火
拂	扌弓
挨	扌矢
泄	乚氵
綱	糸山
慎	心八
恭	廿心
弊	巾艹
貳	弋
氯	气水
蠟	虫巛
孰	亠丸
耕	丰川
稻	禾臼
綺	糸大
荊	刂艹
桿	木干
喪	土衤
盪	皿氵
氨	气女
愣	心方
瀾	氵四
悔	心𠂉
敦	攵亠
葵	艹癶
磕	石皿
顫	亠頁
渴	氵乚
曝	水日
撇	巾扌
梗	日乂
絡	糸夂
蔚	艹尸
翅	十习
估	亻十
鎂	金羊
復	行夂
瓣	辛瓜
濫	氵臣
況	氵儿
陀	阝匕
莖	艹工
惑	空戈
簾	⺮八
徽	攵行
謹	言丰
噓	口丘
瞞	目廿
娛	大女
蓄	艹田
濺	戈氵
敘	亼攵
鑑	金皿
溢	䒑氵
彌	弓乂
寇	又宀
獵	犭巛
滄	人氵
葷	艹冖
蓬	艹之
硫	石川
俏	月亻
貌	豸
舜	爪㐄
炳	火人
茄	力口
訣	言㇕
廚	寸广
炭	山火
綿	糸巾
搗	扌鳥
岡	冂山
掀	扌欠
誘	言禾
翰	十日
睜	目尹
撓	扌兀
掩	扌申
蹬	足䒑
泳	氵水
椅	大木
遜	之糸
甄	西瓦
侍	寸亻
抑	扌卩
敖	士攵
毫	亠毛
侵	亻彐
覽	臣見
概	木儿
援	爪扌
逮	之尹
卒	十亠
鬆	長
捆	扌圍
厭	厂犬
峽	山人
寢	宀爿
菱	艹夂
梯	八木
僑	亻丿
腕	月宀
挫	土扌
膝	月木
嗦	冖糸
眨	目之
循	行目
臀	尸廿
努	女力
黔	四㇕
魅	鬼
徹	行亠
廈	广夂
掘	扌尸
茗	夕艹
絨	糸𠂇
擾	扌夂
襯	衤見
雌	止隹
伽	亻力
蛙	虫土
雕	空周
嬰	貝女
痣	疒士
譽	臼言
廂	广目
隋	月阝
蘊	艹糸
棲	尹女
瑛	王大
禽	人厶
腺	月水
迦	之力
矯	矢口
竅	穴攵
鑲	金甘
緯	糸㐄
繆	糸彡
玖	王丶
肆	長二
菁	艹月
鎳	金自
冶	冫厶
嘔	口匚
遣	之中
岑	山㇕
皖	白兀
糕	米火
閤	門亼
釀	酉甘
彙	空彑
蘸	艹酉
茵	圍艹
簿	⺮氵
咸	戊口
呸	口不
胤	儿
蹤	足止
桓	木二
碘	石曲
廊	广阝
焰	火臼
壘	田土
淳	子口
畏	田衤
屑	尸小
覃	西十
嵌	山欠
販	貝又
嗆	户口
袍	衤巳
菴	艹申
僵	亻田
饞	食丶
沫	一氵
滯	巾氵
臻	至
眺	目⺍
寂	宀又
醣	酉广
晏	日女
秤	禾䒑
蘿	艹隹
誅	言𠂉
螺	虫糸
錠	金止
診	言彡
恤	心皿
涯	厂氵
滋	氵幺
蘆	艹虎
嗜	者口
貿	氏
療	疒小
滲	氵厶
瀝	止氵
筍	⺮勹
朔	䒑月
捻	心扌
勃	十冖
矩	矢コ
淤	冫氵
描	田扌
膚	虎月
契	丰刀
祠	示㇆
陝	阝大
鞏	工革
峻	山夂
稠	禾周
爵	爪寸
刨	勹刂
雍	亠乡
群	尹羊
麵	木目
盞	戈皿
烙	火夂
痘	疒䒑
髓	骨月
嫣	火女
募	力艹
苟	勹艹
篩	⺮巾
魁	空鬼
棕	示木
倦	亻半
疆	弓田
蔓	艹又
樺	夫木
霆	雨士
蠶	七
嘰	口幺
靴	革匕
慮	虎心
眸	目牛
惱	心乂
殊	一木
艇	舟士
熔	火穴
裘	衣一
儘	亻皿
寡	宀刀
擲	阝扌
蔔	艹勹
迥	之冂
巖	山攵
瞬	目㐄
鉻	金夂
榕	木穴
庸	广用
渾	氵車
棠	小木
窺	穴見
埠	土十
奮	空大
剎	乂刂
濁	氵虫
濾	氵虎
嗅	口自
簫	⺮爿
佰	白亻
滇	且八
寅	宀八
姦	女女
梵	木凡
蛾	虫手
慰	尸心
履	尸夂
駛	空馬
宛	宀卩
襪	衤丶
嫖	女示
綸	亼糸
礙	石止
獄	犭犬
闢	門辛
蟬	虫一
涮	巾刂
督	空上
違	之㐄
絞	糸乂
劣	小力
貶	貝之
斧	八斤
裔	衣口
湛	氵其
簇	⺮矢
償	小亻
沛	氵巾
澗	門氵
殤	彡一
掠	小扌
崎	山口
贛	日立
蕩	艹彡
砌	石刀
闌	門四
淹	氵申
慼	戊心
蟻	虫戈
澈	攵氵
葦	艹㐄
瞥	巾⺍
崑	山匕
墮	阝𠂇
輓	車儿
鴿	亼鳥
錘	二金
懼	心隹
椰	木耳
梢	木小
嘟	者阝
瀟	爿氵
障	阝十
霄	雨小
疇	田寸
揣	扌而
唆	八夂
誦	言用
綜	糸示
詢	言日
劃	尹刂
駁	馬乂
拴	扌王
聳	行耳
燭	火虫
襖	衤大
臘	月巛
吏	乂一
堰	土女
棺	木㠯
腥	月生
胞	月巳
羨	羊欠
韶	立日
阜	丿十
剖	立刂
羹	羊大
剃	八刂
寓	厶宀
峪	口山
煜	立火
竊	穴厶
扳	厂扌
桔	木士
轄	車宀
臧	爿臣
喀	夂口
陌	阝一
弩	弓女
撰	八扌
瞿	目隹
蛤	虫亼
襄	衣甘
肅	尹爿
擒	厶扌
哨	口小
鑿	业金
鋸	金尸
膿	月辰
懿	士心
蔭	艹阝
椒	木上
翎	亼习
煌	火王
瀚	氵习
絹	月糸
僱	隹亻
泓	弓氵
昧	日二
棧	木戈
錳	金子
鱗	魚㐄
辜	十辛
筐	⺮王
膊	月寸
遵	寸之
摺	扌白
剁	几刂
拙	扌屮
彆	巾弓
鈔	金丿
鏟	金生
驛	馬半
鱉	巾魚
稜	禾夂
憤	心十
綽	糸十
鶯	火鳥
緻	糸攵
塚	土冖
燜	火門
脊	⺍
捶	扌二
勵	厂力
毓	𠂉川
苔	厶艹
黏	禾人
瞟	目示
舅	臼力
錚	金尹
阪	阝又
恕	心女
轎	車口
啼	口巾
繭	艹虫
鬱	午彡
曠	日八
諦	言巾
褪	衤艮
鞠	革米
彰	立彡
綴	又糸
酬	酉川
橘	木予
啪	口白
睛	空目
斂	攵亼
遁	之目
晝	尹一
殲	一一
樸	木羊
窟	穴凵
鈍	金屮
垢	土𠂆
愿	厂心
奚	爪大
誼	言且
紛	糸刀
腮	月心
鍍	金又
嗟	工口
蠱	虫虫
沸	川氵
妓	女又
儉	亼亻
猿	犭衤
漠	氵艹
撬	扌毛
巍	山鬼
漾	氵羊
擎	艹手
詐	言卜
絃	幺糸
俐	亻禾
胚	月一
楷	木白
迭	之𠂉
詔	言刀
嵩	山亠
驕	馬丿
蹄	足巾
穫	禾又
潰	氵貝
褐	衤乚
丞	㇕一
梭	夂木
瘡	疒人
槓	貝木
唷	厶月
鯨	魚
鎊	金方
畜	亠田
廬	广皿
粽	米示
韌	㐄
囉	隹口
鸞	言鳥
宵	宀月
榆	刂木
嚷	口甘
釵	丶金
絮	女糸
剷	立丿
罕	冖干
駝	馬匕
箏	⺮尹
俯	亻广
瀑	日氵
肇	户二
窪	穴土
暇	日尸
岐	又山
睬	目爪
郊	亠阝
璧	尸丶
挾	人人
捎	月扌
嶼	山八
斃	巾匕
犁	禾牛
怔	心止
焚	木火
鷗	匚鳥
癖	疒辛
灼	火丶
孽	子艹
岱	亻山
麓	木鹿
匙	匕日
嚎	口豕
鏢	金示
涇	氵工
摧	山扌
械	木艹
凋	冫口
蕙	艹一
噗	口羊
筠	⺮土
諧	言白
喧	日口
癲	疒頁
瓢	西瓜
嚕	口魚
裳	小衣
謊	言川
晤	日工
竭	立乚
擅	一扌
諫	言四
烹	火亠
綾	夂糸
漬	丰氵
戟	日十
韜	㐄臼
胥	㇕月
葡	艹甫
噯	口爪
縛	糸寸
嬸	女田
壙	八土
蠍	虫欠
拘	勹扌
躁	足口
穀	士冖
癱	疒隹
鞘	革月
瀨	刀貝
凳	癶几
隙	阝小
娣	八女
驟	馬亻
莞	艹兀
曆	厂日
伶	亻龴
謠	言凵
璽	丶一
拭	扌弋
醃	酉申
墅	土田
懵	心目
碾	石衤
雋	空隹
禧	示口
鷺	足鳥
鵑	口鳥
脅	力月
榨	木卜
黯	土四
侖	亼艹
荼	艹亼
苞	艹巳
戚	戊小
頒	八頁
倘	冂口
怯	心厶
淪	亼氵
礁	石隹
睏	目木
瞻	目言
脖	月子
襟	衤示
尉	尸寸
軼	車大
亥	人亠
蘋	艹頁
肢	月又
悄	心月
紐	糸丨
貯	貝丁
僕	亻羊
禎	示貝
緬	糸目
頰	大頁
糙	米之
炯	火冂
盔	𠂇皿
睦	目土
炕	火几
鬢	長貝
荔	力力
嗷	攵口
籲	⺮頁
鯊	氵魚
藩	艹氵
楨	卜木
尬	尤
贖	貝貝
瘀	疒方
悼	心卜
臍	月川
抿	七扌
憾	心戊
滌	亻氵
嶽	山犬
褒	衣木
痔	疒寸
烘	火八
渭	田氵
嘻	䒑口
錨	田金
鍛	金殳
熄	火心
薯	艹者
禦	行示
蕉	火艹
荀	勹日
逍	之月
拗	扌幺
轍	車攵
毯	毛
鐸	金半
邸	空氏
柵	冂艹
倭	禾亻
熾	火戈
莽	艹犬
勉	𠂊力
璋	王十
毆	匚殳
咚	口冫
槳	爿木
恪	心夂
噹	口田
軀	身口
鈷	金十
歉	䒑欠
績	心貝
樟	木立
豁	丰宀
窖	穴牛
驥	馬八
扭	扌丨
胰	月弓
邇	之乂
啟	空户
隅	厶阝
岔	八山
纜	糸見
枴	木刀
鑼	金隹
廁	广刂
撼	扌心
雛	勹隹
痞	疒不
瘟	疒皿
樽	寸木
崢	山尹
歧	止又
箋	⺮戈
寮	宀小
繃	糸月
悍	心干
嬋	一甲
駭	馬人
硼	月石
啤	口囟
叛	半
浚	夂氵
霽	雨川
嘮	冖力
勘	其
樵	隹木
倡	日亻
糜	广米
漪	氵犭
迴	之圍
駒	馬勹
瑕	王又
蔽	攵艹
鐳	金雨
糯	米而
茫	艹亡
噎	口䒑
飼	食口
狹	犭人
凰	空几
溺	氵冫
霓	雨儿
硝	石月
囤	圍屮
吭	口亠
靡	广非
厥	厂欠
凜	冫禾
跺	足几
萃	亠艹
扼	扌厂
吱	口十
綢	糸周
蛟	虫乂
鋤	金力
誕	言止
瘸	疒䏑
棘	冂木
虜	虎力
夥	田夕
譁	言夫
辮	辛糸
恍	心兀
貽	貝厶
糠	米⺍
渺	氵目
瀛	氵凡
琅	王艮
苛	艹丁
苓	艹龴
姍	女艹
橡	木豕
眩	目幺
拈	卜扌
倔	亻凵
諜	言廿
艱	廿艮
貂	豸口
諒	言小
耙	丰巴
跋	足丿
踱	足又
恢	心火
彝	彑艹
綰	糸㠯
磯	石人
旌	方生
踐	足戈
舵	舟匕
廝	广斤
寐	爿宀
璃	王厶
荻	艹犭
懈	心牛
磐	舟石
漱	欠氵
櫥	木广
諱	言㐄
庶	广火
癬	疒羊
掄	艹冂
釜	八八
騫	宀馬
釐	二土
隸	⺍木
匾	匚艹
膳	月羊
濡	而氵
蕪	艹𠂉
恃	心寸
淞	厶八
頹	禾頁
搔	扌虫
矇	目豕
縈	火糸
嬪	女貝
梧	木工
羈	四馬
屹	山乙
鯉	空魚
灸	火𠂊
甦	一生
熹	火士
鵲	廿鳥
鑰	金艹
焙	火立
蹈	足臼
秧	禾冂
狸	犭土
訥	言冂
沼	刀氵
襠	衤田
毗	田匕
慫	行人
懲	心行
炬	火コ
逞	王之
曖	日夂
簧	⺮廿
鰭	魚日
窘	穴口
赦	土攵
溯	屮月
斟	空其
匿	匚口
剔	日刂
癸	癶大
緞	糸殳
顱	虎頁
嘲	口月
噤	口示
弒	乂工
諭	言刂
謬	言习
甕	亠瓦
噩	王口
鬚	長頁
蟒	犬艹
偵	卜亻
攆	車扌
巔	山十
燮	又言
汲	又氵
筷	⺮大
輿	臼車
詭	言卩
滔	氵臼
姣	女乂
檸	丁木
硃	石𠂉
敝	巾攵
諮	言二
疹	疒彡
涕	氵亻
瑣	王貝
摹	手艹
棣	木尹
羚	羊龴
渤	力氵
蝨	空乙
墟	土丘
柿	巾木
綏	爪女
蹙	戊足
頑	一兀
氖	气㇆
膨	月士
琉	王川
酌	酉丶
榭	木身
鐺	金田
爍	火白
沅	兀氵
濠	豕氵
嬉	女士
殖	一且
眶	目王
稼	禾豕
咎	夂
絢	糸勹
莓	艹母
嘈	日曲
馥	夂禾
粹	米亠
祗	示氏
穢	禾癶
褂	衤卜
叟	臼又
墾	豸土
廓	广亠
弼	一弓
翡	非
偕	亻白
羲	羊丂
汾	刀八
藺	艹門
軾	車工
蛹	虫用
儷	亻鹿
籬	⺮亠
熨	尸火
犀	尸牛
摯	土手
冕	冖儿
褶	衤白
髻	長口
擂	扌雨
檬	豕木
嘶	口斤
昀	勹二
卹	丿皿
槌	木之
吮	口儿
芋	丁艹
萎	艹女
榻	习木
嗡	口习
漣	車氵
訟	言厶
燬	火殳
巒	言山
囑	口虫
篷	⺮之
聆	耳龴
騁	馬丂
嗑	口皿
稟	亠禾
漳	氵立
沱	宀匕
碌	石水
颱	風
燴	火亼
擄	扌虎
砰	石䒑
曙	日者
稽	禾日
簪	⺮七
偎	亻衤
敞	小攵
徙	止行
嬴	亡凡
祚	示卜
巽	巳
兢	儿十
觴	𠂊彡
纓	糸女
綻	宀糸
磺	八石
啜	又又
螢	虫火
壑	卜土
峨	山戈
濂	广氵
閨	門土
姊	女亻
驪	馬鹿
嘖	口丰
謁	言乚
讒	言𠂊
愉	心刂
溥	氵甫
緇	糸田
捨	亼扌
罔	冂亡
衙	口行
懇	豸心
厝	厂廿
勛	貝力
餃	食乂
桀	夕木
澎	氵士
宥	宀𠂇
頡	士頁
骸	骨人
彿	行川
煽	火习
澱	氵尸
檻	木皿
隕	阝貝
餉	食宀
惶	心王
輒	車乚
顰	止十
煦	火日
庇	广匕
芥	川艹
蝗	虫白
鱷	魚口
陋	阝乚
戮	习习
壤	土甘
揖	耳扌
攙	扌𠂊
愕	心丂
唧	口卩
詣	匕言
烽	火丰
慨	心艮
朦	月豕
粱	氵米
峙	山寸
征	行一
詰	士言
淒	女氵
庾	广臼
掖	丶扌
犢	牛士
逵	之土
秩	禾大
蕃	艹釆
塹	車斤
蛛	虫木
晦	日母
餿	又食
嫉	女矢
蓆	广艹
謨	大言
嗤	口屮
幌	巾兀
篆	⺮豕
傭	用亻
慚	心斤
怖	心巾
扈	户巴
嫡	女亠
磬	士石
鍥	金大
踝	足田
婢	女十
婿	女月
挽	扌儿
矗	十且
晰	日斤
鼬	臼由
揩	白扌
罈	午十
偃	亻女
濛	氵豕
銻	金亻
酪	酉夂
幔	巾又
渥	氵至
蔗	艹广
嗓	又口
籮	⺮隹
膛	月土
幟	巾戈
蛻	虫儿
剿	空巛
掣	牛手
蔬	艹㇕
俑	龴亻
腋	月丶
癒	疒亼
憫	心文
憊	亻廿
瀏	氵卯
羿	习艹
璜	王八
拄	王扌
誡	戈言
渙	氵𠂊
筵	⺮止
矜	予㇕
掬	扌米
纂	⺮糸
徊	行口
鰓	魚心
誨	言母
鬍	長月
嗽	口欠
悖	子心
耘	丰厶
銓	金人
鏽	金爿
鑾	言金
榴	木卯
蹺	足兀
伺	㇆亻
饑	食人
榛	丰禾
筏	戈⺮
銬	金丂
奐	𠂊大
癩	疒貝
淅	斤氵
澹	氵言
禱	示寸
辟	尸辛
姥	女者
欖	木見
譏	言幺
坷	土丁
靄	雨乚
顎	口頁
嶄	山斤
痢	疒刂
汰	丶氵
濯	习氵
萼	艹丂
楔	木丰
軻	車丁
輻	車田
煉	四火
甌	匚瓦
峭	山小
猥	犭田
惺	心生
締	糸亠
嘩	夫口
忿	八刀
孵	卯子
罄	士凵
髯	長土
贅	士方
魘	厂鬼
齲	齒厶
膈	月丁
寞	宀艹
櫓	木魚
畸	田大
匆	空勹
壕	土豕
涎	氵廴
闋	門大
耽	耳儿
菅	艹㠯
猩	犭生
詮	王言
疵	疒匕
遐	之尸
袂	衤㇕
霾	雨土
鉸	金乂
燎	火小
闔	門皿
殃	大一
遏	之乚
銼	土金
隘	阝皿
騾	馬糸
檜	亼木
稈	禾干
鵠	牛鳥
衢	行隹
譴	言㠯
泌	丿氵
礬	乂石
岷	山七
贍	貝言
俘	亻子
狩	犭寸
蠡	彑虫
殆	夕一
鬃	長示
晌	日宀
睫	目止
飭	食力
琍	王禾
蝠	虫田
鑣	金火
訛	言匕
靛	丰止
礪	石厶
氦	气人
膀	月方
瀆	四貝
姻	女大
繽	糸宀
鑒	臣金
贓	貝臣
耆	空者
拚	艹扌
籤	一⺮
夙	几夕
腑	月广
噙	冂厶
訖	言乙
潼	立氵
翌	习立
夔	䒑夂
鍬	金禾
舷	舟幺
鱔	魚羊
誑	言犭
氓	亡七
忱	心冖
閭	口門
媳	女自
蠹	一中
荐	艹子
庖	广巳
埂	土乂
賁	十貝
俟	矢亻
懾	心耳
汙	氵一
忝	大心
躡	足耳
喱	厂口
鴛	夕鳥
誣	人言
諍	言尹
怵	心丶
湍	氵而
輟	車又
僻	亻辛
鏃	金矢
鶉	亠鳥
羯	羊乚
拯	扌㇕
俸	亻夫
翱	白习
奠	八大
肱	月厶
瘧	疒一
邕	巛巴
茱	𠂉艹
梔	木巴
楹	皿木
僥	亻兀
倖	半亻
慍	心圍
礎	石木
鏜	金小
翩	户冂
祟	屮
殉	一夕
剋	十刂
皰	皮
苒	冂土
箔	⺮白
輦	空夫
氳	气皿
牒	片木
漩	氵方
玳	王弋
礫	石白
賄	貝月
涸	氵圍
攘	扌甘
歟	臼欠
鐲	金虫
剜	宀夕
苣	艹コ
芍	艹丶
菩	艹立
蠔	虫豕
仞	亻丶
冽	冫刂
鏗	金臣
亟	了
蘑	艹石
輾	車衤
顓	山而
鎔	金穴
鯽	魚卩
憬	心小
愀	心禾
湮	西氵
闡	門一
亙	二冫
撻	扌之
蒞	立艹
盹	目屮
脩	丨亻
謗	言方
盎	冂皿
灤	言氵
繕	糸羊
歿	一又
逕	之工
哮	口者
誥	牛言
狡	犭乂
蹶	足欠
蹋	足习
篡	厶⺮
鰻	魚又
恣	二心
矚	目虫
竣	立夂
悸	心子
煬	火彡
睨	目儿
倌	亻㠯
孺	子而
緝	糸耳
殮	人一
儼	耳攵
皎	白乂
瘓	疒大
癆	疒力
蜇	虫扌
橇	木毛
翳	匚习
崛	山凵
篁	王⺮
偌	𠂇口
諺	言立
庵	广申
隧	阝之
靨	厂目
蜈	大虫
冑	由
澧	氵曲
屜	尸乚
姒	女人
惰	心𠂇
懺	人心
蚤	空又
婊	女衤
斡	十十
韃	革羊
轅	車土
栩	木习
睞	目人
倏	亻犬
蕨	艹厂
藐	艹儿
酵	酉者
蛔	虫圍
匈	勹凵
醞	酉皿
唾	口二
惚	心勹
瑙	王乂
蜥	虫斤
蛀	虫王
螟	虫冖
黍	水禾
緘	糸戊
攣	言手
轂	殳士
佇	丁亻
鈐	金㇕
貉	豸夂
瀕	氵頁
妊	士女
櫛	木⺮
箴	⺮戊
飴	食厶
淙	示氵
嫦	女巾
賒	貝示
慷	心⺍
寥	宀彡
摑	圍扌
蔑	丶艹
砥	石一
迄	之乙
鴕	鳥
咫	尸八
搪	扌广
瞰	目攵
佗	宀亻
塾	亠土
旎	方匕
壅	乡亠
懦	心雨
繚	糸小
繹	糸半
藹	乚艹
爰	爪又
鏘	寸金
詼	言𠂇
騖	予馬
盂	丁皿
髦	長毛
萸	臼艹
卮	𠂆卩
詬	言𠂆
癥	疒攵
綵	爪糸
娓	女毛
蘚	艹羊
籟	⺮貝
榫	隹十
蹊	足爪
肴	乂月
諂	言臼
痿	疒女
湃	氵手
擻	扌婁
睪	四半
釁	臼刀
啻	八亠
旖	方口
姘	女䒑
稔	禾亼
詫	言宀
疚	疒丶
瀋	釆田
啾	火禾
崙	山艹
腱	月廴
鱸	魚皿
瘁	疒亠
漓	厶氵
闆	門口
迂	之一
菰	艹瓜
鐮	金广
洌	夕刂
袒	衤一
櫚	木門
囁	口耳
唳	口户
篙	亠⺮
氛	气
嬤	女幺
牘	片貝
膺	广亻
邏	之隹
琶	王巴
稷	禾田
簣	⺮中
痙	疒工
讖	言一
燻	火千
轡	口車
鞅	革大
骯	骨几
檳	木宀
匱	匚貝
踵	足二
罹	四心
臏	癶貝
懊	心大
瀰	氵乂
遽	之豕
陛	土阝
萄	艹凵
薜	辛艹
囈	二厶
崆	山工
銖	金木
獺	犭貝
芻	勹屮
惻	刂心
闈	門㐄
嫵	女火
璦	王爪
橢	工月
呎	口尸
蓀	丿糸
鮫	魚乂
瘴	疒立
憚	甲一
媼	女皿
絀	糸凵
笞	⺮厶
侮	亻母
胱	月兀
麴	木米
鑠	金白
悴	心亠
梆	丰木
乩	卜乚
呶	又女
賂	貝夂
淄	氵巛
逅	之𠂆
菽	艹上
苧	丁宀
蟆	虫大
鼾	空自
猷	八犬
葩	艹巴
倨	亻尸
餒	食女
溉	儿氵
赭	土者
桅	木卩
嚀	皿丁
慟	心力
砧	石卜
蟀	虫艹
惕	彡心
惘	心亡
惦	心广
窠	穴木
裨	衤十
贗	厂貝
蜓	虫士
褻	衣丸
袞	衣八
懍	亠心
蚩	空屮
殯	一貝
榷	冖木
窈	穴力
豉	又一
劾	亠力
憧	心立
孿	子言
荏	士艹
榔	木阝
燧	火豕
遑	之白
嗇	土人
駢	馬䒑
藪	艹婁
噥	口辰
嗥	十大
颼	空風
砭	石之
蟑	虫十
蚓	虫丨
憩	舌
臚	月皿
紉	丶糸
鞣	革木
饜	厂食
嘗	小日
牯	牛十
囪	囟丶
鷂	爪鳥
麝	鹿寸
沌	氵屮
婀	阝女
瑁	王目
齷	齒至
喋	廿口
悽	心一
驀	大馬
囀	厶寸
骷	骨十
爨	臼火
羸	亡口
攫	扌目
齜	齒匕
秣	木禾
僭	亻七
樅	木行
儔	士亻
羶	羊一
閡	門人
譬	尸言
摒	尸扌
齬	齒口
瞑	目八
穡	土禾
璩	王豕
豺	豸亻
獐	犭十
琺	王氵
俎	人且
肫	月屮
彗	丰彐
鞦	革火
躉	艹足
泱	冂氵
鴆	鳥冖
帚	空彐
茁	艹屮
檄	木攵
竽	⺮丁
咨	二口
逖	之犭
羋	丨
靼	革一
吩	刀口
佞	二亻
諉	言女
瘍	疒日
闐	門八
縊	糸皿
戛	一自
璣	王人
蚪	虫冫
吒	口七
倥	亻穴
猓	犭木
褥	衤寸
孀	女雨
菠	艹皮
跚	足一
牖	片甫
徨	行白
阱	阝川
皴	厶皮
黜	四凵
兗	儿亠
磋	石工
鄹	耳阝
彫	周土
紜	糸厶
鏍	金糸
滓	氵辛
槨	子阝
踴	足力
驃	馬示
恫	冂心
憔	隹心
雹	雨巳
橄	攵耳
皚	白䒑
揆	癶扌
碉	石口
譎	言予
奘	爿大
疙	疒乙
湔	月刂
潺	尸氵
覲	廿見
劬	勹力
恿	空龴
坍	土周
曷	日乚
侈	夕亻
鰍	魚火
惆	心周
邐	之鹿
鸚	貝鳥
蚵	虫丁
蛄	十虫
蠣	虫厶
屐	尸又
瞽	士目
氤	气大
臆	月立
徇	行日
腆	月八
遨	之士
駑	女馬
匏	大巳
尷	空尤
蝴	虫月
鴦	冂鳥
峰	空山
飩	食屮
餾	食田
獰	犭丁
詁	十言
惴	心而
窕	穴儿
鼙	士十
鴣	十鳥
蕈	艹西
楫	耳木
咄	凵口
骼	骨口
饅	食又
餛	食匕
麾	广毛
瑚	王月
琿	王車
蜘	虫口
鈸	金犬
鰱	魚車
粳	米乂
麩	夂夫
歙	亼欠
諄	言子
媲	女囟
繅	糸巛
盍	皿土
飪	食士
胭	月圍
謄	月半
悻	心半
朮	十丶
琵	王匕
拮	士扌
頷	亼㇕
悌	弓亻
妣	匕女
圾	土又
柞	𠂉木
跆	足厶
鏑	金亠
滂	方氵
嫘	田女
皈	白又
奩	大匚
獗	犭欠
愴	心人
抉	大扌
柩	木丶
螳	虫小
咆	口巳
翕	习亼
夤	夕八
醺	酉火
喟	田月
咐	寸口
甥	生
篾	⺮丶
裟	衣氵
媾	甘女
霹	雨辛
蚣	虫八
跎	足匕
嶝	山癶
霑	雨氵
犧	牛丂
蚱	虫卜
罟	十四
磴	石癶
臃	月隹
愎	夂心
軛	車卩
霎	雨女
蜿	虫卩
簸	⺮皮
惋	心卩
泅	圍氵
靂	雨止
兕	圍儿
鄱	釆阝
賃	丿亻
墀	土牛
挈	丰手
蟯	虫兀
狷	月犭
縲	糸糸
瓠	大瓜
蠕	虫而
蹼	羊足
儐	貝癶
鈽	金𠂇
詆	言氏
鬲	一丁
螫	土虫
酩	酉夕
戢	耳口
躂	足羊
刎	勹彡
簑	⺮衣
颺	風彡
膾	月亼
擘	尸手
綞	糸二
縑	糸八
鵡	一鳥
餞	戈食
剽	西刂
枇	匕木
砝	石土
蟈	圍虫
愜	心匚
枸	木勹
瘩	疒艹
疥	疒川
迢	之刀
畚	厶田
梃	木廴
櫝	艹貝
嶇	山匚
幗	巾一
鴒	亼龴
愾	心米
紇	糸乙
坼	土丶
嫗	女匚
鬨	空鬥
莠	艹㇆
螂	虫阝
暹	隹之
佾	八月
胳	夂月
瘠	疒月
颶	風八
鷥	糸鳥
慄	心西
黠	四口
毽	空毛
猖	犭日
孱	尸子
瞠	土目
覬	山見
侏	亻𠂉
蓿	艹宀
戡	其戈
蜻	月虫
鍰	金爪
痊	疒王
洶	凵氵
隍	阝王
噱	豕口
黝	四力
缽	午一
蹉	足工
鰥	魚水
漯	糸氵
貲	止貝
鐃	金兀
鷓	广廿
糢	米艹
萋	女尹
鯧	日魚
邂	牛之
岌	山又
舨	舟厂
赧	又土
幛	巾十
剴	山刂
玷	王卜
嚅	口雨
箝	⺮甘
佝	亻勹
傯	囟亻
髭	長匕
匐	勹田
陲	阝二
嚏	口止
佻	亻⺍
盥	臼皿
仳	匕匕
袈	力衣
耜	丰㠯
胴	月冂
壢	土厂
鵪	大鳥
犖	火牛
蹂	足予
猙	犭尹
袱	衤犬
遴	之米
紼	糸川
駙	馬寸
鏝	又金
嗾	口方
妁	女丶
捩	扌犬
豌	一卩
躊	足士
帑	巾女
瞌	目皿
濘	丁氵
懣	心氵
抨	扌丁
蝌	虫禾
淆	乂氵
酗	酉凵
伉	亻几
貊	豸白
賅	貝人
睽	目大
吁	丁一
犒	牛亠
癘	疒厶
娩	女儿
睥	目十
祆	示大
螃	虫方
獷	犭八
蟋	虫心
鱖	魚欠
陴	阝囟
犛	二牛
軔	車丶
靦	㇕見
埤	土囟
琊	王牙
躇	足者
儡	田亻
圬	丂土
覦	亼見
霪	士雨
玀	犭隹
遘	之甘
慝	匚心
紕	糸匕
躅	足虫
肄	匕二
蜴	虫彡
鰾	魚示
蝙	虫户
褫	衤虎
籐	⺮水
襤	衤皿
怏	心冂
蜢	虫皿
褓	衤亻
崁	欠山
孳	䒑子
鮪	魚月
黷	貝四
燐	火㐄
簷	⺮言
鼴	臼女
蹣	足人
躑	足阝
啕	口凵
輜	車巛
韁	革田
轔	車㐄
溘	厶皿
躪	足艹
撚	扌䏑
踟	足矢
嫻	女門
荸	冖子
嚥	口廿
谿	爪口
塭	土皿
跼	足尸
犄	牛口
勗	日力
篛	⺮冫
聱	士耳
鉋	金巳
綑	糸木
瞇	目米
祐	示𠂇
痺	疒十
証	止言
踫	足业
痴	疒口
珮	王巾
痲	疒儿
虱	乙虫
倣	方亻
抬	扌厶
韆	革卩
瑯	王阝
瘉	刂疒
徬	行方
鼇	士黽
櫂	隹习
搾	扌穴
偺	卜日
濬	卜氵
嚮	乡口
蘗	辛木
啣	口午
貍	豸田
勦	巛力
梱	木圍
霉	雨母
燄	𠂊臼
鼕	士冫
囌	口禾
慇	𠂆心
嬝	女衣
