𧘇	衤
向	宀
𠀉	臼
虛	虎丘
及	刀又
𠁁	卯亞
丆	㇕
丷	八
𡗗	丰
キ	夫
𠁼	⺍
𣥂	癶
肉	䏑
韋	㐄
灬	火
忄	心
乑	亻
于	丁一
才	一亻
乎	爪丁
𢎨	弓亻
弔	丨弓
乃	刀㇆
平	丁䒑
夹	大䒑
典	冊廾
缶	午凵
鼠	臼巛⺍
真	十目𠔀
眞	匕目乚八
具	目𠔀
兵	斤𠔀
共	艹𠔀
吳	口乚大
吴	口一大
呉	口乚𠔀
兴	⺍𠔀
丣	一卯
與	臼一乚丨𠔀
𠔀	廾
丌	廾
氘	刂
飛	乙冫丿刂乙冫
弗	弓刂
井	二刂
𠂢	亻
兜	白匚コ儿
乐	𠂆木
亥	亠丩人
发	丿犬㇕
鬥	刂王王
老	耂匕
考	耂丂
孝	耂子
者	耂
丹	冊丶
册	冊
⺮	竹
个	竹
亇	竹
尔	竹八
失	手丶
片	爿
