的	白勹丶
了	了
我	手戈
是	日一止
在	大丨土
你	亻⺈小
和	禾口
有	大月
不	不
就	亠口小尤
都	者阝
也	也
要	西女
吧	口巴
好	女子
他	亻也
去	土厶
到	至刂
上	上
那	刀二阝
人	人
看	手目
中	中
呢	口尸匕
她	女也
等	⺮土寸
用	用
把	扌巴
下	一卜
恩	因大心
能	厶月匕匕
很	行艮
多	夕夕
做	亻十口攵
想	木目心
被	衤皮
地	土也
而	而
一	一
又	又
再	一冂土
但	亻日一
打	扌丁
大	大
年	矢㐄
啦	口扌立
以	厶人
着	羊目
小	小
得	行日一寸
先	牛儿
啊	口阝丁口
或	戈口一
呀	口牙
找	扌戈
新	立木斤
及	㇆人
跟	足艮
太	大丶
嘛	口广木木
日	日
才	寸丿
可	丁口
比	匕匕
玩	王二儿
最	日耳又
月	月
真	十且八
吃	口矢乙
它	宀匕
其	其
叫	口凵
出	凵山
哈	口人一口
向	自口
家	宀豕
之	之
更	一日乂
走	走
快	忄㇕大
前	䒑月刂
由	由
高	亠口冂口
您	亻⺈小心
加	力口
所	斤㇕斤
天	一大
已	己
里	甲二
啥	口人舌
老	者匕
搞	扌亠口冂口
行	行
事	寸口彐
拿	人一口手
如	女口
死	一夕匕
像	亻⺈口豕
使	亻大口丶
成	戊㇆
只	口八
哪	口刀二阝
回	因口
少	小丿
元	二儿
卡	上卜
靠	牛口非
算	⺮目艹
者	者
忙	忄亡
起	走己
各	夂口
分	八刀
水	水
改	己攵
唉	口厶矢
三	三
放	方攵
全	人王
按	扌宀女
早	日十
拉	扌立
弄	王艹
本	木一
偶	亻日冂厶
性	忄生
第	⺮弓亻
完	宀二儿
同	冂一口
花	艹亻匕
怕	忄白
女	女
些	止匕二
住	亻丶王
名	夕口
跑	足勹巳
次	冫欠
睡	目千艹二
哦	口手戈
挺	扌廴丿士
王	王
掉	扌卜日十
路	足夂口
正	一止
外	夕卜
二	二
生	生
心	心
因	因大
子	子
作	亻矢卜
送	之䒑大
每	矢母
法	氵土厶
乖	千丬匕
拍	扌白
市	亠巾
撒	扌廿月攵
至	至
接	扌立女
美	羊大
表	丰𧘇
未	二小
非	非
即	艮冂
哎	口艹乂
此	止匕
差	羊工
版	片斤又
副	一口田刂
系	丿絲
收	凵攵
男	田力
俺	亻大日乚
字	宀子
股	月殳
便	亻一日乂
考	者了
手	手
道	之䒑自
米	米
座	广人人土
聊	耳氏冂
取	耳又
低	亻氏丶
哇	口土土
受	爪冖又
包	勹巳
阿	阝丁口
喝	口日勹人乚
白	白
金	金
四	四
近	之斤
管	⺮宀㠯
定	宀一止
交	亠八乂
李	木子
笑	⺮丿大
自	自
型	一艹刂土
黑	四二灬
慢	忄日四又
刷	尸巾刂
穿	穴牙
越	走戈乚
位	亻立
部	立口阝
站	立卜口
牛	牛
怪	忄又土
省	小丿目
倒	亻至刂
曾	丷四日
累	田絲
汗	氵一十
查	木日一
象	⺈口豕
半	半
格	木夂口
五	工㇕
方	方
某	甘木
海	氵矢母
相	木目
光	小尤
咋	口矢卜
且	且
林	木木
化	亻匕
班	王刂王
滴	氵亠丷冂十口
店	广卜口
安	宀女
坐	人人土
度	广廿又
俄	亻手戈
歌	丁口丁口欠
信	亻言
若	艹大口
原	厂白小
文	文
晚	日⺈口儿
量	日一甲二
村	木寸
式	弋工
空	穴工
山	山
毛	毛
重	千日二
主	丶王
另	口力
入	人
伐	亻戈
血	丿皿
爽	大乂乂乂乂
往	行丶王
片	片
狗	犭勹口
共	廿八
西	西
周	冂土口
超	走刀口
明	日月
均	土勹冫
期	其月
照	日刀口灬
切	七刀
留	氏丶刀田
特	牛土寸
神	礻申
教	者子攵
哥	丁口丁口
甘	甘
值	亻十且
么	丿厶
陪	阝立口
既	艮七儿
哭	口口大丶
力	力
建	廴彐二
洗	氵牛儿
懂	忄艹千日二
口	口
指	扌匕日
球	王寸氵丶
仍	亻㇆丿
活	氵舌
跌	足牛人
清	氵丰月
提	扌日一止
除	阝人禾
通	之又用
酒	氵酉
票	西示
六	亠八
病	疒
假	亻㇕卜㇕又
久	⺈丶
段	亻三殳
平	丁䒑
抓	扌爪
套	大長
急	⺈彐心
城	土戊㇆
任	亻丿士
草	艹日十
理	王甲二
令	人之
雨	雨
唱	口日日
左	大工
常	小冖口巾
色	⺈巴
菜	艹爪木
集	隹木
感	戊一口心
房	户方
混	氵日匕匕
敢	㇕耳攵
火	火
操	扌口口口木
南	十冂半
退	之艮
件	亻牛
破	石皮
德	行十四一心
雪	雨彐
局	尸㇆口
整	木口攵一止
傻	亻鬼乂八夂
克	十口儿
喊	口戊一口
跳	足氵儿
沈	氵冖儿
反	斤又
篇	⺮户冂艹
待	行土寸
砸	石匚巾
深	氵冖八木
根	木艮
求	寸氵丶
投	扌殳
款	士示欠
知	矢口
八	八
配	酉己
器	口口大丶口口
何	亻丁口
率	亠幺氵十
鬼	鬼
修	亻丨夂彡
面	石因卜丨
北	丬匕
木	木
份	亻八刀
情	忄丰月
肉	冂人人
需	雨而
七	七
流	氵亠厶川
招	扌刀口
痛	疒又用
列	一夕刂
石	石
香	禾日
封	土土寸
眼	目艮
易	日勹彡
冷	冫人之
借	亻廿日
派	氵斤氏
付	亻寸
十	十
油	氵由
胡	十口月
排	扌非
停	亻亠口冖丁
合	人一口
身	身
章	立日十
科	禾冫十
星	日生
牌	片鬼十
翻	釆田习习
帖	巾卜口
商	亠丷冂八口
物	牛勹彡
泡	氵勹巳
玉	王丶
追	之丿㠯
背	丬匕月
解	⺈用刀牛
室	宀至
底	广氏丶
代	亻弋
朱	牛小
亦	亠川八
乾	十日十矢乙
工	工
咱	口自
刀	刀
波	氵皮
推	扌隹
落	艹氵夂口
春	春
笨	⺮木一
九	九
江	氵工
短	矢一口䒑
含	人丶㇕口
千	千
炒	火小丿
藉	艹三小廿日
丫	丷丨
徐	行人禾
秒	禾小丿
青	丰月
耍	而女
夜	亠亻夂丶
吹	口欠
板	木斤又
土	土
姐	女且
直	十且
公	八厶
苦	艹十口
秀	禾㇆丿
博	十甫寸
皮	皮
朝	十日十月
君	尹口
利	禾刂
素	丰絲
立	立
存	大丨子
吾	一韋口
民	巳七
命	人一口冂
忘	亡心
茶	艹人木
冰	冫水
供	亻廿八
案	宀女木
田	田
初	衤刀
品	口口口
抽	扌由
造	之牛口
抱	扌勹巳
野	甲二又㇕丨
胖	月半
故	十口攵
服	月冂又
百	一白
兵	丘八
英	艹冂大
般	舟殳
演	氵宀一由八
嘴	口止匕⺈用
填	土十且八
果	日木
保	亻口木
唐	广彐口
夏	一自夂
莫	艹日大
硬	石一日乂
寒	宀甘八冫
挖	扌穴乙
凡	凡
言	言
防	阝方
街	行土土
距	足匚㇕
挑	扌氵儿
欲	八人口欠
竟	立日儿
源	氵厂白小
官	宀㠯
寄	宀大丁口
古	十口
首	䒑自
思	田心
郭	亠口子阝
亮	亠口冖几
干	一十
粉	米八刀
爆	火日廿八水
戴	土田廿八戈
然	夕大丶灬
疼	疒夂冫
雷	雨田
港	氵廿八巳
租	禾且
狼	犭丶艮
狂	犭王
布	大巾
引	弓丨
捏	扌日土
佛	亻弓川
食	食
船	舟几口
今	人丶㇕
恨	忄艮
宋	宀木
猛	犭子皿
客	宀夂口
友	大又
句	勹口
斯	其斤
沙	氵小丿
哼	口亠口了
望	亡月王
腿	月之艮
丁	丁
祝	礻口儿
界	田八川
抗	扌亠几
步	止小
河	氵丁口
缺	牛山㇕大
尚	小冂口
似	亻厶人
羊	羊
福	礻一口田
必	心丿
遭	之艹日日
否	不口
端	立山而
猜	犭丰月
伊	亻尹
秦	春禾
秋	禾火
毒	丰母
架	力口木
熊	厶月匕匕灬
持	扌土寸
插	扌千臼
折	扌斤
意	立日心
呆	口木
基	其土
困	因木
圈	因半巳
迷	之米
踢	足日勹彡
史	口乂
甲	甲
呵	口丁口
搬	扌舟殳
乃	㇆丿
右	大口
塔	土艹人一口
拖	扌矢也
摸	扌艹日大
院	阝宀二儿
散	廿月攵
松	木人厶
爸	八乂巴
喜	士口䒑口
洋	氵羊
呈	口王
治	氵厶口
降	阝夂㐄
富	宀一口田
姓	女生
料	米冫十
咬	口亠八乂
梅	木矢母
批	扌匕匕
足	足
爬	爪巴
醒	酉日生
狠	犭艮
逛	之犭王
精	米丰月
瘦	疒臼丨又
踩	足釆
偷	亻人一月刂
支	十又
杜	木土
鞋	革土土
展	尸艹展
咧	口一夕刂
依	亻亠𧘇
倍	亻立口
康	广彐氵
堂	小冖口土
救	寸氵丶攵
音	立日
世	廿乚
著	艹者
仲	亻中
舞	矢廿夕㐄
守	宀寸
露	雨足夂口
冒	日目
弱	弓冫弓冫
影	日亠口小彡
州	⺍川
替	夫夫日
逼	之一口田
曲	日刂
牙	牙
箱	⺮木目
遍	之户冂艹
巴	巴
武	一弋止
湖	氵十口月
程	禾口王
柳	木氏丿冂
偏	亻户冂艹
印	氏一冂
味	口二小
零	雨人之
角	⺈用
紫	止匕絲
勒	革力
熟	亠口子丸灬
孔	子乚
寸	寸
厚	厂日子
答	⺮人一口
社	礻土
兼	䒑彐刂八
娘	女丶艮
登	癶一口䒑
微	行山一几攵
佳	亻土土
瞭	目人丷日小
雅	牙隹
魔	广木木鬼
司	㇆一口
志	士心
奇	大丁口
瓦	一乚㇆丶
居	尸十口
盛	戊㇆皿
奶	女㇆丿
虎	虎
后	斤一口
洞	氵冂一口
台	厶口
形	一艹彡
川	川
充	亠厶儿
害	宀丰口
喂	口田展
免	⺈口儿
景	日亠口小
曹	艹日日
煮	者灬
良	丶艮
蛋	㇕止虫
吐	口土
肥	月巴
仙	亻山
碰	石䒑业
酸	酉厶八夂
侯	亻㇕矢
塞	宀甘八土
欠	欠
擦	扌宀夗示
藏	艹戈爿臣
皆	匕匕白
屁	尸匕匕
永	丶水
夫	夫
琴	王王人丶㇕
宏	宀大厶
例	亻一夕刂
砍	石欠
兄	口儿
善	羊䒑口
增	土丷四日
施	方矢也
暗	日立日
忍	刀丶心
肯	止月
母	母
艾	艹乂
致	至攵
宗	宀示
麻	广木木
怒	女又心
扔	扌㇆丿
游	氵方矢子
腰	月西女
嫩	女木口攵
肖	小月
罪	四非
仔	亻子
丑	㇕十
敏	矢母攵
棒	木春工
臭	自大丶
拆	扌斤丶
蔡	艹夗示
校	木亠八乂
氏	氏
糖	米广彐口
吉	士口
押	扌甲
吵	口小丿
谷	八人口
衣	亠𧘇
宇	宀一寸
末	一木
潘	氵釆田
告	牛口
旁	亠丷冖方
耐	而寸
董	艹千日二
榜	木亠丷冖方
醉	酉亠人人十
妹	女二小
宜	宀且
尼	尸匕
灰	大火
屋	尸至
楚	木木㇕止
丹	冂亠
乘	丿木丬匕
刻	亠乡人刂
俊	亻厶八夂
芳	艹方
抄	扌小丿
酷	酉牛口
京	亠口小
返	之斤又
瑞	王山而
仁	亻二
添	氵一大忄
催	亻山隹
具	且八
威	戊一女
核	木亠乡人
瓶	䒑艹一乚㇆丶
犯	犭巳
族	方矢矢
季	禾子
骨	骨
嘿	口四二灬
黎	禾勹丿人水
密	宀心丿山
士	士
炸	火矢卜
洪	氵廿八
容	穴人口
射	身寸
智	矢口日
索	十冖絲
聚	耳又豕
拼	扌䒑艹
燕	廿口丬匕灬
撞	扌立甲二
膜	月艹日大
普	䒑业日
竹	⺮
魏	禾女鬼
范	艹氵巳
搭	扌艹人一口
袁	土口𧘇
扯	扌止
彭	士口䒑彡
薄	艹氵甫寸
曰	因一
胃	田月
堆	土隹
赴	走卜
躲	身几木
孟	子皿
抵	扌氏丶
甜	舌甘
彩	爪木彡
甚	其乚
粗	米且
申	申
念	人丶㇕心
惹	艹大口心
盒	人一口皿
逃	之氵儿
嘉	士口䒑力口
升	丿艹
姚	女氵儿
休	亻木
症	疒一止
斤	斤
功	工力
喇	口木口刂
浪	氵丶艮
扣	扌口
泰	春水
忠	中心
梁	氵刀八木
吸	口㇆人
跨	足大一了
森	木木木
瞎	目宀丰口
卷	半巳
于	一寸
井	二川
蛇	虫宀匕
寺	土寸
屏	尸䒑艹
灌	氵艹口口隹
埋	土甲二
略	田夂口
目	目
蒙	艹冖一豕
托	扌丿七
巧	工了
淡	氵火火
拜	手一丰
冬	夂冫
娜	女刀二阝
池	氵也
敲	亠口冂口卜又
愁	禾火心
勇	又用力
泥	氵尸匕
昏	氏日
遇	之日冂厶
巨	匚㇕
怎	矢卜心
磨	广木木石
呼	口丿丷寸
液	氵亠亻夂
泉	白水
嫁	女宀豕
汪	氵王
稍	禾小月
薛	艹丿㠯辛
豆	一口䒑
旺	日王
攻	工攵
祥	礻羊
委	禾女
佐	亻大工
隔	阝一口冂丷丁
崔	山隹
碗	石宀夗
吻	口勹彡
健	亻廴彐二
速	之木口
失	牛人
雄	大厶隹
胸	月勹乂凵
框	木匚王
暴	日廿八水
娃	女土土
唯	口隹
漏	氵尸雨
拔	扌大又丶
洛	氵夂口
探	扌冖八木
碟	石廿乚木
郎	丶艮阝
珠	王牛小
尿	尸水
透	之禾㇆丿
惠	車心
府	广亻寸
菲	艹非
叼	口㇆一
父	八乂
耳	耳
窗	穴鬼夂
搜	扌臼丨又
希	乂大巾
患	口中心
尾	尸毛
播	扌釆田
岩	山石
逗	之一口䒑
限	阝艮
帝	亠丷冖巾
昌	日日
模	木艹日大
扁	户冂艹
舒	人舌又㇕丨
嫌	女䒑彐刂八
陶	阝勹牛山
苗	艹田
剪	䒑月刂刀
羽	习习
哩	口甲二
稿	禾亠口冂口
邦	丰阝
玲	王人之
坑	土亠几
袋	亻弋亠𧘇
趁	走人彡
妖	女丿大
甩	月乚
琳	王木木
乙	乙
伴	亻半
尊	丷酉寸
熬	丰力攵灬
吊	口巾
霜	雨木目
沿	氵几口
伯	亻白
浩	氵牛口
剩	禾丬匕刂
域	土戈口一
祖	礻且
肺	月一巾
附	阝亻寸
制	牛巾刂
玄	亠幺
置	四十且
豪	亠口冖豕
助	且力
幽	幺幺山
欣	斤欠
辣	辛木口
煤	火甘木
瓜	瓜
慧	丰丰彐心
墨	四二灬土
娶	耳又女
犬	大丶
炎	火火
震	雨辰
遂	之丷豕
斌	文一弋止
控	扌穴工
覆	西行矢日夂
趟	走小冂口
禁	木木示
烤	火者了
童	立甲二
杯	木不
晴	日丰月
魂	二厶鬼
益	䒑八皿
庭	广廴丿士
肝	月一十
坊	土方
晨	日辰
振	扌辰
割	宀丰口刂
消	氵小月
兆	氵儿
隆	阝夂一生
撤	扌亠厶月攵
粥	弓米弓
馨	士尸殳禾日
滑	氵骨
曼	日四又
暖	日爪一大又
己	己
止	止
柱	木丶王
妻	一彐女
盾	斤十目
奔	大十艹
政	一止攵
爹	八乂夕夕
刺	木冂刂
冠	冖二儿寸
躺	身小冂口
舍	人舌
售	隹口
婚	女氏日
兔	⺈口儿丶
敬	艹勹口攵
潮	氵十日十月
昂	日氏冂
咳	口亠乡人
邪	牙阝
促	亻足
鼠	臼巛
葛	艹日勹人乚
串	口中
桑	又又又木
苑	艹夗
迎	之氏冂
弓	弓
碎	石亠人人十
余	人禾
承	㇕水三
迪	之由
臣	臣
勤	廿口丰力
摔	扌亠幺氵十
蒸	艹㇕水一灬
凌	冫土八夂
辛	辛
旗	方矢其
妙	女小丿
始	女厶口
符	⺮亻寸
亭	亠口冖丁
吼	口子乚
云	二厶
研	石一艹
咪	口米
俗	亻八人口
珍	王人彡
卓	卜日十
捧	扌春工
舔	舌一大忄
愈	人一月刂心
溪	氵爪幺大
歪	不一止
晃	日小尤
斜	人禾冫十
尤	尤
洲	氵⺍川
乎	丿丷寸
湘	氵木目
翔	羊习习
枝	木十又
逸	之⺈口儿丶
哄	口廿八
餐	卜夕又食
染	氵九木
粘	米卜口
炮	火勹巳
桌	卜日木
芬	艹八刀
萍	艹氵一䒑
晶	日日日
勾	勹厶
戒	戈艹
桂	木土土
朗	丶艮月
堵	土者
矣	厶矢
捐	扌口月
荷	艹亻丁口
棉	木白巾
私	禾厶
姜	羊女
鼓	士口䒑十又
霞	雨㇕卜㇕又
瞧	目隹灬
皇	白王
企	人止
互	一彑
沉	氵冖几
箭	⺮䒑月刂
柏	木白
焦	隹灬
憋	水冂攵心
盟	日月皿
延	廴丿止
柔	又㇕亻木
粒	米立
盆	八刀皿
眉	尸目
碧	王白石
籍	⺮三小廿日
刮	舌刂
勿	勹彡
坤	土申
汁	氵十
浴	氵八人口
翼	习习田廿八
哲	扌斤口
涵	氵㇕水凵
菌	艹因禾
桶	木又用
抹	扌一木
判	半刂
弟	丷弓亻
傅	亻甫寸
衰	亠日𧘇
叔	上小又
肩	户月
殿	尸廿八殳
番	釆田
怡	忄厶口
旭	九日
航	舟亠几
妮	女尸匕
坡	土皮
旅	方矢氏
赤	土川八
技	扌十又
摘	扌亠丷冂十口
翠	习习亠人人十
孝	者子
移	禾夕夕
予	又㇕丨
岳	丘山
屎	尸米
融	一口冂丷丁虫
棋	木其
扶	扌夫
介	人川
渡	氵广廿又
芯	艹心
采	爪木
乳	爪子乚
拳	半手
薇	艹行山一几攵
淫	氵爪丿士
拽	扌日乚丿
宅	宀丿七
掌	小冖口手
培	土立口
莉	艹禾刂
盼	目八刀
握	扌尸至
截	土隹戈
孤	子瓜
什	亻十
宣	宀二日
尖	小大
醋	酉廿日
朵	几木
穆	禾白小彡
啃	口止月
耗	三小毛
息	自心
伍	亻工㇕
塘	土广彐口
逢	之夂丰
桃	木氵儿
壁	尸口辛土
霍	雨隹
漆	氵木人水
虹	虫工
丸	丸
券	半刀
俱	亻且八
菊	艹勹米
奴	女又
岸	山厂一十
凝	冫匕矢又㇕止
芝	艹之
烈	一夕刂灬
矮	矢禾女
婆	氵皮女
蝶	虫廿乚木
枕	木冖儿
避	之尸口辛
帕	巾白
浮	氵爪子
盈	㇆丿又皿
枚	木攵
材	木寸丿
扎	扌乚
翁	八厶习习
幻	幺㇆
衫	衤彡
杆	木一十
固	因十口
耀	小尤习习隹
槽	木艹日日
穴	穴
幅	巾一口田
伸	亻申
悲	非心
殷	斤彐㇆殳
萌	艹日月
斑	王文王
澡	氵口口口木
屈	尸凵山
娟	女口月
怨	夗心
恐	工凡心
柴	止匕木
逆	之䒑凵
渣	氵木日一
熙	臣巳灬
抖	扌冫十
忽	勹彡心
津	氵彐二
胎	月厶口
准	冫隹
摩	广木木手
漫	氵日四又
溜	氵氏刀田
扇	户习习
堡	亻口木土
淘	氵勹牛山
墓	艹日大土
鹿	鹿
彬	木木彡
蹭	足丷四日
卿	氏丿艮冂
函	㇕水凵
奈	大示
茂	艹戊
肌	月几
映	日冂大
鼻	自田一川
泵	石水
育	亠厶月
澳	氵自米大
候	亻丨㇕矢
种	禾中
邀	之白方攵
佩	亻几一巾
策	⺮木冂
藤	艹月半水
仿	亻方
磊	石石石
雁	厂亻隹
窄	穴矢卜
昨	日矢卜
戈	戈
爪	爪
癌	疒口口口山
效	亠八乂攵
拷	扌者了
猴	犭亻㇕矢
掏	扌勹牛山
汝	氵女
撮	扌日耳又
幸	土半
揉	扌又㇕亻木
舟	舟
盯	目丁
蜜	宀心丿虫
漂	氵西示
序	广又㇕丨
巷	廿八巳
梨	禾刂木
舌	舌
蒂	艹亠丷冖巾
腹	月矢日夂
蟹	⺈用刀牛虫
陷	阝⺈臼
捉	扌足
疑	匕矢又㇕止
鼎	目爿片
慌	忄艹亡川
瘤	疒氏刀田
彼	行皮
辰	辰
忌	己心
踏	足水日
捷	扌一彐止
罐	牛山艹口口隹
伏	亻大丶
默	四二灬大丶
赫	土川八土川八
杰	木灬
孩	子亠乡人
咖	口力口
悟	忄工㇕口
帽	巾日目
幼	幺力
旋	方矢㇕止
壹	士冖一口䒑
霸	雨革月
席	广廿巾
叉	又丶
妃	女己
典	冂廿八
儒	亻雨而
裸	衤日木
奉	春工
御	行牛止冂
腔	月穴工
突	穴大丶
刑	一艹刂
痕	疒艮
午	矢十
蕾	艹雨田
宰	宀辛
囊	一中冖口口甘𧘇
弘	弓厶
境	土立日儿
拒	扌匚㇕
毅	立豕殳
煎	䒑月刂灬
弦	弓亠幺
渝	氵人一月刂
罩	四卜日十
蓉	艹穴人口
卵	氏丿丶冂丶
尺	尸丶
逾	之人一月刂
垂	千艹二
惜	忄廿日
浦	氵甫
警	艹勹口攵言
扛	扌工
氧	气羊
揭	扌日勹人乚
逐	之豕
昭	日刀口
宿	宀亻一白
裂	一夕刂亠𧘇
僧	亻丷四日
裙	衤尹口
彪	虎彡
淋	氵木木
束	木口
牢	宀牛
揍	扌春一大
劫	土厶力
拓	扌石
扮	扌八刀
喻	口人一月刂
律	行彐二
株	木牛小
砂	石小丿
埃	土厶矢
斗	冫十
坪	土一䒑
仇	亻九
吞	一大口
亡	亡
沾	氵卜口
牧	牛攵
兜	白氏㇕儿
寨	宀甘八木
掐	扌⺈臼
稀	禾乂大巾
恰	忄人一口
棍	木日匕匕
淑	氵上小又
慕	艹日大忄
歇	日勹人乚欠
疏	㇕止亠厶川
膏	亠口冖口月
陵	阝土八夂
姆	女母
碳	石山大火
廷	廴丿士
糊	米十口月
蚊	虫文
祭	夗示
拾	扌人一口
朋	月月
媚	女尸目
吟	口人丶㇕
筒	⺮冂一口
丘	丘
趴	足八
繁	矢母攵絲
坦	土日一
穗	禾車心
屯	七凵
虐	虎匚
蹲	足丷酉寸
惟	忄隹
幕	艹日大巾
扒	扌八
搓	扌羊工
遮	之广廿灬
庚	广彐人
哉	土口戈
涉	氵止小
臂	尸口辛月
敷	甫方攵
丙	一冂人
署	四者
示	示
夕	夕
趣	走耳又
渠	氵匚㇕木
杭	木亠几
疾	疒矢
崇	山宀示
裕	衤八人口
挪	扌刀二阝
荒	艹亡川
筋	⺮月力
孕	㇆丿子
撕	扌其斤
戳	习习隹戈
帆	巾凡
阻	阝且
享	亠口子
棚	木月月
傲	亻丰力攵
蹦	足山月月
焊	火日一十
召	刀口
徒	行走
脂	月匕日
几	几
艘	舟臼丨又
靖	立丰月
奏	春一大
咒	口口几
盲	亡目
姿	冫欠女
炫	火亠幺
坎	土欠
拌	扌半
缸	牛山工
弗	弓川
狐	犭瓜
栽	土木戈
硅	石土土
述	之木丶
泛	氵丿之
甫	甫
佑	亻大口
卦	土土卜
耿	耳火
咽	口因大
袖	衤由
糟	米艹日日
激	氵白方攵
珊	王冂冂一
潭	氵西日十
蠢	春虫虫
植	木十且
占	卜口
倚	亻大丁口
姨	女大弓
幢	巾立甲二
焉	一止一乚灬
桐	木冂一口
痰	疒火火
捂	扌工㇕口
万	一力
蒲	艹氵甫
芽	艹牙
碑	石鬼十
嚼	口爪四艮寸
燃	火夕大丶灬
朴	木卜
杖	木一乂
磷	石米夕㐄
脆	月⺈厂巳
刃	刀丶
姑	女十口
衡	行⺈田大
措	扌廿日
眠	目巳七
途	之人禾
鄂	口口一了阝
捅	扌又用
禾	禾
磁	石䒑幺幺
沃	氵丿大
肚	月土
哀	亠口𧘇
浸	氵彐冖又
柄	木一冂人
跪	足⺈厂巳
瓷	冫欠一乚㇆丶
凸	丨一丨㇆一
磅	石亠丷冖方
宴	宀日女
堪	土其乚
仗	亻一乂
崩	山月月
革	革
聘	耳由了
刊	一十刂
裁	土亠𧘇戈
郁	大月阝
逝	之扌斤
塌	土日习习
崖	山厂土土
廉	广䒑彐刂八
婉	女宀夗
攀	木乂乂木大手
喘	口山而
氮	气火火
鞍	革宀女
巫	工人人
沁	氵心
瑟	王王心丿
揪	扌禾火
棵	木日木
拐	扌口力
披	扌皮
削	小月刂
悠	亻丨攵心
凹	冂一冂一
葬	艹一夕匕艹
瞪	目癶一口䒑
授	扌爪冖又
卸	牛止冂
慈	䒑幺幺心
瞄	目艹田
鞭	革亻一日乂
危	⺈厂巳
泊	氵白
喉	口亻㇕矢
溶	氵穴人口
拎	扌人之
察	宀夗示
昆	日匕匕
禹	丿口冂厶
娥	女手戈
醇	酉亠口子
橙	木癶一口䒑
辨	辛刂辛
暮	艹日大日
薪	艹立木斤
巢	巛日木
脾	月鬼十
愚	日冂厶心
蜀	四勹虫
裹	亠日木𧘇
藕	艹三小日冂厶
劈	尸口辛刀
堤	土日一止
拱	扌廿八
夸	大一了
傍	亻亠丷冖方
燥	火口口口木
允	厶儿
杏	木口
芒	艹亡
畔	田半
豹	豸勹丶
澄	氵癶一口䒑
冥	冖日亠八
媒	女甘木
酥	酉禾
垮	土大一了
枯	木十口
塑	䒑凵月土
卜	卜
茅	艹又㇕亻
搏	扌甫寸
沐	氵木
豫	又㇕丨⺈口豕
蒜	艹示示
雀	小丿隹
腐	广亻寸冂人人
皓	白牛口
央	冂大
冤	冖⺈口儿丶
据	扌尸十口
浙	氵扌斤
栓	木人王
梳	木亠厶川
冀	丬匕田廿八
冉	冂土
彤	冂亠彡
卑	鬼十
誓	扌斤言
蜂	虫夂丰
勺	勹丶
迅	之乙十
虫	虫
匹	匚儿
仰	亻氏冂
煞	⺈彐攵灬
羞	羊㇕十
注	氵丶王
嫂	女臼丨又
瞳	目立甲二
拂	扌弓川
挨	扌厶矢
泄	氵廿乚
夷	大弓
慎	忄十且八
汽	氵气
恭	廿八忄
弊	水冂攵艹
旦	日一
涂	氵人禾
氯	气彐水
乍	矢卜
耕	三小二川
稻	禾爪臼
屠	尸者
笛	⺮由
捕	扌甫
蕊	艹心心心
氨	气宀女
愣	忄四方
悔	忄矢母
敦	亠口子攵
葵	艹癶一大
磕	石土厶皿
渴	氵日勹人乚
曝	日日廿八水
撇	扌用水冂攵
梗	木一日乂
蔚	艹尸示寸
翅	十又习习
估	亻十口
瓣	辛瓜辛
淮	氵隹
惑	戈口一心
巡	之巛
墩	土亠口子攵
徽	行山一絲攵
蓄	艹亠幺田
匪	匚非
溢	氵䒑八皿
寇	宀二儿卜又
蓬	艹之夂丰
硫	石亠厶川
俏	亻小月
迫	之白
貌	豸白儿
茄	艹力口
炭	山大火
挂	扌土土
掀	扌斤欠
翰	十日十人习习
掩	扌大日乚
蹬	足癶一口䒑
泳	氵丶水
玫	王攵
椅	木大丁口
侍	亻土寸
抑	扌氏冂
毫	亠口冖毛
侵	亻彐冖又
妥	爪女
概	木艮七儿
援	扌爪一大又
昔	廿日
晾	日亠口小
逮	之彐氵
卒	亠人人十
捆	扌因木
菱	艹土八夂
梯	木丷弓亻
籽	米子
腕	月宀夗
挫	扌人人土
膝	月木人水
嗦	口十冖絲
眨	目丿之
循	行斤十目
臀	尸廿八殳月
矛	又㇕亻
努	女又力
黔	四二灬人丶㇕
乏	丿之
魅	鬼二小
凶	乂凵
掘	扌尸凵山
雌	止匕隹
旱	日一十
掰	手八刀手
蛙	虫土土
雕	冂土口隹
隋	阝大工月
芙	艹夫
刁	㇆一
禽	人亠乂凵冂厶
腺	月白水
欺	其欠
杉	木彡
党	小冖口儿
玖	王⺈丶
肆	長彐二
悉	釆心
掂	扌广卜口
冶	冫厶口
遣	之中一㠯
皖	白宀二儿
糕	米羊灬
址	土止
茵	艹因大
簿	⺮氵甫寸
旬	勹日
丈	一乂
咸	戊一口
碘	石冂廿八
瞅	目禾火
廊	广丶艮阝
焰	火⺈臼
淳	氵亠口子
畏	田展
屑	尸小月
嵌	山甘欠
泣	氵立
袍	衤勹巳
僵	亻三田田
沫	氵一木
寂	宀上小又
秤	禾丁䒑
藻	艹氵口口口木
螺	虫田絲
恤	忄丿皿
污	氵一了
涯	氵厂土土
滋	氵䒑幺幺
嗜	口者匕日
陡	阝走
栗	西木
捻	扌人丶㇕心
勃	十冖子力
矩	矢匚㇕
沽	氵十口
淤	氵方人冫
描	扌艹田
契	丰刀大
祠	礻㇆一口
峻	山厶八夂
稠	禾冂土口
爵	爪四艮寸
秉	禾彐
刨	勹巳刂
群	尹口羊
役	行殳
烙	火夂口
灾	宀火
强	弓口虫
痘	疒一口䒑
髓	骨之大工月
募	艹日大力
苟	艹勹口
析	木斤
魁	鬼冫十
斥	斤丶
棕	木宀示
倦	亻半巳
疆	弓土三田田
蔓	艹日四又
靴	革亻匕
烟	火因大
巾	巾
殊	一夕牛小
叮	口丁
艇	舟廴丿士
熔	火穴人口
芹	艹斤
寡	宀石且八刀
瞬	目爪冖夕㐄
邑	口巴
榕	木穴人口
庸	广彐月
棠	小冖口木
埠	土丿㠯十
茬	艹大丨土
嗅	口自大丶
滇	氵十且八
寅	宀一由八
蛾	虫手戈
慰	尸示寸心
履	尸行矢日夂
宛	宀夗
涮	氵尸巾刂
督	上小又目
衍	行氵
劣	小丿力
祈	礻斤
魄	白鬼
斧	八乂斤
淌	氵小冂口
簇	⺮方矢矢
沛	氵一巾
掠	扌亠口小
崎	山大丁口
菇	艹女十口
砌	石七刀
眯	目米
辱	辰寸
匠	匚斤
肘	月寸
淹	氵大日乚
洽	氵人一口
究	穴九
矢	矢
澈	氵亠厶月攵
椰	木耳阝
梢	木小月
障	阝立日十
霄	雨小月
揣	扌山而
槐	木鬼
粟	西米
唆	口厶八夂
拴	扌人王
吏	大口丶
堰	土匚日女
棺	木宀㠯
腥	月日生
胞	月勹巳
剖	立口刂
羹	羊灬羊大
剃	丷弓亻刂
寓	宀日冂厶
撩	扌大丷日小
扳	扌斤又
桔	木士口
妄	亡女
陌	阝一白
弧	弓瓜
撰	扌巳巳廿八
蛤	虫人一口
擒	扌人亠乂凵冂厶
哨	口小月
皂	白七
汞	工水
芭	艹巴
椒	木上小又
戎	戈大
肋	月力
煌	火白王
疤	疒巴
昧	日二小
柒	氵七木
旨	匕日
巳	巳
辜	十口辛
筐	⺮匚王
膊	月甫寸
遵	之丷酉寸
愧	忄鬼
拙	扌凵山
竿	⺮一十
甸	勹田
衷	亠中𧘇
脊	氵人月
憨	㇕耳攵心
捶	扌千艹二
苔	艹厶口
奸	女一十
舅	臼田力
恕	女口心
啼	口亠丷冖巾
睹	目者
疲	疒皮
褪	衤之艮
鞠	革勹米
彰	立日十彡
酬	酉⺍川
橘	木又㇕亻冂八口
啪	口扌白
睛	目丰月
哆	口夕夕
窟	穴尸凵山
垢	土斤一口
愿	厂白小心
腮	月田心
枉	木王
笙	⺮生
沸	氵弓川
妓	女十又
猿	犭土口𧘇
漠	氵艹日大
撬	扌毛毛毛
巍	山禾女鬼
漾	氵羊丶水
擎	艹勹口攵手
靶	革巴
俐	亻禾刂
胚	月不一
楷	木匕匕白
迭	之牛人
蹄	足亠丷冖巾
褐	衤日勹人乚
梭	木厶八夂
畜	亠幺田
宵	宀小月
榆	木人一月刂
嚷	口亠口口甘𧘇
絮	女口絲
戊	戊
罕	冖八一十
叩	口冂
俯	亻广亻寸
瀑	氵日廿八水
肇	户攵彐二
暇	日㇕卜㇕又
睬	目爪木
郊	亠八乂阝
璧	尸口辛王丶
捎	扌小月
嘀	口亠丷冂十口
犁	禾刂牛
怔	忄一止
焚	木木火
灼	火勹丶
孽	艹丿㠯辛子
匙	日一止匕
嚎	口亠口冖豕
摧	扌山隹
械	木戈艹
乞	矢乙
卯	氏丿冂
喧	口宀二日
瓢	西示瓜
裳	小冖口亠𧘇
竭	立日勹人乚
妨	女方
玻	王皮
擅	扌亠因口日一
烹	亠口了灬
卉	十艹
括	扌舌
檐	木⺈厂八言
尸	尸
椎	木隹
恬	忄舌
檀	木亠因口日一
坯	土不一
葡	艹勹甫
伙	亻火
拘	扌勹口
躁	足口口口木
囚	因人
匣	匚甲
凳	癶一口䒑几
隙	阝小日小
伶	亻人之
拭	扌弋工
墅	甲二又㇕丨土
碾	石尸艹展
榨	木穴矢卜
黯	四二灬立日
苞	艹勹巳
戚	戊上小
倘	亻小冂口
怯	忄土厶
礁	石隹灬
瞻	目⺈厂八言
躬	身弓
脖	月十冖子
襟	衤木木示
尉	尸示寸
亥	亠乡人
肢	月十又
悄	忄小月
厘	厂甲二
憎	忄丷四日
糙	米之牛口
盔	大火皿
睦	目土八土
炕	火亠几
荔	艹力力力
奢	大者
尬	尤人川
趾	足止
悼	忄卜日十
憾	忄戊一口心
稚	禾隹
褒	亠亻口木𧘇
烘	火廿八
嘻	口士口䒑口
熄	火自心
薯	艹四者
蕉	艹隹灬
泪	氵目
拗	扌幺力
毯	毛火火
莽	艹大丶艹
勉	⺈口儿力
亢	亠几
涌	氵又用
妒	女户
暑	日者
疫	疒殳
歉	䒑彐刂八欠
樟	木立日十
豁	宀丰口八人口
窖	穴牛口
脉	月丶水
启	户口
扭	扌㇕十
胰	月大弓
帘	穴巾
隅	阝日冂厶
岔	八刀山
弛	弓也
秘	禾心丿
撼	扌戊一口心
瘟	疒日皿
歧	止十又
椿	木春
确	石⺈用
价	亻人川
悍	忄日一十
啤	口鬼十
壬	丿士
叛	半斤又
捌	扌口力刂
勘	其乚力
啄	口豕
倡	亻日日
肛	月工
蔽	艹水冂攵
糯	米雨而
茫	艹氵亡
凰	几白王
溺	氵弓冫弓冫
硝	石小月
囤	因七凵
吭	口亠几
靡	广木木非
跺	足几木
扼	扌厂巳
吱	口十又
圃	因甫
瘸	疒力口冂人人
琢	王豕
酉	酉
棘	木冂木冂
蚌	虫丰
恍	忄小尤
糠	米广彐氵
渺	氵目小丿
祀	礻巳
琅	王丶艮
苛	艹丁口
唬	口虎
夭	丿大
橡	木⺈口豕
茸	艹耳
倔	亻尸凵山
丰	丰
耙	三小巴
跋	足大又丶
踱	足广廿又
叭	口八
恢	忄大火
舵	舟宀匕
璃	王亠乂凵冂厶
懈	忄⺈用刀牛
宦	宀臣
漱	氵木口欠
庶	广廿灬
挎	扌大一了
茉	艹一木
匾	匚户冂艹
筑	⺮工凡
痹	疒田一川
恃	忄土寸
舀	爪臼
搔	扌又丶虫
梧	木工㇕口
屹	山矢乙
灸	⺈丶火
蹈	足爪臼
牡	牛土
秧	禾冂大
狸	犭甲二
沼	氵刀口
夯	大力
炬	火匚㇕
逞	之口王
簧	⺮廿由八
窘	穴尹口
赦	土川八攵
溯	氵䒑凵月
宙	宀由
斟	其乚冫十
柑	木甘
匿	匚艹大口
剔	日勹彡刂
眷	半目
癸	癶一大
嘲	口十日十月
噩	王口口口口
筷	⺮忄㇕大
侄	亻至
滔	氵爪臼
丐	一卜乚
戌	戊一
疹	疒人彡
炊	火欠
涕	氵丷弓亻
摹	艹日大手
羚	羊人之
渤	氵十冖子力
墟	土虎业
柿	木亠巾
噪	口口口口木
膨	月士口䒑彡
琉	王亠厶川
抒	扌又㇕丨
酌	酉勹丶
殖	一夕十且
眶	目匚王
稼	禾宀豕
粹	米亠人人十
褂	衤土土卜
廓	广亠口子阝
豚	月豕
犀	尸水牛
垛	土几木
擂	扌雨田
檬	木艹冖一豕
咕	口十口
嘶	口其斤
吮	口厶儿
厂	厂
芋	艹一寸
萎	艹禾女
嗡	口八厶习习
吠	口大丶
篷	⺮之夂丰
聆	耳人之
碌	石彐水
怠	厶口心
杠	木工
砰	石丁䒑
曙	日四者
稽	禾尤匕日
偎	亻田展
敞	小冂口攵
徙	行止止
拇	扌母
兢	十口儿十口儿
峨	山手戈
姊	女丿乚亻
愉	忄人一月刂
衙	行工㇕口
鄙	口十因口阝
澎	氵士口䒑彡
煽	火户习习
惶	忄白王
酣	酉甘
庇	广匕匕
芥	艹人川
蝗	虫白王
床	广木
陋	阝一冂人乚
壤	土亠口口甘𧘇
愕	忄口口一了
唧	口艮冂
慨	忄艮七儿
乒	丘丿
朦	月艹冖一豕
粱	氵刀八米
征	行一止
柬	木四
秩	禾牛人
朽	木了
蛛	虫牛小
啡	口非
晦	日矢母
嫉	女疒矢
广	广
幌	巾日小尤
臼	臼
怖	忄大巾
灶	火土
宁	宀丁
哺	口甫
婿	女㇕止月
挽	扌⺈口儿
歹	一夕
矗	十且十且十且
叨	口刀
晰	日木斤
揩	扌匕匕白
酪	酉夂口
瑰	王鬼
蔗	艹广廿灬
嗓	口又又又木
膛	月小冖口土
汛	氵乙十
剿	巛日木刂
蔬	艹㇕止亠厶川
腋	月亠亻夂丶
吆	口幺
拄	扌丶王
吝	文口
皿	皿
徊	行因口
嗽	口木口欠
悖	忄十冖子
耘	三小二厶
榴	木氏丶刀田
伺	亻㇆一口
胜	月生
筏	⺮亻戈
辟	尸口辛
姥	女者匕
坷	土丁口
仆	亻卜
脯	月甫
痢	疒禾刂
汰	氵大丶
峭	山小月
僚	亻大丷日小
忿	八刀心
孵	氏丿丶冂丶爪子
紊	文絲
捺	扌大示
帷	巾隹
寞	宀艹日大
畸	田大丁口
箕	⺮其
匆	勹彡丶
渲	氵宀二日
耽	其冖儿
猩	犭日生
舶	舟白
殃	一夕冂大
遏	之日勹人乚
匕	匕
隘	阝䒑八皿
泌	氵心丿
俘	亻爪子
晌	日自口
睫	目一彐止
捍	扌日一十
蝠	虫一口田
膀	月亠丷冖方
姻	女因大
窒	穴至
熏	千四二灬
氓	亡巳七
忱	忄冖儿
雇	户隹
媳	女自心
荐	艹大丨子
埂	土一日乂
僻	亻尸口辛
瓤	亠口口甘𧘇瓜
拯	扌㇕水一
奠	丷酉大
翩	户冂艹习习
祟	凵山示
殉	一夕勹日
跤	足亠八乂
牲	牛生
菩	艹立口
佣	亻用
喳	口木日一
蘑	艹广木木石
跛	足皮
盹	目七凵
哮	口者子
乓	丘丶
狡	犭亠八乂
蹋	足日习习
篡	⺮目大厶
竣	立厶八夂
韭	非一
肪	月方
秸	禾士口
崛	山尸凵山
庵	广大日乚
隧	阝之丷豕
蜈	虫口一大
惰	忄大工月
蚤	又丶虫
苹	艹丁䒑
藐	艹豸白儿
酵	酉者子
匈	勹乂凵
唾	口千艹二
瑙	王巛鬼乂
蛀	虫丶王
适	之舌
慷	忄广彐氵
寥	宀习习人彡
蔑	艹四戊丶
迄	之矢乙
臊	月口口口木
懦	忄雨而
羔	羊灬
肴	乂大月
湃	氵手一丰
疚	疒⺈丶
窿	穴阝夂一生
漓	氵亠乂凵冂厶
迂	之一寸
氛	气八刀
垃	土立
佃	亻田
腊	月廿日
沮	氵且
并	䒑艹
懊	忄自米大
萄	艹勹牛山
达	之大
唇	辰口
况	冫口儿
冗	冖几
侮	亻矢母
悴	忄亠人人十
梆	木丰阝
蟆	虫艹日大
溉	氵艮七儿
嘹	口大丷日小
蟀	虫亠幺氵艹
惕	忄日勹彡
惦	忄广卜口
蜓	虫廴丿士
榔	木丶艮阝
蚓	虫弓丨
葫	艹十口月
譬	尸口辛言
豺	豸寸丿
柜	木匚㇕
帚	彐冖巾
茁	艹凵山
咨	冫欠口
淀	氵宀一止
吩	口八刀
蚪	虫冫十
褥	衤辰寸
菠	艹氵皮
徘	行非
蜒	虫廴丿止
蜡	虫廿日
憔	忄隹灬
雹	雨勹巳
橄	艹㇕耳攵
婪	木木女
疙	疒矢乙
侈	亻夕夕
蝴	虫十口月
峰	山夂丰
呻	日申
咄	口凵山
蜘	虫矢口
唁	口言
棱	木土八夂
圾	土㇆人
咐	口亻寸
甥	生田力
霹	雨尸口辛
蚣	虫八厶
霎	雨立女
簸	⺮其皮
惋	忄宀夗
蚯	虫丘
蠕	虫雨而
瘩	疒艹人一口
迢	之刀口
胳	月夂口
猖	犭日日
蜻	虫丰月
猾	犭骨
冲	冫中
痊	疒人王
迹	之亠川八
儿	儿
玷	王卜口
栖	木西
凭	亻丿士几
韵	立日勹冫
踊	足又用
叶	口十
蹂	足又㇕亻木
袱	衤亻大丶
豌	一口䒑宀夗
蝌	虫禾冫十
淆	氵乂大月
酗	酉乂凵
吁	口一寸
螃	虫亠丷冖方
蟋	虫釆心
亏	一了
划	戈刂
蝙	虫户冂艹
坏	土不
够	勹口夕夕
圣	又土
弃	亠厶艹
极	木㇆人
葱	艹勹彡丶心
猫	犭艹田
猪	犭者
册	冂冂一
机	木几
隶	彐氵
垒	厶厶厶土
号	口了
扑	扌卜
赶	走一十
窑	穴牛山
听	口斤
柠	木宀丁
猬	犭田月
猎	犭廿日
凄	冫一彐女
晋	一业日
痴	疒矢口
叙	人禾又
离	亠乂凵冂厶
滚	氵亠八厶𧘇
屉	尸廿乚
无	一尤
与	一乚一
样	木羊
国	因王丶
吨	口七凵
户	户
巩	工凡
却	土厶冂
担	扌日一
撑	扌小冖口手
携	扌隹㇆丿
抬	扌厶口
构	木勹厶
医	匚矢
蝎	虫日勹人乚
咏	口丶水
踪	足宀示
叹	口又
网	冂乂乂
冈	冂乂
岭	山人之
复	矢日夂
笋	⺮尹
众	人人人
脚	月土厶冂
胆	月日一
庄	广土
凉	冫亠口小
决	冫㇕大
恒	忄二日
潜	氵夫夫日
汹	氵乂凵
袜	衤一木
宫	宀口口
异	巳艹
栅	木冂冂一
吕	口口
秆	禾一十
删	冂冂一刂
胶	月亠八乂
泞	氵宀丁
扰	扌尤
芜	艹一尤
芦	艹户
碱	石戊一口
奋	大田
邮	由阝
毁	臼工殳
体	亻木一
优	亻尤
犹	犭尤
肮	月亠几
凑	冫春一大
痒	疒羊
烛	火虫
怜	忄人之
惊	忄亠口小
羡	羊冫欠
洁	氵士口
垦	艮土
篱	⺮亠乂凵冂厶
灯	火丁
橱	木厂一口䒑寸
减	冫戊一口
耻	耳止
厨	厂一口䒑寸
凛	冫亠因口示
厦	厂一自夂
亲	立木
届	尸由
厢	厂木目
忧	忄尤
禀	亠因口示
叠	又又又冖且
开	一艹
录	彐水
献	十冂半大丶
园	因二儿
杀	乂木
寻	彐寸
邓	又阝
吓	口一卜
触	⺈用虫
权	木又
杂	九木
丽	一冂丶冂丶
币	丿巾
仅	亻又
沟	氵勹厶
灵	彐火
茧	艹虫
怀	忄不
积	禾口八
敌	舌攵
块	土㇕大
备	夂田
关	䒑大
队	阝人
宪	宀牛儿
现	王見
个	人丨
说	言丷口儿
为	丷㇆丶
没	氵殳
这	之文
对	又寸
发	乚丿又丶
两	一冂人人
项	工頁
专	二乚丶
来	二水
动	二厶力
长	長
联	耳䒑大
帮	丰阝巾
热	扌丸灬
拨	扌乚丿又丶
带	艹冖巾
节	艹冂
标	木示
横	木廿由八
龙	龍
页	頁
顾	厂巳頁
车	車
区	匚乂
暂	車斤日
轨	車九
软	車欠
点	卜口灬
旧	丨日
齿	齒
别	口力刂
员	口貝
吗	口馬
时	日寸
业	业
当	小彐
电	日乚
贱	貝戈
败	貝攵
内	冂人
贩	貝斤又
见	見
赔	貝立口
县	且厶
税	禾丷口儿
气	气
传	亻二乚丶
顺	川頁
们	亻門
伪	亻丷㇆丶
会	人二厶
领	人之頁
从	人人
镇	金十且八
须	彡頁
钱	金戈
钻	金卜口
钢	金冂乂
铁	金牛人
胀	月長
腻	月弋二貝
独	犭虫
肿	月中
风	几乂
脱	月丷口儿
鱼	魚
条	夂木
乐	氏小
争	⺈彐
鸟	鳥
讲	言二川
让	言上
调	言冂土口
齐	文川
诉	言斤丶
设	言殳
该	言亠乡人
变	亠刂八又
装	丬士亠𧘇
闻	門耳
闭	門寸丿
问	門口
间	門日
门	門
将	丬夕寸
应	广⺍一
疗	疒了
废	广乚丿又丶
类	米大
炼	火七㇆八
总	丷口心
单	丷日十
粮	米丶艮
数	米女攵
洒	氵西
滤	氵虎心
测	氵貝刂
学	⺍冖子
汉	氵又
泼	氵乚丿又丶
宽	宀艹見
军	冖車
补	衤卜
审	宀申
实	宀冫大
马	馬
层	尸二厶
颇	皮頁
观	又見
难	又隹
验	馬人二⺍
买	㇕冫大
骗	馬户冂艹
张	弓長
阳	阝日
费	弓川貝
办	力八
阴	阝月
习	习
弹	弓丷日十
随	阝之大月
红	絲工
续	絲十㇕冫大
纯	絲七凵
细	絲田
组	絲且
统	絲亠厶儿
断	米乚斤
编	絲户冂艹
经	絲㇕丶工
蚕	一大虫
顶	丁頁
鹉	一弋止鳥
严	一业丿
亚	一业
恶	一业心
画	一田凵
残	一夕戈
歼	一夕千
灭	一火
迈	之一力
坛	土二厶
墙	土十䒑因口
盐	土卜皿
坝	土貝
进	之二川
规	夫見
赵	走乂
顽	二儿頁
远	之二儿
趋	走⺈彐
坟	土文
颊	二火頁
夹	二火
壶	士冖业
壳	士冖几
声	士尸
场	土㇆彡
运	之二厶
寿	丰寸
环	王不
职	耳口八
责	丰貝
静	丰月⺈彐
艳	丰⺈巴
聪	耳丷口心
鬓	長彡宀丘八
玛	王馬
聂	耳又又
抚	扌一尤
挟	扌二火
摄	扌耳又又
捞	扌艹冖力
拢	扌龍
拣	扌七㇆八
抠	扌匚乂
损	扌口貝
挡	扌小彐
摆	扌四土厶
拥	扌用
捡	扌人二⺍
抡	扌人匕
抢	扌人巳
摇	扌爪牛山
垫	扌丸土
挚	扌丸手
执	扌丸
抛	扌九力
换	扌⺈冂大
搀	扌⺈口儿冫
挣	扌⺈彐
挤	扌文川
过	之寸
扩	扌广
搁	扌門夂口
掷	扌䒑大阝
搂	扌米女
搅	扌⺍冖見
拧	扌宀丁
挥	扌冖車
护	扌户
扫	扌彐
摊	扌又隹
扬	扌㇆彡
报	扌冂又
掺	扌厶大彡
拟	扌厶人
苇	艹工㇆
协	十力八
载	土車戈
莲	艹之車
蓝	艹刂⺮皿
黄	廿由八
颠	十且八頁
获	艹犭大丶
蔼	艹言日勹人乚
蒋	艹丬夕寸
丧	十丷展
荡	艹氵㇆彡
莹	艹冖王丶
荣	艹冖木
荤	艹冖車
萤	艹冖虫
营	艹冖口口
荧	艹冖火
劳	艹冖力
茎	艹㇕丶工
萧	艹彐川八
卖	十㇕冫大
艺	艹乙
苏	艹力八
荫	艹阝月
萨	艹阝立丿
蕴	艹絲日皿
药	艹絲勹丶
飘	西示風
梦	木木夕
雳	雨厂力
栋	木七小
栈	木戈
枢	木匚乂
档	木小彐
贾	西貝
枣	木冂冫
桥	木丿大川
霉	雨矢母
检	木人二⺍
枪	木人巳
枫	木風
赖	木口⺈貝
术	木丶
酿	酉丶艮
桩	木广土
楼	木米女
树	木又寸
椭	木阝大月
杨	木㇆彡
厅	厂丁
厉	厂一力
压	厂土丶
砖	石二乚丶
夺	大寸
硕	石頁
厌	厂大丶
还	之不
碍	石日一寸
厕	厂貝刂
砚	石見
垄	龍土
袭	龍亠𧘇
态	大丶心
矿	石广
牵	大冖牛
码	石馬
历	厂力
础	石凵山
轩	車一十
辆	車一冂人人
贰	弋二貝
转	車二乚丶
连	之車
轰	車又又
轧	車乚
辅	車甫
尧	戈尤
翘	戈尤习习
卧	臣卜
辑	車口耳
轴	車由
东	七小
盏	戈皿
轿	車丿大川
输	車人一月刂
殴	匚乂殳
轮	車人匕
鸦	牙鳥
较	車亠八乂
辙	車亠厶月攵
辖	車宀丰口
轻	車㇕丶工
辗	車尸艹展
顿	七凵頁
战	卜口戈
蝇	虫口日乚
蜗	虫口冂人
卤	卜因乂
频	止小頁
虚	虎业
贞	卜貝
龄	齒人之
蜕	虫丷口儿
蝉	虫丷日十
虑	虎心
颅	卜尸頁
卢	卜尸
蚂	虫馬
虏	虎力
吴	口一大
哑	口一业
贵	中一貝
围	因工㇆
团	因寸丿
喷	口十艹貝
躏	足艹門隹
咙	口龍
跷	足戈尤
践	足戈
呕	口匚乂
虽	口虫
圆	因口貝
骂	口口馬
啰	口四夕
跃	足丿大
响	口自口
哗	口亻匕十
呛	口人匕
叽	口几
鹃	口月鳥
唤	口⺈冂大
图	因夂冫
鸣	口鳥
嘱	口尸丿口冂厶
啸	口彐川八
哟	口絲勹丶
题	日一止頁
师	刂一巾
畴	田丰寸
颗	日木頁
晒	日西
辉	小尤冖車
辈	非車
晓	日戈尤
鸭	甲鳥
显	日业
帅	刂巾
临	刂⺮日
监	刂⺮皿
览	刂⺮見
鉴	刂⺮金
尘	小土
旷	日广
凿	业半凵
尝	小冖二厶
晕	日冖車
赏	小冖口貝
归	刂彐
贤	刂又貝
肾	刂又月
竖	刂又立
紧	刂又絲
畅	申㇆彡
赋	貝一弋止
屿	山一乚一
峡	山二火
罢	四土厶
帐	巾長
账	貝長
财	貝寸丿
瞒	目艹一冂人人
巅	山十且八頁
赎	貝十㇕冫大
贿	貝大月
鸯	冂大鳥
贼	貝戈大
岖	山匚乂
崭	山車斤
贴	貝卜口
帜	巾口八
刚	冂乂刂
赐	貝日勹彡
婴	貝貝女
贝	貝
赌	貝者
则	貝刂
赂	貝夂口
岁	山夕
睁	目⺈彐
购	貝勹厶
罚	四言刂
赃	貝广土
赠	貝丷四日
赚	貝䒑彐刂八
贮	貝宀一
瞩	目尸丿口冂厶
凯	山己几
岂	山己
悬	且厶心
丢	丿土厶
筹	⺮丰寸
迁	之千
笼	⺮龍
乔	丿大川
毡	毛卜口
乱	舌乚
篮	⺮刂⺮皿
笔	⺮毛
签	⺮人二⺍
秃	禾几
颓	禾几頁
称	禾⺈小
赞	牛儿牛儿貝
选	之牛儿
稳	禾⺈彐心
鹅	手戈鳥
辞	舌辛
简	⺮門日
篓	⺮米女
氢	气㇕丶工
箫	⺮彐川八
俩	亻一冂人人
粤	鬼米了
侠	亻二火
伟	亻工㇆
债	亻丰貝
侥	亻戈尤
贷	亻弋貝
舆	臼車八
躯	身匚乂
侦	亻卜貝
侣	亻口口
侧	亻貝刂
侨	亻丿大川
赁	亻丿士貝
伤	亻矢力
俭	亻人二⺍
伦	亻人匕
华	亻匕十
倾	亻匕頁
货	亻匕貝
储	亻言者
奥	自米大
亿	亻乙
剑	人二⺍刂
敛	人二⺍攵
饵	食耳
仓	人巳
馍	食艹日大
刹	乂木刂
饶	食戈尤
彻	行七刀
衔	行金
馈	食中一貝
饿	食手戈
饰	食矢巾
丛	人人一
耸	人人耳
爷	八乂冂
饭	食斤又
馁	食爪女
饥	食几
馋	食⺈口儿冫
馅	食⺈臼
饮	食欠
仑	人匕
馏	食氏丶刀田
饱	食勹巳
贪	人丶㇕貝
伞	人䒑丨
饼	食䒑艹
邻	人之阝
馆	食宀㠯
蚀	食虫
饲	食㇆一口
颁	八刀頁
创	人巳刂
贫	八刀貝
颂	八厶頁
钉	金丁
铐	金者了
铸	金丰寸
钳	金甘
针	金十
错	金廿日
质	斤十貝
铺	金甫
链	金之車
钟	金中
铝	金口口
锅	金口冂人
锁	金小貝
钞	金小丿
销	金小月
锡	金日勹彡
铛	金小彐
铜	金冂一口
盘	舟皿
钠	金冂人
舰	舟見
锄	金且力
锹	金禾火
锈	金禾㇆丿
锻	金亻三殳
锥	金隹
锦	金白巾
铃	金人之
舱	舟人巳
铅	金几口
钥	金月
锋	金夂丰
铭	金夕口
钦	金欠
钓	金勹丶
钧	金勹冫
钩	金勹厶
锌	金辛
镜	金立日儿
铲	金立丿
镑	金亠丷冖方
镀	金广廿又
镰	金广䒑彐刂八
锐	金丷口儿
爱	爪冖大又
释	釆又工
锯	金尸十口
银	金艮
锰	金子皿
键	金廴彐二
肤	月二人
狭	犭二火
胧	月龍
狈	犭貝
脸	月人二⺍
鹏	月月鳥
狰	犭⺈彐
狱	犭言大丶
脐	月文川
脑	月亠乂凵
脏	月广土
腾	月半馬
狞	犭宀丁
脓	月冖𧘇
胁	月力八
鳍	魚者匕日
顷	匕頁
处	夂卜
鲤	魚甲二
尔	⺈小
鲁	魚日
龟	⺈日乚
岛	鳥山
负	⺈貝
颖	匕禾頁
毕	匕匕十
鲍	魚勹巳
贸	氏丶刀貝
鲜	魚羊
鳞	魚米夕㐄
鸵	鳥宀匕
雏	⺈彐隹
皱	⺈彐皮
鲫	魚艮冂
务	夂力
鸳	夗鳥
匀	勹冫
乌	烏
订	言丁
评	言丁䒑
诗	言土寸
诸	言者
诬	言工人人
语	言工㇕口
讳	言工㇆
请	言丰月
讨	言寸
计	言十
谋	言甘木
谍	言廿乚木
诺	言艹大口
谎	言艹亡川
读	言十㇕冫大
谭	言西日十
斋	文而
试	言弋工
诫	言戈艹
讶	言牙
诚	言戊㇆
误	言口一大
颤	亠因口日一頁
识	言口八
赢	亡口月貝凡
诽	言非
刘	文刂
课	言日木
亩	亠田
蛮	亠刂八虫
谓	言田月
弯	亠刂八弓
许	言矢十
话	言舌
颜	立丿彡頁
诱	言禾㇆丿
诲	言矢母
训	言川
谁	言隹
剂	文川刂
认	言人
诊	言人彡
论	言人匕
义	丶乂
谣	言爪牛山
讥	言几
讽	言風
诡	言⺈厂巳
询	言勹日
谐	言匕匕白
谅	言亠口小
谚	言立丿彡
议	言丶乂
辩	辛言辛
谤	言亠丷冖方
访	言方
详	言羊
产	立丿
谈	言火火
谜	言之米
谦	言䒑彐刂八
谴	言之中一㠯
谊	言宀且
译	言又工
诀	言㇕大
诵	言又用
词	言㇆一口
讯	言乙十
诞	言廴丿止
记	言己
辫	辛絲辛
闺	門土土
冯	冫馬
头	冫大
庆	广大
库	广車
庞	广龍
状	丬大丶
冻	冫七小
壮	丬士
闸	門甲
闰	門王
闲	門木
闽	門虫
闯	門馬
阀	門亻戈
鹰	疒亻隹鳥
瘪	疒自人匕
闪	門人
疮	疒人巳
疯	疒風
桨	丬夕木
奖	丬夕大
浆	丬夕水
资	冫欠貝
阎	門⺈臼
癣	疒魚羊
净	冫⺈彐
闹	門亠巾
阅	門丷口儿
阐	門丷日十
阔	門氵舌
庐	广户
闷	門心
瘫	疒又隹
瘾	疒阝⺈彐心
妆	丬女
兰	䒑二
誊	半言
愤	忄十艹貝
懒	忄木口⺈貝
娄	米女
烦	火頁
郑	䒑大阝
烧	火戈尤
惭	忄車斤
兑	丷口儿
兽	丷田一口
灿	火山
惧	忄且八
养	羊川
烁	火氏小
焕	火⺈冂大
恼	忄亠乂凵
悯	忄門文
悦	忄丷口儿
忆	忄乙
递	之丷弓亻
惨	忄厶大彡
惯	忄母貝
兹	䒑幺幺
举	⺍一八工
兴	⺍一八
誉	⺍一八言
洼	氵土土
鸿	氵工鳥
涛	氵丰寸
满	氵艹一冂人人
滞	氵艹冖巾
潇	氵艹彐川八
沥	氵厂力
浇	氵戈尤
浅	氵戈
渐	氵車斤
汇	氵匚
浊	氵虫
涡	氵口冂人
湿	氵日业
温	氵日皿
溅	氵貝戈
渊	氵川米
沦	氵人匕
涤	氵夂木
涣	氵⺈冂大
渔	氵魚
润	氵門王
澜	氵門木四
涧	氵門日
浑	氵冖車
觉	⺍冖見
沪	氵户
滨	氵宀丘八
浓	氵冖𧘇
泽	氵又工
滩	氵又隹
涨	氵弓長
汤	氵㇆彡
涩	氵刀丶止
烫	氵㇆彡火
渗	氵厶大彡
写	冖一乚一
窍	穴工了
窥	穴二人見
违	之工㇆
祷	礻丰寸
宝	宀王丶
赛	宀甘八貝
宠	宀龍
窃	穴七刀
遗	之中一貝
祸	礻口冂人
视	礻見
袄	衤丿大
鹤	冖隹鳥
穷	穴力
遥	之爪牛山
宾	宀丘八
额	宀夂口頁
农	冖𧘇
礼	礻乚
裤	衤广車
禅	礻丷日十
迟	之尸丶
逊	之子小
边	之力
辽	之了
颈	㇕丶工頁
劲	㇕丶工力
骤	馬耳又豕
剧	尸十口刂
骑	馬大丁口
驮	馬大
戏	又戈
驱	馬匚乂
驶	馬口乂
剥	彐水刂
骡	馬田絲
骄	馬丿大川
属	尸丿口冂厶
驯	馬川
肃	彐川八
驳	馬乂乂
驹	馬勹口
骆	馬夂口
欢	又欠
鸡	又鳥
驻	馬丶王
昼	尸丶日一
尽	尸丶冫
骇	馬亠乡人
屡	尸米女
驴	馬户
驼	馬宀匕
恳	艮心
预	又㇕丨頁
艰	又艮
驰	馬也
劝	又力
骏	馬厶八夂
卫	冂一
际	阝示
陕	阝二火
陆	阝二山
阵	阝車
陈	阝七小
贺	力口貝
驾	力口馬
孙	子小
坠	阝人土
阶	阝人川
弥	弓⺈小
隐	阝⺈彐心
飞	乙冫
导	巳寸
结	絲士口
绪	絲者
纬	絲工㇆
绩	絲丰貝
绑	絲丰阝
缚	絲甫寸
叁	厶大三
缅	絲石因卜丨
参	厶大彡
绕	絲戈尤
线	絲戈
练	絲七㇆八
绰	絲卜日十
娱	女口一大
缉	絲口耳
绳	絲口日乚
织	絲口八
绢	絲口月
纱	絲小丿
绸	絲冂土口
纲	絲冂乂
纳	絲冂人
纤	絲千
妈	女馬
绣	絲禾㇆丿
缎	絲亻三殳
维	絲隹
绵	絲白巾
缴	絲白方攵
给	絲人一口
绘	絲人二厶
纵	絲人人
纷	絲八刀
缓	絲爪一大又
绷	絲月月
纸	絲氏
络	絲夂口
绚	絲勹日
约	絲勹丶
终	絲夂冫
绝	絲⺈巴
纹	絲文
纺	絲方
缠	石广甲二
绊	絲半
继	絲米乚
综	絲宀示
绽	絲宀一止
婶	女宀申
缩	絲宀亻一白
缝	絲之夂丰
妇	女彐
纽	絲㇕十
绿	絲彐水
绍	絲刀口
贯	母貝
级	絲㇆人
纫	絲刀丶
纪	絲己
丝	絲絲一
缘	絲彑豕
纠	絲凵
乡	乡
贡	工貝
韧	工㇆刀丶
击	二山
赘	丰力攵貝
麦	丰夂
琐	王小貝
琼	王亠口小
撵	扌二人二人車
挠	扌戈尤
揽	扌刂⺮見
势	扌丸力
捣	扌鳥山
拦	扌䒑二
择	扌又工
荆	艹一艹刂
鹊	廿日鳥
莱	艹二水
韩	十日十工㇆
萝	艹四夕
苍	艹人巳
莺	艹冖鳥
酝	酉二厶
榄	木刂⺮見
槛	木刂⺮皿
樱	木貝貝女
桦	木亻匕十
栏	木䒑二
雾	雨夂力
励	厂一力力
聋	龍耳
矾	石凡
砾	石氏小
尴	尤刂⺮皿
辐	車一口田
斩	車斤
欧	匚乂欠
鸥	匚乂鳥
虾	虫一卜
蚁	虫丶乂
唠	口艹冖力
嚣	口口頁口口
呐	口冂人
勋	口貝力
呜	口烏
坚	刂又土
鳖	水冂攵魚
睐	目二水
罗	四夕
逻	之四夕
岗	山冂乂
贬	貝丿之
赡	貝⺈厂八言
贻	貝厶口
鹦	貝貝女鳥
矫	矢丿大川
牺	牛西
秽	禾山夕
筛	⺮刂一巾
箩	⺮四夕
衅	丿皿半
筝	⺮⺈彐
囱	鬼夂
偿	亻小冖二厶
仪	亻丶乂
鸽	人一口鳥
惩	行一止心
径	行㇕丶工
馒	食日四又
饺	食亠八乂
钙	金一卜乚
锚	金艹田
钝	金七凵
钾	金甲
锣	金四夕
锤	金千艹二
镶	金亠口口甘𧘇
镐	金亠口冂口
觅	爪見
钮	金㇕十
凤	几又
狮	犭刂一巾
肠	月㇆彡
鳄	魚口口一了
毙	匕匕一夕匕
鲸	魚亠口小
惫	夂田心
证	言一止
谨	言廿口丰
峦	亠刂八山
恋	亠刂八心
诈	言矢卜
谢	言身寸
讹	言亻匕
讼	言八厶
谆	言亠口子
赣	立日十夂工貝
竞	立口儿
谱	言䒑业日
谬	言习习人彡
盗	冫欠皿
庙	广由
疟	疒匚
酱	丬夕酉
阁	門夂口
痪	疒⺈冂大
盖	羊皿
粪	米廿八
烂	火䒑二
炉	火户
涝	氵艹冖力
濒	氵止小頁
溃	氵中一貝
滥	氵刂⺮皿
鲨	氵小丿魚
沧	氵人巳
浏	氵文刂
济	氵文川
湾	氵亠刂八弓
泻	氵冖一乚一
寝	宀丬彐冖又
窜	穴口中
窝	穴口冂人
禄	礻彐水
衬	衤寸
双	又又
骚	馬又丶虫
书	㇕㇆丨丶
堕	阝大月土
陨	阝口貝
险	阝人二⺍
缰	絲三田田
缭	絲大丷日小
绒	絲戈大
绅	絲申
缆	絲刂⺮見
娇	女丿大川
绞	絲亠八乂
缔	絲亠丷冖巾
缕	絲米女
缤	絲宀丘八
绎	絲又工
缀	絲又又又又
