# 柬・東
練	糸木日
爛	火門木日
蘭	艹門木日
欄	木門木日
攔	扌門木日
瀾	氵門木日
闌	門木日
煉	火木日
斕	文門木日
讕	言門木日
鑭	金門木日
籣	⺮門木日
灡	氵艹門木日
襴	衤門木日
暕	日木日
鰊	魚木日
朄	申木日
瑓	王木日
糷	米艹門木日
萰	艹木日
𡔔	土艹門木日
𪩱	巴門木日
𫲴	子艹門木日
𡄮	口金木日
𫇡	舟艹門木日
㘓	口門木日
𢦂	心艹門木日
𠣂	言木日力
㦨	心門木日
囒	口艹門木日
䃹	石門木日
𬵿	魚艹門木日
𥈵	目木日
𫋨	虫言木日
𢒞	木日彡
欗	木艹門木日
𢺤	扌艹門木日
𩽥	魚門木日

# 黑・黒
墨	田土灬土
黛	亻弋田土灬
濹	氵田土灬土

# 曾・曽
層	尸丷田日
贈	貝丷田日
僧	亻丷田日
憎	心丷田日

# 吳・吴・呉
誤	言呉
虞	虎呉
蜈	虫呉
麌	鹿吳
鋘	金吳
噳	口虎吳
茣	艹吳
澞	氵虎吳
𣮇	吳毛

# 画（田・由）
画	一由凵
婳	女一由凵
𪽗	尸丶一由凵
𤳰	尸毛尸丶一由凵
𫥯	尸丶一由凵尸毛
𡳒	尸毛一由凵

# 爪缶・䏑缶・爪干凵
鰩	魚䏑缶
徭	行䏑缶
傜	亻䏑缶
愮	心䏑缶
颻	䏑缶風
媱	女䏑缶
猺	犭䏑缶
𤁓	氵王䏑缶
𤁠	氵之䏑缶
𩆍	雨氵䏑缶
嗂	口䏑缶
䁘	目䏑缶
𩆡	雨之䏑缶
𡏟	土䏑缶
𩆋	雨扌䏑缶
謡	言爪干凵
瑶	王爪干凵
遥	之爪干凵

# 夕寸・爪寸
埓	土䏑寸
将	爿爪寸
蒋	艹爿爪寸

# 直（十目一・十目乚）
直	十目乚
置	四十目乚
植	木十目乚
殖	一夕十目乚
矗	十目乚十目乚十目乚
埴	土十目乚
淔	氵十目乚
稙	禾十目乚
犆	牛十目乚
𫹦	十目乚行土寸
𬑚	十目乚匚巾
𫤁	亻小冂口十目乚
𪧡	十目乚宀寸
𫕾	四十目乚非
𥊢	十目乚小冂口
𤣡	犭四勹虫十目乚
𥊣	小冂口十目乚
𤊧	火十目乚
𫗾	禾日十目乚
𠶗	口十目乚
𨁷	足十目乚

# 真・眞
滇	氵眞
嗔	口眞
癲	疒眞頁
縝	糸眞
禛	示眞
闐	門眞
瞋	目眞
稹	禾眞
寘	宀眞
瑱	王眞
傎	亻眞
搷	扌眞
鬒	長彡眞
窴	穴眞
磌	石眞
蹎	足眞
衠	行眞
齻	齒眞
𤄱	氵金眞
𧜖	衤眞
𪓇	四土灬眞頁
𬹙	眞四土灬
𠆍	亠月眞
𡂌	口眞小丿
𡻗	山眞
𬉌	氵口眞
𤛇	牛眞
𢅬	白巾眞
𩝻	食眞
𤠶	犭眞
鷏	真鳥

# 大・犬
器	口口大口口
類	米大頁
臭	自大
突	穴大
莽	艹大艹
蟒	虫艹大艹
唳	口户大
捩	扌户大
綟	糸户大

# 賴（𠂊・刀）
懶	心木口刀貝
賴	木口刀貝
瀨	氵木口刀貝
癩	疒木口刀貝
籟	⺮木口刀貝
獺	犭木口刀貝
嬾	女木口刀貝
藾	艹木口刀貝
𱜝	匚㇕心木口刀貝
𣡙	田木木口刀貝
𡚚	大木口刀貝
𬟣	艹氵木口刀貝
𣡚	田木木口刀貝
𬯩	阝丁口木口刀貝
𢁑	巴木口刀貝
𢀲	匚㇕木口刀貝

# 晋・晉
縉	糸二厶厶日
瑨	王二厶厶日
搢	扌二厶厶日
溍	氵二厶厶日
鄑	二厶厶日阝

# 氐（氏丶・氏一）
低	亻氏一
底	广氏一
抵	扌氏一
牴	牛氏一
邸	氏一阝
祗	示氏一
骶	骨氏一
氐	氏一
砥	石氏一
胝	月氏一
羝	羊氏一
鴟	氏一鳥
詆	言氏一
柢	木氏一
坻	土氏一
厎	厂氏一
袛	衤氏一
秪	禾氏一
菧	艹广氏一
茋	艹氏一
蚳	虫氏一
軧	車氏一
岻	山氏一
泜	氵氏一
阺	阝氏一
弤	弓氏一
貾	貝氏一
觝	𠂊用氏一
𥓵	石广氏一
𬺙	立申亻氏一
𢋠	亠丷冖巾广氏一
𧍉	虫广氏一
𡌠	土亻氏一
𦝉	月广氏一
𬇉	氏一刀
𤯰	生广氏一
𤯿	广氏一立丿生
𪂰	鳥广氏一
𫢵	亻氏一下
𦰣	艹亻氏一
𣷳	氵广氏一
𡞖	女广氏一
𪽅	广氏一生
𢋴	廿儿冖巾广氏一
掋	扌广氏一
㭽	木广氏一
𦨢	舟氏一
𦅴	尸毛糸氏一
𠴓	口亻氏一

# 界（八・人）
界	田人氘
堺	土田人氘
𤲂	田人氘下
𪽐	丿田人氘
𤋽	火田人氘
𫈨	艹田人氘

# 犮（犬㇕・犬丿）
髮	長彡犬丿
拔	扌犬丿
跋	足犬丿
魃	鬼犬丿
鈸	金犬丿
紱	糸犬丿
菝	艹扌犬丿
祓	示犬丿
黻	业巾𠁼犬丿
茇	艹犬丿
犮	犬丿
沷	氵犬丿
妭	女犬丿
秡	禾犬丿
袚	衤犬丿
軷	車犬丿
韍	韋口㐄犬丿
胈	月犬丿
詙	言犬丿
帗	巾犬丿
蛂	虫犬丿
鼥	鼠犬丿
瞂	𠂆十目犬丿
翇	习习犬丿
𧛌	衣才犬丿

# 鄉・郷
響	乡艮阝立日
曏	日乡艮阝
饗	乡艮阝食
薌	艹乡艮阝
膷	月乡艮阝
蠁	乡艮阝虫
鱜	魚乡艮阝
嚮	乡艮阝向口

# 呂・吕
營	火火冖口丿口
鋁	金口丿口
閭	門口丿口
莒	艹口丿口
櫚	木門口丿口
営	⺍冖口丿口
麿	广木木口丿口
瀯	氵火火冖口丿口
筥	⺮口丿口
梠	木口丿口
絽	糸口丿口
郘	口丿口阝
营	艹冖口丿口
稆	禾口丿口
𣨕	一夕口丿口
𤞪	犭口丿口
𡄀	口丿口艹四十乚
𬩀	之不口丿口
捛	扌口丿口
𫭐	圍口口丿口
𥓅	石口丿口
𥺓	米口丿口
𠴊	口口丿口
𥆻	目口丿口
𡋿	土口丿口
𱜗	口丿口匚㇕
𠭤	口丿口厂又
𫡽	亠八乂口丿口
𡳎	尸毛口丿口
𨓐	之口丿口
𫤉	亻匕頁口丿口
焒	火口丿口
𠒦	小兀口丿口
𣳮	氵口丿口
𫶴	羊工口丿口
𥖕	口丿口石皮
𪡉	口丿口亇
𪁳	口丿口鳥
𤳧	口丿口田共
𫼴	手口丿口
𡱶	尸口丿口
𨹬	阝口丿口
𢙲	心口丿口
㛎	女口丿口
𤀗	氵牛儿口丿口
𥖓	石皮口丿口
𫶷	口丿口巴

# 巳・己・卩
起	走己
包	勹己
選	之己己共
泡	氵勹己
抱	扌勹己
港	氵共己
飽	食勹己
遷	之西大己
胞	月勹己
巽	己己共
躚	足之西大卩
萢	艹氵勹己
砲	石勹己
异	己艹
韆	革之西大卩
僊	亻西大巳
𧽈	走己申丿
𤠳	犭走己
𫎼	走己宀女
𬏌	由走己
𬦗	走己丰木
𧽇	申丿走己

# 次（冫・二）
次	冫欠
資	冫欠貝
姿	冫欠女
瓷	冫欠瓦
茨	艹冫欠
懿	士冖一口䒑冫欠心
諮	言冫欠口
恣	冫欠心
佽	亻冫欠
咨	冫欠口
粢	冫欠米
絘	糸冫欠
趑	走冫欠
蠀	虫冫欠貝
薋	艹冫欠貝
楶	冫欠口木
秶	冫欠禾
羡	羊冫欠
餈	冫欠食
盗	冫欠皿
𣛯	木冫欠皿
𬅧	冫欠目
𪞼	亠乂凵羊冫欠
𬐾	其乚冫欠皿
𬏗	釆田冫欠
𬚺	肉冫欠

# 匀（冫・二）
均	土勹二
鈞	金勹二
筠	⺮土勹二
昀	日勹二
鋆	土勹二金
韵	立日勹二
盷	目勹二
畇	田勹二
荺	艹土勹二
袀	衤勹二

# 市・巿
肺	月亠巾
姉	女亠巾

# 敖（士方・丰力・土方）
熬	土方攵灬
傲	亻土方攵
敖	土方攵
嗷	口土方攵
獒	土方攵犬
鰲	土方攵魚
贅	土方攵貝
螯	土方攵虫
鏊	土方攵金
驁	土方攵馬
遨	之土方攵
嶅	土方攵山
廒	广土方攵
璈	王土方攵
慠	心土方攵
聱	土方攵耳
摮	土方攵手
磝	石土方攵
謷	土方攵言
隞	阝土方攵
蔜	艹土方攵
嚽	口土方攵貝
鼇	土方攵黽
𨎞	車土方攵
𪵧	气土方攵
𫗺	䒑自土方攵
𢳆	扌土方攵
𧑃	虫土方攵

# 囪・囱
總	糸囟夂心
窗	穴囟夂
蔥	艹囟夂心
聰	耳囟夂心
璁	王囟夂心
驄	馬囟夂心
傯	亻囟夂心
蟌	虫囟夂心
熜	火囟夂心
摠	扌囟夂心
謥	言囟夂心
骢	馬囟夂心
𦪐	舟囟夂心
鏓	金囟夂心
𤄋	氵糸囟夂心

# 单・単
蝉	虫⺍甲一
惮	心⺍甲一
禅	示⺍甲一
箪	⺮⺍甲一
𱔩	口⺍甲一戈

# 亏
虧	虎隹丂一

# 敢（㇕・丁）
敢	丁耳攵
嚴	口口厂丁耳攵
巖	山口口厂丁耳攵
憨	丁耳攵心
闞	門丁耳攵
儼	亻口口厂丁耳攵
瞰	目丁耳攵
橄	木丁耳攵
釅	酉口口厂丁耳攵
噉	口丁耳攵
澉	氵丁耳攵
厳	⺍厂丁耳攵
撖	扌丁耳攵
巌	山⺍厂丁耳攵
玁	犭口口厂丁耳攵
矙	目門丁耳攵
豃	八人口丁耳攵
曮	日口口厂丁耳攵
譀	言丁耳攵
鬫	鬥丁耳攵
㘎	口門丁耳攵
阚	門丁耳攵
𨅺	足丁耳攵
𥼲	米丁耳攵
𥍛	目山口口厂丁耳攵
㘙	口口口厂丁耳攵
𡆑	口山口口厂丁耳攵
𡑒	土丁耳攵

# 蚤（丶・冫）
騷	馬又冫虫
搔	扌又冫虫
蚤	又冫虫
瘙	疒又冫虫
溞	氵又冫虫
瑵	王又冫虫
慅	心又冫虫
鼜	士口䒑十又又冫虫
糔	米又冫虫
颾	風又冫虫
𦞣	月又冫虫
𠋺	亻又冫虫
𦃐	糸又冫虫

# 堇（廿・艹）
僅	亻艹口丰
勤	艹口丰力
謹	言艹口丰
瑾	王艹口丰
堇	艹口丰
槿	木艹口丰
饉	食艹口丰
覲	艹口丰見
鄞	艹口丰阝
慬	心艹口丰
瘽	疒艹口丰
廑	广艹口丰
殣	一夕艹口丰
蓳	艹艹口丰
墐	土艹口丰
騹	馬艹口丰
螼	虫艹口丰
懃	艹口丰力心
𫦽	艹口丰力生
𥵚	⺮艹口丰力
𣝀	木艹口丰力
𡀣	口艹口丰力
𤄲	氵言艹口丰
𤯺	生艹口丰力
𡄾	口言艹口丰
𢥢	心言艹口丰

# 廿口夫・艹口夫
難	艹口夫隹
漢	氵艹口夫
攤	扌艹口夫隹
嘆	口艹口夫
灘	氵艹口夫隹
歎	艹口夫欠
癱	疒艹口夫隹
艱	艹口夫艮
儺	亻艹口夫隹
戁	艹口夫隹心
熯	火艹口夫
暵	日艹口夫
臡	艹口夫隹肉
䕼	艹艹口夫隹
𡁚	口氵艹口夫
𬥮	艹口夫八刀貝
𨫪	金艹口夫
𪝳	亻氵艹口夫
𪪫	艹口夫广車
𧄊	艹日十艹口夫
𡔃	土艹口夫隹
𢠦	心艹口夫
𥸁	⺮艹口夫隹
𦣎	月艹口夫隹
𢥪	心艹口夫隹
𡅧	口艹口夫隹

# 虛・虚
墟	土虎业
覷	虎业見
歔	虎业欠
譃	言虎业
虡	虎业八
魖	鬼虎业
驉	馬虎业
鱋	魚虎业
戯	虎业戈
𨼋	阝虎业
𬞲	艹虎业一丂
𱢱	日虎业一丂
𢣧	心虎业一丂
𫣞	亻虎业
𪹣	火虎业

# 拐（力・刀）
拐	扌口刀

# 屯（一・丿）
純	糸丿屮
噸	口丿屮頁
頓	丿屮頁
屯	丿屮
鈍	金丿屮
囤	圍丿屮
扽	扌丿屮
盹	目丿屮
沌	氵丿屮
肫	月丿屮
邨	丿屮阝
飩	食丿屮
砘	石丿屮
窀	穴丿屮
魨	魚丿屮
迍	之丿屮
忳	心丿屮
坉	土丿屮
庉	广丿屮
軘	車丿屮
芚	艹丿屮
杶	木丿屮
訰	言丿屮
瓲	瓦丿屮
吨	口丿屮
莼	艹糸丿屮
炖	火丿屮
𢵶	扌金丿屮
𡶁	山丿屮
𣔝	木之丿屮
㹠	犭丿屮
𦟒	丿屮月𠂊厂卩
𧉙	虫丿屮
𦡋	月丿屮頁
𡴢	丿屮䒑业
𥇈	目圍丿屮
𧿬	足丿屮
𡴉	丿屮凡
𡚃	金丿屮大
𥂉	丿屮冫欠皿
𫃉	西米丿屮
𧘸	衤丿屮
𩂄	雨丿屮
𦝊	月之丿屮
𬙴	羊大丿屮
𡭻	小大丿屮
𤵊	疒丿屮
𢲝	糸丿屮手

# 反（𠂆・厂）
版	片厂又
飯	食厂又
反	厂又
板	木厂又
返	之厂又
販	貝厂又
扳	扌厂又
坂	土厂又
阪	阝厂又
叛	半厂又
畈	田厂又
鈑	金厂又
皈	白厂又
仮	亻厂又
舨	舟厂又
蝂	虫片厂又
粄	米厂又
昄	日厂又
魬	魚厂又
眅	目厂又
汳	氵厂又
𦙀	月厂又
𪠭	厂又阝且
𢆕	平厂又
𥾵	糸厂又
𫷰	广木厂又
𧿨	足厂又
𥯈	⺮木厂又
𫩍	厂又雨田
𢴔	扌貝厂又

# 俞（刂・巛）
輸	車亼月巛
愈	亼月巛心
渝	氵亼月巛
逾	之亼月巛
瑜	王亼月巛
諭	言亼月巛
愉	心亼月巛
癒	疒亼月巛心
踰	足亼月巛
嵛	山亼月巛
窬	穴亼月巛
揄	扌亼月巛
覦	亼月巛見
褕	衤亼月巛
腧	月亼月巛
蝓	虫亼月巛
毹	亼月巛毛
鄃	亼月巛阝
隃	阝亼月巛
牏	片亼月巛
歈	亼月巛欠
蕍	艹氵亼月巛
睮	目亼月巛
羭	羊亼月巛
緰	糸亼月巛
崳	山亼月巛
媮	女亼月巛
瘉	疒亼月巛
鍮	金亼月巛
㺄	犭亼月巛
𤭷	瓦亼月巛
𬲇	亼月巛心几二
𪿐	矢車亼月巛
𫗄	几二亼月巛心
𬕷	⺮亼月巛心
𬲂	几二亼月巛
𫕲	雨之亼月巛
𣜴	木亼月巛心
𪱎	日生亼月巛
𬲠	食亼月巛心
𥣒	禾亼月巛心
𦾤	艹亼月巛心
𩙌	几二之亼月巛
𤀒	氵亼月巛心
匬	匚亼月巛
𪬪	个亼月巛心
𫗃	几二亼月巛心
𩙍	風亼月巛心
𨮋	金亼月巛心
𩙋	風之亼月巛
𬰅	雨亼月巛
𢷀	扌亼月巛心
𫖾	亼月巛几二

# 强・強
犟	弓厶虫牛
鏹	金弓厶虫
襁	衤弓厶虫
糨	米弓厶虫
蔃	艹弓厶虫
漒	氵弓厶虫
膙	月弓厶虫
𫋙	虫弓厶虫
𪻈	犭弓厶虫

# 臣𠂉丶・臣𠂉一
藍	艹臣𠂉一皿
監	臣𠂉一皿
艦	舟臣𠂉一皿
攬	扌臣𠂉一四見
籃	⺮臣𠂉一皿
濫	氵臣𠂉一皿
鑑	金臣𠂉一皿
覽	臣𠂉一四見
纜	糸臣𠂉一四見
檻	木臣𠂉一皿
欖	木臣𠂉一四見
鑒	臣𠂉一四金
尷	尢臣𠂉一皿
覧	臣𠂉一見
襤	衤臣𠂉一皿
爁	火臣𠂉一皿
礛	石臣𠂉一皿
轞	車臣𠂉一皿
𡽾	山臣𠂉一皿
𧕭	虫艹臣𠂉一皿
㺝	犭臣𠂉一皿
𤑸	火臣𠂉一見
𪸄	氵臣𠂉一皿亇
𥍖	目臣𠂉一四見
𡅋	口木臣𠂉一皿
𤓆	火艹臣𠂉一皿
㜮	女臣𠂉一皿
𫶻	巴臣𠂉一皿
𥍍	目艹臣𠂉一皿
𡔑	土臣𠂉一四見
𩁱	隹木臣𠂉一皿
𫬠	口臣𠂉一見
𨇣	足臣𠂉一見
𧖐	虫臣𠂉一四見
𨰲	金臣𠂉一四見
𤼓	疒艹臣𠂉一皿
嚂	口臣𠂉一皿
𱶭	禾艹臣𠂉一皿
𣡓	木⺮臣𠂉一皿
𥌈	目臣𠂉一皿
囕	口臣𠂉一四見
㩜	扌臣𠂉一皿
𦡶	月臣𠂉一皿
懢	忄臣𠂉一皿
𠑈	亻氵臣𠂉一皿
𥗽	石臣𠂉一四見
𣠩	木艹臣𠂉一皿

# 最（日・冖二）
最	日耳又
撮	扌日耳又
蕞	艹日耳又
嘬	口日耳又
𣋁	日日耳又
襊	衤日耳又
繓	糸日耳又
樶	木日耳又
𢢇	忄日耳又
㵊	氵日耳又
𪱕	日耳又亇
熶	火日耳又
𥊴	目日耳又

# 免・兔
逸	之免

# 亻丨夂・亻丨攵
條	亻丨攵木
修	亻丨攵彡
滌	氵亻丨攵木
絛	亻丨攵糸
脩	亻丨攵月
倏	亻丨攵犬
篠	⺮亻丨攵木
鰷	魚亻丨攵木
翛	亻丨攵习习
蓧	艹亻丨攵木
儵	亻丨攵四土灬
鞗	亻丨攵革
鯈	亻丨攵魚
蓨	艹亻丨攵月
滫	氵亻丨攵月
蓚	艹亻丨攵彡
窱	穴亻丨攵木
虪	虎亻丨攵四土灬
䗛	虫亻丨攵月
𪅭	亻丨攵月鳥
𬗲	糸亻丨攵彡
𡪇	宀丁亻丨攵彡
𠺧	口亻丨攵木
