的	白勹丶
了	了
我	手戈
是	日一止
在	大丨土
你	亻⺈小
和	禾口
有	大月
不	不
就	亠口小尤
都	者阝
也	也
要	西女
吧	口巴
好	女子
他	亻也
說	言八口儿
去	土厶
到	至刂
沒	氵勹又
還	之四一口𧘇
上	上
對	业羊寸
那	刀二阝
人	人
個	亻圍十口
看	手目
中	中
呢	口尸匕
來	木人人
嗎	口馬
會	人一四日
她	女也
與	臼一乚丨八
給	絲人一口
等	⺮土寸
這	之言
用	用
把	扌巴
下	一卜
恩	圍大心
能	厶月匕匕
很	行艮
多	夕夕
做	亻十口攵
想	木目心
點	四二灬卜口
被	衤皮
地	土也
而	而
一	一
後	行幺夂
又	又
從	行人人止
再	一冂土
將	爿夕寸
時	日土寸
但	亻日一
過	之咼
打	扌丁
大	大
年	𠂉㐄
麼	广木木幺
啦	口扌立
以	厶人
買	四貝
讓	言亠口口甘𧘇
嗯	口圍大心
小	小
得	行日一寸
先	牛儿
啊	口阝丁口
或	戈口一
呀	口牙
找	扌戈
新	立木斤
及	㇆人
跟	足艮
於	方人冫
太	大丶
嘛	口广木木
號	口了虎
日	日
才	寸丿
可	丁口
比	匕匕
玩	王二儿
們	亻門
最	日耳又
月	月
真	十且八
吃	口𠂉乙
發	癶弓殳
並	䒑业
它	宀匕
其	其
話	言舌
請	言丰月
錢	金戈戈
叫	口凵
開	門一艹
出	凵山
誰	言隹
哈	口人一口
當	小冖口田
向	自口
家	宀豕
問	門口
之	之
更	一日乂
該	言亠乡人
走	走
快	忄㇕大
別	口力刂
前	䒑月刂
由	由
高	亠口冂口
您	亻⺈小心
加	力口
所	斤㇕斤
天	一大
卻	八人口卩
已	己
里	甲二
內	冂人
寫	宀臼勹灬
老	者匕
搞	扌亠口冂口
行	行
事	寸口彐
拿	人一口手
帶	廿儿冖巾
如	女口
死	一夕匕
賣	士四貝
暈	日冖車
像	亻⺈口豕
使	亻大口丶
剛	冂䒑山刂
成	戊㇆
無	𠂉廿灬
換	扌⺈冂八大
只	口八
哪	口刀二阝
愛	爪冖心夂
回	圍口
聽	耳王十四一心
少	小丿
元	二儿
卡	上卜
靠	牛口非
幫	土土寸白巾
算	⺮目艹
者	者
忙	忄亡
起	走己
各	夂口
學	臼乂乂子
分	八刀
咯	口夂口
總	絲鬼夂心
則	貝刂
水	水
張	弓長
改	己攵
唉	口厶矢
三	三
見	見
連	之車
車	車
放	方攵
全	人王
按	扌宀女
區	匚口口口
萬	艹日冂厶
機	木幺幺戈人
早	日十
拉	扌立
弄	王艹
本	木一
偶	亻日冂厶
頁	頁
進	之隹
性	忄生
第	⺮弓亻
完	宀二儿
同	冂一口
花	艹亻匕
長	長
怕	忄白
女	女
講	言甘冂土
殺	乂木殳
組	絲且
錯	金廿日
些	止匕二
住	亻丶王
名	夕口
跑	足勹巳
次	冫欠
網	絲冂䒑亡
睡	目千艹二
裝	爿士亠𧘇
哦	口手戈
挺	扌廴丿士
王	王
圖	圍口十圍口
掉	扌卜日十
路	足夂口
正	一止
外	夕卜
二	二
頭	一口䒑頁
應	广亻隹心
生	生
心	心
因	圍大
子	子
強	弓厶虫
類	米大丶頁
作	亻𠂉卜
送	之䒑大
書	彐二日
每	𠂉母
法	氵土厶
乖	千丬匕
拍	扌白
市	亠巾
撒	扌廿月攵
至	至
接	扌立女
美	羊大
表	丰𧘇
未	二小
辦	辛力辛
非	非
級	絲㇆人
即	艮卩
哎	口艹乂
此	止匕
差	羊工
版	片斤又
併	亻䒑艹
副	一口田刂
系	丿絲
收	凵攵
男	田力
俺	亻大日乚
字	宀子
兩	一巾人人
股	月殳
轉	車車寸
便	亻一日乂
考	者了
塊	土鬼
線	絲白水
手	手
黃	廿一由八
道	之䒑自
米	米
座	广人人土
豬	豕者
聊	耳氏卩
取	耳又
低	亻氏丶
難	廿口夫隹
哇	口土土
兒	臼儿
受	爪冖又
包	勹巳
阿	阝丁口
喝	口日勹人乚
白	白
金	金
四	四
近	之斤
管	⺮宀㠯
定	宀一止
傳	亻車寸
門	門
樣	木羊丶水
夠	夕夕勹口
交	亠八乂
李	木子
笑	⺮丿大
自	自
邊	之自穴方
型	一艹刂土
黑	四二灬
慢	忄日四又
刷	尸巾刂
穿	穴牙
越	走戈乚
位	亻立
貴	中一貝
部	立口阝
稱	禾爪冂土
處	虎夂几
選	之巳巳廿八
站	立卜口
牛	牛
怪	忄又土
省	小丿目
倒	亻至刂
談	言火火
曾	丷四日
經	絲一巛工
數	數女攵
據	扌虎豕
變	言絲絲攵
累	田絲
汗	氵一十
查	木日一
象	⺈口豕
半	半
陳	阝木日
紅	絲工
格	木夂口
五	工㇕
幹	十日十人一十
樓	木數女
方	方
讀	言士四貝
頂	丁頁
某	甘木
條	亻丨夂木
亂	爪又冂厶又乚
唔	口工㇕口
馬	馬
遠	之土口𧘇
單	口口日十
海	氵𠂉母
相	木目
熱	土八土丸灬
光	小尤
咋	口𠂉卜
風	風
且	且
林	木木
滿	氵廿巾人人
額	宀夂口頁
化	亻匕
班	王刂王
滴	氵亠丷冂十口
掛	扌土土卜
關	門幺幺凵二
漲	氵弓長
店	广卜口
安	宀女
坐	人人土
約	絲勹丶
飛	乙冫丿川乙冫
劉	氏丶刀金刂
度	广廿又
種	禾千日二
俄	亻手戈
歌	丁口丁口欠
報	土半卩又
信	亻言
若	艹大口
原	厂白小
文	文
飯	食斤又
晚	日⺈口儿
量	日一甲二
村	木寸
式	弋工
空	穴工
山	山
賺	貝䒑彐刂八
毛	毛
重	千日二
主	丶王
另	口力
間	門日
裡	衤甲二
貼	貝卜口
入	人
伐	亻戈
血	丿皿
盤	舟殳皿
爽	大乂乂乂乂
隊	阝丷豕
楊	木日一勹彡
臺	士口冖至
往	行丶王
片	片
國	圍戈口一
狗	犭勹口
歲	止戊一小
費	弓川貝
壞	土亠四水𧘇
龍	龍
離	亠乂凵冂厶隹
共	廿八
西	西
佔	亻卜口
周	周土口
超	走刀口
明	日月
媽	女馬
均	土勹冫
期	其月
達	之土羊
照	日刀口灬
切	七刀
留	氏丶刀田
動	千日二力
特	牛土寸
氣	气米
係	亻丿絲
神	礻申
鳥	鳥
畫	彐二田一
夢	艹四冖夕
教	者子攵
哥	丁口丁口
甘	甘
蠻	言絲絲虫
魚	魚
值	亻十且
鎮	金十且八
么	丿厶
罵	四馬
陪	阝立口
既	艮七儿
哭	口口大丶
力	力
建	廴彐二
洗	氵牛儿
懂	忄艹千日二
雙	隹隹又
口	口
指	扌匕日
東	木日
球	王寸氵丶
仍	亻㇆丿
活	氵舌
跌	足牛人
練	絲木四
億	亻立日心
清	氵丰月
提	扌日一止
除	阝人禾
通	之又用
酒	氵酉
貓	豸艹田
餓	食手戈
票	西示
六	亠八
病	疒
假	亻㇕卜㇕又
久	⺈丶
段	亻三殳
平	一丷十
抓	扌爪
套	大長
課	言日木
急	⺈彐心
藥	艹白幺幺木
城	土戊㇆
任	亻丿士
草	艹日十
羅	四絲隹
理	王甲二
令	人之
雨	雨
貨	亻匕貝
唱	口日日
左	大工
藍	艹臣⺮皿
縣	且小丿絲
常	小冖口巾
色	⺈巴
搶	扌人户口
菜	艹爪木
喲	口絲勹丶
集	隹木
感	戊一口心
房	户方
較	車亠八乂
混	氵日匕匕
敢	㇕耳攵
火	火
臉	月人一口口人人
操	扌口口口木
南	十冂半
退	之艮
件	亻牛
吳	口乚大
破	石皮
聲	士尸殳耳
德	行十四一心
雪	雨彐
局	尸㇆口
雲	雨二厶
噢	口自米大
整	木口攵一止
傻	亻鬼乂八夂
華	艹一艹工
克	十口儿
呃	口厂巳
喊	口戊一口
現	王見
跳	足氵儿
養	羊丶艮
補	衤甫
團	圍車寸
沈	氵冖儿
反	斤又
樂	白幺幺木
篇	⺮户冂艹
待	行土寸
砸	石匚巾
深	氵冖八木
煩	火頁
根	木艮
求	寸氵丶
投	扌殳
電	雨日乚
親	立木見
惡	一业心
葉	艹廿乚木
款	士示欠
知	矢口
八	八
配	酉己
器	口口大丶口口
何	亻丁口
率	亠幺氵十
調	言周土口
鬼	鬼
修	亻丨夂彡
試	言弋工
謝	言身寸
僅	亻廿口丰
層	尸丷四日
面	石圍卜丨
週	之周土口
北	丬匕
木	木
份	亻八刀
記	言己
趙	走小月
情	忄丰月
肉	冂人人
需	雨而
七	七
論	言人一冂艹
流	氵亠厶川
招	扌刀口
痛	疒又用
列	一夕刂
石	石
香	禾日
封	土土寸
眼	目艮
易	日勹彡
冷	冫人之
借	亻廿日
派	氵斤氏
帥	丿㠯巾
付	亻寸
十	十
廠	广小冂口攵
陽	阝日一勹彡
樹	木士口䒑寸
油	氵由
胡	十口月
排	扌非
停	亻亠口冖丁
合	人一口
軍	冖車
身	身
奧	自丿釆大
章	立日十
科	禾冫十
倆	亻一巾人人
星	日生
牌	片鬼十
權	木艹口口隹
翻	釆田习习
隨	阝之大工月
場	土日一勹彡
帖	巾卜口
商	亠丷冂八口
庫	广車
價	亻西貝
物	牛勹彡
泡	氵勹巳
寶	宀王牛山貝
玉	王丶
體	骨日刂一口䒑
追	之丿㠯
傷	亻𠂉日一勹彡
背	丬匕月
腳	月八人口卩
丟	王厶
劍	人一口口人人刂
解	⺈用刀牛
室	宀至
底	广氏丶
業	业丷三小
代	亻弋
孫	子丿絲
朱	牛小
亦	亠川八
須	彡頁
舊	艹隹臼
乾	十日十𠂉乙
工	工
咱	口自
詞	言㇆一口
刀	刀
喔	口尸至
波	氵皮
證	言癶一口䒑
鐵	金土口王戈
推	扌隹
落	艹氵夂口
節	⺮艮卩
春	春
輕	車一巛工
笨	⺮木一
九	九
輸	車人一月刂
江	氵工
短	矢一口䒑
含	人丶㇕口
千	千
炒	火小丿
藉	艹三小廿日
丫	丷丨
徐	行人禾
騙	馬户冂艹
秒	禾小丿
青	丰月
耍	而女
夜	亠亻夂丶
許	言𠂉十
吹	口欠
師	丿㠯一巾
板	木斤又
土	土
贏	亡口月貝凡
姐	女且
直	十且
公	八厶
苦	艹十口
秀	禾㇆丿
博	十甫寸
皮	皮
朝	十日十月
君	尹口
詩	言土寸
爛	火門木四
靜	丰月爪彐
利	禾刂
素	丰絲
立	立
存	大丨子
燒	火土土土尤
斷	幺幺一幺幺乚斤
吾	工㇕口
虧	虎隹一了
湯	氵日一勹彡
民	巳七
極	木了口又一
命	人一口卩
忘	亡心
茶	艹人木
冰	冫水
供	亻廿八
案	宀女木
田	田
初	衤刀
品	口口口
抽	扌由
造	之牛口
抱	扌勹巳
野	甲二又㇕丨
綠	絲彑水
項	工頁
獎	爿夕寸大丶
胖	月半
緊	臣又絲
故	十口攵
服	月卩又
盡	彐一灬皿
百	一白
兵	丘八
英	艹冂大
蘇	艹魚禾
般	舟殳
演	氵宀一由八
嘴	口止匕⺈用
簽	⺮人口口人人
填	土十且八
果	日木
保	亻口木
唐	广彐口
雞	爪幺大隹
夏	一自夂
莫	艹日大
硬	石一日乂
寒	宀甘八冫
挖	扌穴乙
凡	凡
髮	長彡大又丶
言	言
題	日一止頁
防	阝方
街	行土土
距	足匚㇕
挑	扌氵儿
純	絲七凵
鬧	刂王王亠巾
欲	八人口欠
竟	立日儿
源	氵厂白小
官	宀㠯
戲	虎一口䒑戈
寄	宀大丁口
古	十口
首	䒑自
思	田心
橋	木丿大口冂口
燈	火癶一口䒑
郭	亠口子阝
亮	亠口冖几
干	一十
屬	尸水四勹虫
窮	穴身弓
粉	米八刀
爆	火日廿八水
韓	十日十韋口㐄
刪	冂艹刂
戴	土田廿八戈
然	夕大丶灬
衝	行千日二
疼	疒夂冫
雷	雨田
蓋	艹土厶皿
港	氵廿八巳
租	禾且
狼	犭丶艮
蘭	艹門木四
狂	犭王
布	大巾
引	弓丨
壓	厂日月大丶土
亞	一业
捏	扌日土
齊	亠丷丨刀氏川
隻	隹又
賽	宀甘八貝
員	口貝
佛	亻弓川
食	食
船	舟几口
今	人丶㇕
恨	忄艮
宋	宀木
銀	金艮
猛	犭子皿
客	宀夂口
黨	小冖口四二灬
雖	口虫隹
碼	石馬
友	大又
領	人之頁
句	勹口
斯	其斤
沙	氵小丿
戰	口口日十戈
哼	口亠口了
望	亡月王
腿	月之艮
沖	氵中
丁	丁
園	圍土口𧘇
祝	礻口儿
鄉	乡丶艮阝
鄭	丷酉大阝
界	田八川
抗	扌亠几
步	止小
河	氵丁口
缺	牛山㇕大
賊	貝戈大
尚	小冂口
似	亻厶人
羊	羊
福	礻一口田
必	心丿
遭	之艹日日
煙	火西土
否	不口
端	立山而
設	言殳
猜	犭丰月
伊	亻尹
秦	春禾
秋	禾火
毒	丰母
架	力口木
熊	厶月匕匕灬
持	扌土寸
廣	广廿由八
插	扌千臼
歸	丿㠯止彐冖巾
折	扌斤
滾	氵亠八口𧘇
靈	雨口口口工人人
意	立日心
呆	口木
基	其土
困	圍木
圈	圍半巳
迷	之米
趕	走日一十
踢	足日勹彡
勝	月半力
史	口乂
甲	甲
呵	口丁口
搬	扌舟殳
獲	犭艹隹又
紙	絲氏
乃	㇆丿
覺	臼乂乂見
右	大口
塔	土艹人一口
準	氵隹十
拖	扌𠂉也
摸	扌艹日大
院	阝宀二儿
慘	忄厶厶厶人彡
訂	言丁
散	廿月攵
松	木人厶
爸	八乂巴
喜	士口䒑口
洋	氵羊
語	言工㇕口
呈	口王
治	氵厶口
降	阝夂㐄
漢	氵廿口夫
富	宀一口田
姓	女生
料	米冫十
嘎	口一自戈
結	絲士口
閃	門人
咬	口亠八乂
梅	木𠂉母
批	扌匕匕
戶	斤㇕
足	足
寧	宀心皿丁
爬	爪巴
醒	酉日生
狠	犭艮
逛	之犭王
精	米丰月
瘦	疒臼丨又
瘋	疒風
踩	足釆
槍	木人户口
軟	車欠
偷	亻人一月刂
支	十又
杜	木土
麗	一冂丶一冂丶鹿
鞋	革土土
展	尸艹展
興	臼冂一口八
依	亻亠𧘇
倍	亻立口
康	广彐氵
堂	小冖口土
救	寸氵丶攵
觀	艹口口隹見
鍵	金廴彐二
製	牛巾刂亠𧘇
餘	食人禾
筆	⺮彐二
音	立日
世	廿乚
著	艹者
仲	亻中
舞	𠂉廿夕㐄
守	宀寸
露	雨足夂口
冒	日目
榮	火火冖木
弱	弓冫弓冫
影	日亠口小彡
州	⺍川
替	夫夫日
逼	之一口田
陸	阝土八土
曲	日刂
願	厂白小頁
牙	牙
箱	⺮木目
嚇	口土川八土川八
測	氵貝刂
莊	艹爿士
寬	宀艹見丶
遍	之户冂艹
細	絲田
狀	爿大丶
巴	巴
閒	門月
武	一弋止
湖	氵十口月
聯	耳幺幺凵二
程	禾口王
柳	木氏丿卩
偏	亻户冂艹
實	宀母貝
印	氏一卩
味	口二小
鎖	金小貝
零	雨人之
環	王四一口𧘇
角	⺈用
紫	止匕絲
勒	革力
島	鳥山
耶	耳阝
熟	亠口子丸灬
孔	子乚
寸	寸
標	木西示
歐	匚口口口欠
厚	厂日子
答	⺮人一口
社	礻土
懶	忄木口⺈貝
顧	户隹頁
順	川頁
滅	氵戊一火
運	之冖車
輪	車人一冂艹
兼	䒑彐刂八
溫	氵圍人皿
娘	女丶艮
登	癶一口䒑
悶	門心
微	行山一几攵
佳	亻土土
瞭	目人丷日小
雅	牙隹
魔	广木木鬼
司	㇆一口
拋	扌尤力
志	士心
奇	大丁口
編	絲户冂艹
瓦	瓦
居	尸十口
憑	冫馬心
盛	戊㇆皿
奶	女㇆丿
虎	虎
后	斤一口
洞	氵冂一口
台	厶口
形	一艹彡
負	⺈貝
川	川
檔	木小冖口田
圓	圍口貝
牆	爿土人人圍口
充	亠厶儿
害	宀丰口
喂	口田展
免	⺈口儿
景	日亠口小
擬	扌匕矢又㇕止
穩	禾爪工彐心
曹	艹日日
曉	日土土土尤
煮	者灬
良	丶艮
蛋	㇕止虫
吐	口土
肥	月巴
仙	亻山
宮	宀口鬼
碰	石䒑业
酸	酉厶八夂
侯	亻㇕矢
塞	宀甘八土
嘍	口數女
脫	月八口儿
勁	一巛工力
欠	欠
創	人户口刂
擦	扌宀夗示
爾	一八巾乂乂乂乂
藏	艹戈爿臣
皆	匕匕白
屁	尸匕匕
永	丶水
夫	夫
掙	扌爪彐
琴	王王人丶㇕
錄	金彑水
餵	食田展
稅	禾八口儿
宏	宀大厶
例	亻一夕刂
專	車寸
砍	石欠
視	礻見
繼	絲幺幺一幺幺乚
兄	口儿
產	文厂生
善	羊䒑口
增	土丷四日
施	方𠂉也
淚	氵户大丶
暗	日立日
忍	刀丶心
肯	止月
母	母
聖	耳口王
橫	木廿一由八
遊	之方𠂉子
艾	艹乂
致	至攵
宗	宀示
偉	亻韋口㐄
麻	广木木
怒	女又心
扔	扌㇆丿
爭	爪彐
游	氵方𠂉子
鄧	癶一口䒑阝
腰	月西女
嫩	女木口攵
肖	小月
淨	氵爪彐
罪	四非
仔	亻子
彈	弓口口日十
丑	㇕十
減	氵戊一口
敏	𠂉母攵
義	羊手戈
棒	木春工
臭	自大丶
響	乡丶艮阝立日
聞	門耳
拆	扌斤丶
蔡	艹夗示
計	言十
絲	絲絲
校	木亠八乂
氏	氏
糖	米广彐口
吉	士口
押	扌甲
馮	冫馬
吵	口小丿
谷	八人口
麥	木人人夕
衣	亠𧘇
宇	宀一寸
雜	亠人人木隹
末	一木
潘	氵釆田
告	牛口
旁	亠丷冖方
耐	而寸
董	艹千日二
榜	木亠丷冖方
醉	酉亠人人十
鍾	金千日二
妹	女二小
鋼	金冂䒑山
蔣	艹爿寸
幣	水冂攵巾
宜	宀且
尼	尸匕
灰	大火
評	言一丷十
維	絲隹
絕	絲刀巴
屋	尸至
幾	幺幺戈人
楚	木木㇕止
屆	尸土凵
館	食宀㠯
丹	周亠
乘	丿木丬匕
認	言刀丶心
刻	亠乡人刂
俊	亻厶八夂
芳	艹方
抄	扌小丿
夾	大人人
酷	酉牛口
京	亠口小
嚴	口口厂㇕耳攵
返	之斤又
礦	石广廿由八
廳	广耳王十四一心
魯	魚日
瑞	王山而
仁	亻二
飄	西示風
註	言丶王
添	氵一大忄
催	亻山隹
具	且八
威	戊一女
劇	虎豕刂
核	木亠乡人
農	日刂辰
瓶	䒑艹瓦
銅	金冂一口
犯	犭巳
族	方𠂉矢
季	禾子
尋	彐工口寸
顯	日幺幺灬頁
骨	骨
嘿	口四二灬
鏈	金之車
擺	扌四厶月匕匕
擠	扌亠丷丨刀氏川
黎	禾勹丿人水
騎	馬大丁口
密	宀心丿山
士	士
術	行木丶
炸	火𠂉卜
祇	礻氏
洪	氵廿八
訊	言乙十
腦	月巛鬼乂
禮	礻日刂一口䒑
容	穴人口
輝	小尤冖車
射	身寸
智	矢口日
索	十冖絲
聚	耳又乑
拼	扌䒑艹
燕	廿口丬匕灬
撞	扌立甲二
膜	月艹日大
普	䒑业日
竹	⺮
魏	禾女鬼
澤	氵四土半
側	亻貝刂
諾	言艹大口
呂	口鬼
范	艹氵巳
搭	扌艹人一口
鳳	几一鳥
袁	土口𧘇
扯	扌止
鑽	金牛儿牛儿貝
彭	士口䒑彡
陰	阝人丶㇕二厶
唸	口人丶㇕心
薄	艹氵甫寸
涼	氵亠口小
曰	日
胃	田月
鹽	臣𠂉卜圍乂皿
賴	木口⺈貝
獨	犭四勹虫
窩	穴咼
堆	土隹
赴	走卜
載	土車戈
躲	身几木
孟	子皿
抵	扌氏丶
甜	舌甘
舉	臼一乚丨八工
彩	爪木彡
甚	其乚
厄	厂巳
粗	米且
傑	亻夕㐄木
噸	口七凵頁
慶	鹿㇕心夂
緣	絲彑豕
駐	馬丶王
申	申
衛	行韋口㐄
訓	言川
念	人丶㇕心
蕭	艹彐片爿
惹	艹大口心
帳	巾長
勸	艹口口隹力
讚	言牛儿牛儿貝
盒	人一口皿
逃	之氵儿
嘉	士口䒑力口
納	絲冂人
升	丿艹
倉	人户口
姚	女氵儿
休	亻木
症	疒一止
斤	斤
功	工力
喇	口木口刂
釦	金口
浪	氵丶艮
扣	扌口
泰	春水
忠	中心
梁	氵刀八木
吸	口㇆人
貝	貝
跨	足大一了
盧	虎田皿
森	木木木
瞎	目宀丰口
卷	半巳
于	一寸
井	二川
針	金十
蛇	虫宀匕
寺	土寸
購	貝甘冂土
導	之䒑自寸
飲	食欠
噴	口十十十貝
虛	虎业
屏	尸䒑艹
優	亻一白冖心夂
灌	氵艹口口隹
埋	土甲二
略	田夂口
掃	扌彐冖巾
吶	口冂人
目	目
蒙	艹冖一豕
託	言丿七
托	扌丿七
巧	工了
淡	氵火火
賤	貝戈戈
拜	手一丰
冬	夂冫
娜	女刀二阝
懷	忄亠四水𧘇
池	氵也
敲	亠口冂口卜又
凱	山一口䒑几
鐘	金立甲二
愁	禾火心
鋪	金甫
薩	艹阝立丿生
揚	扌日一勹彡
勇	又用力
財	貝寸丿
鍊	金木四
終	絲夂冫
質	斤斤貝
泥	氵尸匕
昏	氏日
遇	之日冂厶
喬	丿大口冂口
欄	木門木四
鍋	金咼
巨	匚㇕
儀	亻羊手戈
遲	之尸水牛
怎	𠂉卜心
磨	广木木石
呼	口丿丷寸
賭	貝者
液	氵亠亻夂
泉	白水
嫁	女宀豕
捲	扌半巳
汪	氵王
稍	禾小月
薛	艹丿㠯辛
賈	西貝
豆	一口䒑
頓	七凵頁
旺	日王
儂	亻日刂辰
攻	工攵
祥	礻羊
委	禾女
佐	亻大工
臨	臣𠂉口口口
隔	阝一口冂丷丁
繞	絲土土土尤
輛	車一巾人人
崔	山隹
溝	氵甘冂土
碗	石宀夗
賠	貝立口
吻	口勹彡
健	亻廴彐二
速	之木口
失	牛人
雄	大厶隹
胸	月勹乂凵
框	木匚王
鬥	刂王王
暴	日廿八水
湊	氵春一大
陣	阝車
識	言立日戈
娃	女土土
唯	口隹
漏	氵尸雨
拔	扌大又丶
洛	氵夂口
探	扌冖八木
碟	石廿乚木
郎	丶艮阝
珠	王牛小
劑	亠丷丨扌刀氏川刂
尿	尸水
透	之禾㇆丿
惠	車心
譚	言西日十
營	火火冖口鬼
府	广亻寸
菲	艹非
叼	口㇆一
父	八乂
耳	耳
殘	一夕戈戈
窗	穴鬼夂
搜	扌臼丨又
希	乂大巾
患	口中心
尾	尸毛
播	扌釆田
岩	山石
逗	之一口䒑
廢	广癶弓殳
賢	臣又貝
限	阝艮
帝	亠丷冖巾
昌	日日
模	木艹日大
磚	石車寸
扁	户冂艹
舒	人舌又㇕丨
嫌	女䒑彐刂八
陶	阝勹牛山
苗	艹田
剪	䒑月刂刀
羽	习习
哩	口甲二
稿	禾亠口冂口
棟	木木日
邦	丰阝
撿	扌人一口口人人
玲	王人之
驚	艹勹口攵馬
坑	土亠几
備	亻廿丿用
撥	扌癶弓殳
袋	亻弋亠𧘇
趁	走人彡
妖	女丿大
甩	月乚
錦	金白巾
溼	氵一幺幺土
琳	王木木
乙	乙
伴	亻半
淺	氵戈戈
尊	丷酉寸
顏	文厂彡頁
匯	匚氵隹
熬	丰力攵灬
吊	口巾
霜	雨木目
沿	氵几口
伯	亻白
盜	氵欠皿
浩	氵牛口
剩	禾丬匕刂
域	土戈口一
祖	礻且
肺	月一巾
附	阝亻寸
制	牛巾刂
玄	亠幺
置	四十且
豪	亠口冖豕
恆	忄二夕
助	且力
濤	氵士㇕工一日寸
幽	幺幺山
欣	斤欠
豐	丰丰山一口䒑
辣	辛木口
煤	火甘木
戀	言絲絲心
圍	圍韋口㐄
瓜	瓜
諸	言者
俾	亻鬼十
慧	丰丰彐心
墨	四二灬土
鮮	魚羊
鏡	金立日儿
娶	耳又女
蝦	虫㇕卜㇕又
犬	大丶
鵬	月月鳥
誠	言戊㇆
賀	力口貝
險	阝人一口口人人
飾	食𠂉巾
撐	扌小冖口牙
炎	火火
震	雨辰
鋒	金夂丰
遂	之丷豕
軒	車一十
控	扌穴工
殼	士冖一几殳
擋	扌小冖口田
覆	西行𠂉日夂
趟	走小冂口
禁	木木示
烤	火者了
盃	不皿
童	立甲二
蟲	虫虫虫
徵	行山一王攵
杯	木不
暨	艮七儿日一
晴	日丰月
魂	二厶鬼
益	䒑八皿
庭	广廴丿士
肝	月一十
濃	氵日刂辰
坊	土方
晨	日辰
紀	絲己
振	扌辰
塵	鹿土
割	宀丰口刂
敗	貝攵
消	氵小月
兆	氵儿
楓	木風
隆	阝夂一生
撤	扌亠厶月攵
粥	弓米弓
馨	士尸殳禾日
誤	言口一大
滑	氵骨
曼	日四又
暖	日爪一大又
滬	氵户口巴
己	己
止	止
柱	木丶王
塗	氵人禾土
妻	一彐女
灣	氵言絲絲弓
盾	斤十目
奔	大十艹
潤	氵門王
政	一止攵
爹	八乂夕夕
尹	尹
廖	广习习人彡
刺	木冂刂
冠	冖二儿寸
躺	身小冂口
舍	人舌
蓮	艹之車
售	隹口
獸	口口田一口大丶
婚	女氏日
攝	扌耳耳耳
醫	匚矢殳酉
閣	門夂口
妞	女㇕十
邱	丘阝
兔	⺈口儿丶
敬	艹勹口攵
潮	氵十日十月
昂	日氏卩
飽	食勹巳
咳	口亠乡人
邪	牙阝
促	亻足
鼠	臼巛
葛	艹日勹人乚
串	口中
桑	又又又木
續	絲士四貝
苑	艹夗
迎	之氏卩
弓	弓
碎	石亠人人十
余	人禾
承	㇕水三
迪	之由
膠	月习习人彡
烏	烏
牠	牛也
臣	臣
勤	廿口丰力
摔	扌亠幺氵十
撈	扌火火冖扌力
蒸	艹㇕水一灬
凌	冫土八夂
辛	辛
旗	方𠂉其
妙	女小丿
始	女厶口
符	⺮亻寸
倫	亻人一冂艹
鋁	金口鬼
亭	亠口冖丁
吼	口子乚
云	二厶
研	石一艹
咪	口米
俗	亻八人口
爺	八乂耳阝
霧	雨又㇕亻夂力
珍	王人彡
卓	卜日十
韋	韋口㐄
歡	艹口口隹欠
嗨	口氵𠂉母
積	禾丰貝
捧	扌春工
鳴	口鳥
舔	舌一大忄
贊	牛儿牛儿貝
喃	口十冂半
簡	⺮門日
豔	丰丰山一口䒑土厶皿
愈	人一月刂心
溪	氵爪幺大
罰	四言刂
歪	不一止
晃	日小尤
斜	人禾冫十
預	又㇕丨頁
鄒	勹凵勹凵阝
尤	尤
洲	氵⺍川
乎	丿丷寸
湘	氵木目
罷	四厶月匕匕
軸	車由
妳	女⺈小
翔	羊习习
異	田廿八
隱	阝爪工彐心
枝	木十又
逸	之⺈口儿丶
哄	口廿八
餐	卜夕又食
顆	日木頁
鴨	甲鳥
染	氵九木
餅	食䒑艹
藝	艹土八土丸二厶
炮	火勹巳
桌	卜日木
芬	艹八刀
鴻	氵工鳥
攜	扌山隹冂八口
腎	臣又月
撲	扌业羊
萍	艹氵一丷十
晶	日日日
勾	勹厶
戒	戈艹
桂	木土土
朗	丶艮月
堵	土者
矣	厶矢
捐	扌口月
彎	言絲絲弓
薑	艹三田田
荷	艹亻丁口
畝	亠田⺈丶
棉	木白巾
私	禾厶
擊	車凵殳手
姜	羊女
貸	亻弋貝
傾	亻匕頁
鼓	士口䒑十又
霞	雨㇕卜㇕又
瞧	目隹灬
皇	白王
企	人止
互	一彑
沉	氵冖几
箭	⺮䒑月刂
柏	木白
騰	月半馬
焦	隹灬
潔	氵丰刀絲
盟	日月皿
延	廴丿止
柔	又㇕亻木
資	冫欠貝
粒	米立
嶺	山人之頁
盆	八刀皿
檢	木人一口口人人
護	言艹隹又
眉	尸目
傘	人人人人人十
碧	王白石
籍	⺮三小廿日
燙	氵日一勹彡火
瑪	王馬
刮	舌刂
勿	勹彡
坤	土申
汁	氵十
冊	冂艹
銘	金夕口
浴	氵八人口
翼	习习田廿八
哲	扌斤口
涵	氵㇕水凵
鈣	金一卜乚
菌	艹圍禾
敵	亠丷冂十口攵
桶	木又用
抹	扌一木
判	半刂
寵	宀龍
紋	絲文
弟	丷弓亻
傅	亻甫寸
衰	亠日𧘇
譯	言四土半
柯	木丁口
叔	上小又
肩	户月
殿	尸廿八殳
番	釆田
驢	馬虎田皿
怡	忄厶口
旭	九日
訪	言方
勢	土八土丸力
蒐	艹鬼
航	舟亠几
妮	女尸匕
萊	艹木人人
坡	土皮
兇	乂凵儿
旅	方𠂉氏
鷹	广亻隹鳥
赤	土川八
技	扌十又
韻	立日口貝
摘	扌亠丷冂十口
翠	习习亠人人十
邁	之艹日冂厶
孝	者子
移	禾夕夕
搖	扌夕牛山
畢	甲艹二
予	又㇕丨
岳	丘山
屎	尸米
融	一口冂丷丁虫
棋	木其
勞	火火冖力
採	扌爪木
鈕	金㇕十
扶	扌夫
介	人川
渡	氵广廿又
奪	大隹寸
采	爪木
乳	爪子乚
拳	半手
齣	齒勹口
錫	金日勹彡
薇	艹行山一几攵
淫	氵爪丿士
拽	扌日乚丿
職	耳立日戈
宅	宀丿七
掌	小冖口手
培	土立口
莉	艹禾刂
損	扌口貝
櫃	木匚中一貝
盼	目八刀
握	扌尸至
謀	言甘木
廟	广十日十月
截	土隹戈
孤	子瓜
壯	爿士
邵	刀口阝
墊	土半丸土
規	夫見
頗	皮頁
什	亻十
宣	宀二日
妍	女一艹
尖	小大
討	言寸
醋	酉廿日
朵	几木
膽	月⺈厂八言
穆	禾白小彡
姬	女臣
龜	丿黽
啃	口止月
漸	氵車斤
耗	三小毛
息	自心
伍	亻工㇕
塘	土广彐口
壽	士㇕工一口寸
逢	之夂丰
闖	門馬
晉	二厶厶日
桃	木氵儿
壁	尸口辛土
霍	雨隹
爐	火虎田皿
漆	氵木人水
暫	車斤日
虹	虫工
丸	丸
券	半刀
辭	爪又冂厶又辛
縫	絲之夂丰
俱	亻且八
菊	艹勹米
奴	女又
岸	山厂一十
凝	冫匕矢又㇕止
膩	月弋二貝
芝	艹之
兮	八了
脈	月斤氏
嚐	口小冖口匕日
烈	一夕刂灬
矮	矢禾女
貪	人丶㇕貝
婆	氵皮女
俞	人一月刂
蝶	虫廿乚木
誇	言大一了
枕	木冖儿
毀	臼土殳
避	之尸口辛
帕	巾白
綁	絲丰阝
悅	忄八口儿
浮	氵爪子
盈	㇆丿又皿
枚	木攵
材	木寸丿
賞	小冖口貝
扎	扌乚
翁	八厶习习
幻	幺㇆
衫	衤彡
固	圍十口
耀	小尤习习隹
槽	木艹日日
穴	穴
獻	虎一口冂丷丁大丶
幅	巾一口田
審	宀釆田
斬	車斤
伸	亻申
悲	非心
殷	斤彐㇆殳
茲	艹幺幺
穎	匕禾頁
萌	艹日月
斑	王文王
澡	氵口口口木
牽	亠幺冖牛
屈	尸凵山
娟	女口月
怨	夗心
癢	疒羊丶艮
恐	工凡心
凍	冫木日
複	衤𠂉日夂
柴	止匕木
逆	之䒑凵
騷	馬又丶虫
渣	氵木日一
熙	臣巳灬
抖	扌冫十
忽	勹彡心
津	氵彐二
胎	月厶口
糧	米日一甲二
濟	氵亠丷丨刀氏川
參	厶厶厶人彡
譜	言䒑业日
准	冫隹
褲	衤广車
紮	木乚絲
摩	广木木手
縮	絲宀亻一白
漫	氵日四又
溜	氵氏刀田
彥	文厂彡
棄	亠厶廿木
扇	户习习
婷	女亠口冖丁
菸	艹方人冫
脣	辰月
憂	一白冖心夂
堡	亻口木土
淘	氵勹牛山
墓	艹日大土
鹿	鹿
嬌	女丿大口冂口
遞	之斤虎
彬	木木彡
卿	氏丿艮卩
琪	王其
鶴	冖隹鳥
函	㇕水凵
確	石冖隹
郡	尹口阝
奈	大示
茂	艹戊
緩	絲爪一大又
協	十力力力
瓊	王⺈冂人目夂
髒	骨艹一夕匕艹
債	亻丰貝
肌	月几
薰	艹千四二灬
映	日冂大
粵	鬼釆了
鼻	自田一川
銷	金小月
育	亠厶月
澳	氵自米大
候	亻丨㇕矢
堅	臣又土
邀	之白方攵
閉	門寸丿
妝	爿女
佩	亻几一巾
決	氵㇕大
適	之亠丷冂十口
策	⺮木冂
藤	艹月半水
仿	亻方
磊	石石石
雁	厂亻隹
俠	亻大人人
腸	月日一勹彡
窄	穴𠂉卜
昨	日𠂉卜
倪	亻臼儿
務	又㇕亻夂力
雯	雨文
戈	戈
爪	爪
癌	疒口口口山
效	亠八乂攵
拷	扌者了
猴	犭亻㇕矢
掏	扌勹牛山
汝	氵女
撮	扌日耳又
幸	土半
揉	扌又㇕亻木
醬	爿夕寸酉
舟	舟
訴	言斤丶
態	厶月匕匕心
盯	目丁
繡	絲彐片爿
蜜	宀心丿虫
漂	氵西示
序	广又㇕丨
巷	廿八巳
梨	禾刂木
舌	舌
蒂	艹亠丷冖巾
腹	月𠂉日夂
蟹	⺈用刀牛虫
陷	阝⺈臼
捉	扌足
蒼	艹人户口
鵝	手戈鳥
疑	匕矢又㇕止
鼎	目爿片
釣	金勹丶
慌	忄艹亡川
蔥	艹鬼夂心
瘤	疒氏刀田
彼	行皮
辰	辰
執	土半丸
忌	己心
踏	足水日
龔	龍廿八
捷	扌一彐止
罐	牛山艹口口隹
腫	月千日二
縱	絲行人人止
伏	亻大丶
壇	土亠圍口日一
觸	⺈用四勹虫
默	四二灬大丶
懸	且小丿絲心
赫	土川八土川八
瑩	火火冖王
杰	木灬
孩	子亠乡人
咖	口力口
幀	巾卜貝
悟	忄工㇕口
頻	止小頁
灑	氵一冂丶一冂丶鹿
燉	火亠口子攵
帽	巾日目
幼	幺力
旋	方𠂉㇕止
擁	扌亠乡隹
聶	耳耳耳
猶	犭丷酉
壹	士冖一口䒑
霸	雨革月
席	广廿巾
叉	又丶
繫	車凵殳絲
妃	女己
擔	扌⺈厂八言
典	冂廿八
贈	貝丷四日
儒	亻雨而
裸	衤日木
奉	春工
御	行牛止卩
腔	月穴工
突	穴大丶
刑	一艹刂
痕	疒艮
賓	宀一小貝
午	𠂉十
攤	扌廿口夫隹
蕾	艹雨田
頸	一巛工頁
臟	月艹爿戈臣
宰	宀辛
囊	一中冖口口甘𧘇
賬	貝長
弘	弓厶
境	土立日儿
拒	扌匚㇕
毅	立豕殳
煎	䒑月刂灬
弦	弓亠幺
渝	氵人一月刂
罩	四卜日十
蓉	艹穴人口
憶	忄立日心
卵	氏丿丶卩丶
遷	之西大巳
尺	尸丶
禍	礻咼
逾	之人一月刂
垂	千艹二
潛	氵七儿七儿日
郵	千艹二阝
惜	忄廿日
浦	氵甫
警	艹勹口攵言
扛	扌工
氧	气羊
揭	扌日勹人乚
逐	之豕
謂	言田月
昭	日刀口
宿	宀亻一白
統	絲亠厶儿
裂	一夕刂亠𧘇
僧	亻丷四日
慣	忄母貝
裙	衤尹口
彪	虎彡
淋	氵木木
束	木口
牢	宀牛
齋	亠丷丨刀氏川小
揍	扌春一大
仕	亻士
鉤	金勹口
劫	土厶力
拓	扌石
扮	扌八刀
疊	田田田冖且
鋅	金辛
喻	口人一月刂
律	行彐二
株	木牛小
砂	石小丿
埃	土厶矢
斗	冫十
坪	土一丷十
揮	扌冖車
仇	亻九
吞	一大口
亡	亡
沾	氵卜口
遙	之夕牛山
壺	士冖业
牧	牛攵
霖	雨木木
兜	白氏㇕儿
寨	宀甘八木
監	臣⺮皿
稀	禾乂大巾
恰	忄人一口
牴	牛氏丶
棍	木日匕匕
朕	月䒑大
淑	氵上小又
饒	食土土土尤
慕	艹日大忄
歇	日勹人乚欠
疏	㇕止亠厶川
膏	亠口冖口月
陵	阝土八夂
壩	土雨革月
纏	絲广甲二八土
鹹	卜圍乂戊一口
姆	女母
聰	耳鬼夂心
捱	扌厂土土
碳	石山大火
銳	金八口儿
驗	馬人一口口人人
齒	齒
廷	廴丿士
糊	米十口月
翹	土土土尤习习
儲	亻言者
楠	木十冂半
顛	十且八頁
蚊	虫文
祭	夗示
龐	广龍
拾	扌人一口
裴	非亠𧘇
朋	月月
媚	女尸目
吟	口人丶㇕
筒	⺮冂一口
丘	丘
責	丰貝
趴	足八
堯	土土土尤
繁	𠂉母攵絲
坦	土日一
穗	禾車心
紗	絲小丿
屯	七凵
虐	虎匚
蹲	足丷酉寸
紹	絲刀口
惟	忄隹
幕	艹日大巾
澆	氵土土土尤
扒	扌八
搓	扌羊工
遮	之广廿灬
庚	广彐人
哉	土口戈
涉	氵止小
賦	貝一弋止
臂	尸口辛月
樁	木春臼
敷	甫方攵
禪	礻口口日十
佬	亻者匕
瑤	王夕牛山
習	习习白
臥	臣人
釘	金丁
阮	阝二儿
丙	一冂人
歷	厂禾禾止
躍	足习习隹
署	四者
範	⺮車巳
示	示
邢	一艹阝
擰	扌宀心皿丁
莎	艹氵小丿
糞	米田廿八
嵐	山風
濱	氵宀一小貝
夕	夕
議	言羊手戈
趣	走耳又
渠	氵匚㇕木
閱	門八口儿
繩	絲黽
杭	木亠几
疾	疒矢
崇	山宀示
擴	扌广廿由八
傢	亻宀豕
婦	女彐冖巾
裕	衤八人口
嘆	口廿口夫
艦	舟臣⺮皿
挪	扌刀二阝
荒	艹亡川
貞	卜貝
筋	⺮月力
孕	㇆丿子
撕	扌其斤
鈴	金人之
戳	习习隹戈
帆	巾凡
籌	⺮士㇕工口寸
奎	大土土
駕	力口馬
阻	阝且
享	亠口子
棚	木月月
傲	亻丰力攵
欽	金欠
蹦	足山月月
焊	火日一十
召	刀口
徒	行走
脂	月匕日
几	几
趨	走勹凵勹凵
艘	舟臼丨又
競	立口儿立口儿
靖	立丰月
奏	春一大
咒	口口几
釋	釆四土半
盲	亡目
姿	冫欠女
炫	火亠幺
賜	貝日勹彡
湧	氵又用力
潑	氵癶弓殳
坎	土欠
拌	扌半
樊	木乂乂木大
缸	牛山工
弗	弓川
狐	犭瓜
漿	爿夕寸水
栽	土木戈
閻	門⺈臼
攪	扌臼乂乂見
述	之木丶
籠	⺮龍
泛	氵丿之
甫	甫
佑	亻大口
鮑	魚勹巳
閥	門亻戈
卦	土土卜
耿	耳火
咽	口圍大
倩	亻丰月
袖	衤由
貧	八刀貝
糟	米艹日日
激	氵白方攵
階	阝匕匕白
珊	王周周一
潭	氵西日十
蠢	春虫虫
植	木十且
占	卜口
嘯	口彐片爿
徑	行一巛工
鉛	金几口
屍	尸一夕匕
倚	亻大丁口
灘	氵廿口夫隹
姨	女大弓
災	巛火
幢	巾立甲二
鈉	金冂人
暢	申日一勹彡
詠	言丶水
齡	齒人之
焉	一止一乚灬
茹	艹女口
桐	木冂一口
痰	疒火火
捂	扌工㇕口
鄰	米夕㐄阝
揀	扌木四
艙	舟人户口
謙	言䒑彐刂八
織	絲立日戈
蒲	艹氵甫
芽	艹牙
驅	馬匚口口口
轟	車車車
攔	扌門木四
碑	石鬼十
嚼	口爪四艮寸
燃	火夕大丶灬
摟	扌數女
輔	車甫
暉	日冖車
朴	木卜
碩	石頁
杖	木一乂
謎	言之米
磷	石米夕㐄
竄	穴臼巛
脆	月⺈厂巳
刃	刀丶
墜	阝丷豕土
姑	女十口
衡	行⺈田大
皺	勹凵勹凵皮
擇	扌四土半
櫻	木貝貝女
鹼	卜圍乂人一口口人人
窯	穴羊灬
措	扌廿日
眠	目巳七
途	之人禾
鄂	口口一了阝
叢	业羊耳又
禾	禾
磁	石䒑幺幺
錶	金丰𧘇
沃	氵丿大
屢	尸數女
辯	辛言辛
肚	月土
哀	亠口𧘇
浸	氵彐冖又
柄	木一冂人
跪	足⺈厂巳
攬	扌臣⺮四見
輯	車口耳
瓷	冫欠瓦
澀	氵刀丶刀丶止止
踹	足山而
凸	丨一丨㇆一
瑜	王人一月刂
磅	石亠丷冖方
豈	山一口䒑
瀉	氵宀臼勹灬
遼	之大丷日小
豎	臣又一口䒑
宴	宀日女
堪	土其乚
擱	扌門夂口
麟	鹿米夕㐄
祿	礻彑水
翟	习习隹
仗	亻一乂
崩	山月月
醜	酉鬼
厲	厂艹日冂厶
革	革
憲	宀丰四心
遺	之中一貝
聘	耳由了
喚	口⺈冂八大
閘	門甲
刊	一十刂
裁	土亠𧘇戈
郁	大月阝
逝	之扌斤
際	阝夗示
狄	犭火
誌	言士心
塌	土日习习
崖	山厂土土
廉	广䒑彐刂八
婉	女宀夗
攀	木乂乂木大手
獅	犭丿㠯一巾
喘	口山而
氫	气一巛工
氮	气火火
鞍	革宀女
竇	穴士四貝
墳	土十艹貝
巫	工人人
虞	虎口一大
沁	氵心
瑟	王王心丿
揪	扌禾火
棵	木日木
拐	扌口力
築	⺮工凡木
癮	疒阝爪工彐心
剝	彑水刂
披	扌皮
削	小月刂
籃	⺮臣⺮皿
悠	亻丨攵心
睿	卜冖一八人目
凹	冂一冂一
葬	艹一夕匕艹
咦	口大弓
瞪	目癶一口䒑
詹	⺈厂八言
侃	亻口川
授	扌爪冖又
卸	牛止卩
頌	八厶頁
慈	䒑幺幺心
闊	門氵舌
纖	絲人人戈非一
棗	木冂木冂
瞄	目艹田
駱	馬夂口
馳	馬也
鞭	革亻一日乂
楞	木四方
兌	八口儿
危	⺈厂巳
襲	龍亠𧘇
泊	氵白
喉	口亻㇕矢
溶	氵穴人口
撫	扌𠂉廿灬
媛	女爪一大又
拎	扌人之
察	宀夗示
駿	馬厶八夂
繪	絲人一四日
黴	行山一四二灬攵
鈞	金勹冫
憐	忄米夕㐄
昆	日匕匕
禹	丿口冂厶
娥	女手戈
醇	酉亠口子
橙	木癶一口䒑
辨	辛刂辛
暮	艹日大日
祕	礻心丿
薪	艹立木斤
煥	火⺈冂八大
巢	巛日木
鉀	金甲
脾	月鬼十
淵	氵片爿
愚	日冂厶心
蜀	四勹虫
裹	亠日木𧘇
藕	艹三小日冂厶
劈	尸口辛刀
堤	土日一止
拱	扌廿八
夸	大一了
傍	亻亠丷冖方
燥	火口口口木
漁	氵魚
允	厶儿
杏	木口
芒	艹亡
畔	田半
豹	豸勹丶
澄	氵癶一口䒑
冥	冖日亠八
媒	女甘木
燦	火卜夕又米
酥	酉禾
垮	土大一了
枯	木十口
軌	車九
塑	䒑凵月土
卜	卜
構	木甘冂土
茅	艹又㇕亻
慾	八人口欠心
搏	扌甫寸
鑄	金士㇕工一口寸
沐	氵木
豫	又㇕丨⺈口豕
蒜	艹示示
雀	小丿隹
亨	亠口了
詳	言羊
腐	广亻寸冂人人
皓	白牛口
央	冂大
氟	气弓川
冤	冖⺈口儿丶
浙	氵扌斤
栓	木人王
梳	木亠厶川
冀	丬匕田廿八
輩	非車
冉	冂土
餡	食⺈臼
彤	周亠彡
奕	亠川八大
卑	鬼十
誓	扌斤言
蜂	虫夂丰
迅	之乙十
虫	虫
恥	耳心
匹	匚儿
曦	日羊禾了戈
仰	亻氏卩
煞	⺈彐攵灬
羞	羊㇕十
注	氵丶王
嫂	女臼丨又
瞳	目立甲二
黛	亻弋四二灬
妾	立女
拂	扌弓川
挨	扌厶矢
泄	氵廿乚
綱	絲冂䒑山
夷	大弓
慎	忄十且八
汽	氵气
恭	廿八忄
弊	水冂攵艹
貳	弋二貝
旦	日一
氯	气彐水
祁	礻阝
蠟	虫巛圍乂巛
乍	𠂉卜
孰	亠口子丸
耕	三小二川
稻	禾爪臼
屠	尸者
綺	絲大丁口
荊	艹一艹刂
桿	木日一十
笛	⺮由
捕	扌甫
蕊	艹心心心
喪	十口口展
盪	氵日一勹彡皿
氨	气宀女
愣	忄四方
瀾	氵門木四
悔	忄𠂉母
敦	亠口子攵
葵	艹癶一大
磕	石土厶皿
顫	亠圍口日一頁
閩	門虫
渴	氵日勹人乚
曝	日日廿八水
閔	門文
撇	扌用水冂攵
梗	木一日乂
絡	絲夂口
貫	母貝
蔚	艹尸示寸
翅	十又习习
估	亻十口
鎂	金羊大
復	行𠂉日夂
瓣	辛瓜辛
濫	氵臣⺮皿
況	氵口儿
淮	氵隹
陀	阝宀匕
莖	艹一巛工
惑	戈口一心
簾	⺮广䒑彐刂八
巡	之巛
徽	行山一絲攵
謹	言廿口丰
脹	月長
噓	口虎业
瞞	目廿巾人人
娛	女口乚大
蓄	艹亠幺田
梓	木辛
匪	匚非
濺	氵貝戈戈
敘	人禾攵
鑑	金臣⺮皿
溢	氵䒑八皿
彌	弓一八巾乂乂乂乂
覓	爪見
寇	宀二儿卜又
獵	犭巛圍乂巛
滄	氵人户口
葷	艹冖車
蓬	艹之夂丰
硫	石亠厶川
俏	亻小月
迫	之白
貌	豸白儿
弔	弓丨
舜	爪冖夕㐄
炳	火一冂人
茄	艹力口
頤	臣頁
訣	言㇕大
廚	广士口䒑寸
炭	山大火
綿	絲白巾
搗	扌鳥山
萱	艹宀二日
岡	冂䒑山
掀	扌斤欠
誘	言禾㇆丿
翰	十日十人习习
睜	目爪彐
撓	扌土土土尤
掩	扌大日乚
蹬	足癶一口䒑
泳	氵丶水
玫	王攵
椅	木大丁口
遜	之子丿絲
甄	西土瓦
侍	亻土寸
抑	扌氏卩
啞	口一业
敖	丰力攵
毫	亠口冖毛
侵	亻彐冖又
妥	爪女
覽	臣⺮四見
概	木艮七儿
貢	工貝
援	扌爪一大又
昔	廿日
逮	之彐氵
卒	亠人人十
鬆	長彡木八厶
捆	扌圍木
厭	厂日月大丶
峽	山大人人
彷	行方
寢	宀爿彐冖又
菱	艹土八夂
梯	木丷弓亻
僑	亻丿大口冂口
腕	月宀夗
挫	扌人人土
膝	月木人水
嗦	口十冖絲
眨	目丿之
循	行斤十目
臀	尸廿八殳月
矛	又㇕亻
努	女又力
黔	四二灬人丶㇕
乏	丿之
魅	鬼二小
徹	行亠厶月攵
凶	乂凵
廈	广一自夂
掘	扌尸凵山
茗	艹夕口
絨	絲戈大
擾	扌一白冖心夂
襯	衤立木見
雌	止匕隹
旱	日一十
伽	亻力口
蛙	虫土土
雕	周土口隹
嬰	貝貝女
痣	疒士心
譽	臼一乚丨八言
跡	足亠川八
廂	广木目
汀	氵丁
隋	阝大工月
緒	絲者
蘊	艹絲圍人皿
勻	勹二
芙	艹夫
棲	木一彐女
刁	㇆一
瑛	王艹冂大
禽	人亠乂凵冂厶
腺	月白水
迦	之力口
矯	矢丿大口冂口
欺	其欠
杉	木彡
竅	穴白方攵
鑲	金亠口口甘𧘇
緯	絲韋口㐄
繆	絲习习人彡
玖	王⺈丶
肆	長彐二
悉	釆心
菁	艹丰月
鎳	金自木
冶	冫厶口
絆	絲半
嘔	口匚口口口
遣	之中一㠯
岑	山人丶㇕
皖	白宀二儿
糕	米羊灬
斐	非文
閤	門人一口
釀	酉亠口口甘𧘇
彙	彑冖日木
址	土止
蘸	艹酉隹灬
茵	艹圍大
簿	⺮氵甫寸
旬	勹日
丈	一乂
咸	戊一口
呸	口不一
胤	儿幺月
蹤	足行人人止
婁	數女
桓	木二日
碘	石冂廿八
廊	广丶艮阝
焰	火⺈臼
壘	田田田土
淳	氵亠口子
畏	田展
屑	尸小月
覃	西日十
嵌	山甘欠
販	貝斤又
泣	氵立
嗆	口人户口
眾	四亻人人
袍	衤勹巳
菴	艹大日乚
僵	亻三田田
饞	食⺈口匕匕⺈口儿丶
沫	氵一木
滯	氵廿儿冖巾
臻	至春禾
眺	目氵儿
寂	宀上小又
醣	酉广彐口
晏	日宀女
秤	禾一丷十
嗚	口烏
蘿	艹四絲隹
誅	言牛小
藻	艹氵口口口木
螺	虫田絲
錠	金宀一止
診	言人彡
恤	忄丿皿
涯	氵厂土土
滋	氵䒑幺幺
蘆	艹虎田皿
嗜	口者匕日
貿	氏刀貝
療	疒大丷日小
滲	氵厶厶厶人彡
瀝	氵厂禾禾止
陡	阝走
栗	西木
筍	⺮勹日
朔	䒑凵月
淇	氵其
捻	扌人丶㇕心
勃	十冖子力
矩	矢匚㇕
沽	氵十口
淤	氵方人冫
描	扌艹田
膚	虎田月
契	丰刀大
祠	礻㇆一口
陝	阝大人人
鞏	工凡革
峻	山厶八夂
稠	禾周土口
爵	爪四艮寸
秉	禾彐
刨	勹巳刂
雍	亠乡隹
群	尹口羊
麵	木人人夕石圍卜丨
盞	戈戈皿
役	行殳
烙	火夂口
痘	疒一口䒑
髓	骨之大工月
嫣	女一止一乚灬
募	艹日大力
苟	艹勹口
析	木斤
篩	⺮丿㠯一巾
魁	鬼冫十
斥	斤丶
棕	木宀示
匡	匚王
倦	亻半巳
疆	弓土三田田
蔓	艹日四又
樺	木艹一艹工
牟	厶牛
霆	雨廴丿士
蠶	七儿七儿日虫虫
嘰	口幺幺戈人
靴	革亻匕
慮	虎田心
眸	目厶牛
惱	忄巛鬼乂
巾	巾
殊	一夕牛小
叮	口丁
艇	舟廴丿士
熔	火穴人口
裘	寸氵丶亠𧘇
芹	艹斤
儘	亻彐一灬皿
寡	宀石且八刀
擲	扌丷酉大阝
蔔	艹勹一口田
迥	之冂口
巖	山口口厂㇕耳攵
瞬	目爪冖夕㐄
邑	口巴
鉻	金夂口
榕	木穴人口
庸	广彐月
渾	氵冖車
棠	小冖口木
祺	礻其
紡	絲方
蝕	食虫
窺	穴夫見
埠	土丿㠯十
奮	大隹田
剎	乂木丶刂
濁	氵四勹虫
濾	氵虎田心
嗅	口自大丶
簫	⺮彐片爿
佰	亻一白
滇	氵十且八
寅	宀一由八
姦	女女女
梵	木木凡
蛾	虫手戈
慰	尸示寸心
履	尸行𠂉日夂
駛	馬口乂
宛	宀夗
襪	衤艹四戊丶
嫖	女西示
綸	絲人一冂艹
礙	石匕矢又㇕止
獄	犭言大丶
闢	門尸口辛
蟬	虫口口日十
涮	氵尸巾刂
督	上小又目
衍	行氵
違	之韋口㐄
絞	絲亠八乂
廿	廿
劣	小丿力
銜	行金
祈	礻斤
貶	貝丿之
魄	白鬼
斧	八乂斤
裔	亠𧘇冂八口
湛	氵其乚
淌	氵小冂口
簇	⺮方𠂉矢
償	亻小冖口貝
沛	氵一巾
澗	氵門日
殤	一夕𠂉日一勹彡
掠	扌亠口小
崎	山大丁口
贛	立日十夂工貝
蕩	艹氵日一勹彡
砌	石七刀
闌	門木四
辱	辰寸
匠	匚斤
肘	月寸
淹	氵大日乚
洽	氵人一口
究	穴九
慼	戊上小心
矢	矢
蟻	虫羊手戈
澈	氵亠厶月攵
葦	艹韋口㐄
瞥	水冂攵目
崑	山日匕匕
墮	阝大工月土
輓	車⺈口儿
鴿	人一口鳥
錘	金千艹二
懼	忄目目隹
椰	木耳阝
梢	木小月
嘟	口者阝
瀟	氵艹彐片爿
障	阝立日十
霄	雨小月
疇	田士㇕工一口寸
揣	扌山而
槐	木鬼
粟	西米
唆	口厶八夂
誦	言又用
綜	絲宀示
詢	言勹日
劃	彐二田一刂
札	木乚
駁	馬乂乂
拴	扌人王
攏	扌龍
聳	行人人止耳
燭	火四勹虫
襖	衤自米大
臘	月巛圍乂巛
吏	大口丶
堰	土匚日女
棺	木宀㠯
腥	月日生
胞	月勹巳
羨	羊氵欠
韶	立日刀口
阜	丿㠯十
剖	立口刂
羹	羊灬羊大
剃	丷弓亻刂
寓	宀日冂厶
峪	山八人口
煜	火日立
竊	穴釆卜冂人冂厶
撩	扌大丷日小
扳	扌斤又
桔	木士口
轄	車宀丰口
臧	爿戈臣
喀	口宀夂口
妄	亡女
陌	阝一白
弧	弓瓜
弩	女又弓
撰	扌巳巳廿八
瞿	目目隹
卞	亠卜
蛤	虫人一口
襄	亠口口甘𧘇
肅	彐片爿
擒	扌人亠乂凵冂厶
哨	口小月
鑿	业半臼殳金
皂	白七
鋸	金尸十口
汞	工水
芭	艹巴
膿	月日刂辰
懿	士冖一口䒑冫欠心
蔭	艹阝人丶㇕二厶
椒	木上小又
戎	戈大
肋	月力
翎	人之习习
煌	火白王
錐	金隹
疤	疒巴
瀚	氵十日十人习习
絹	絲口月
僱	亻户隹
泓	氵弓厶
昧	日二小
棧	木戈戈
硯	石見
錳	金子皿
旨	匕日
鱗	魚米夕㐄
巳	巳
辜	十口辛
筐	⺮匚王
膊	月甫寸
遵	之丷酉寸
摺	扌习习白
剁	几木刂
愧	忄鬼
拙	扌凵山
彆	水冂攵弓
竿	⺮一十
鈔	金小丿
鏟	金立丿生
驛	馬四土半
鱉	水冂攵魚
稜	禾土八夂
憤	忄十艹貝
綽	絲卜日十
鶯	火火冖鳥
緻	絲至攵
圭	土土
塚	土冖豕
甸	勹田
衷	亠中𧘇
燜	火門心
脊	氵人月
搽	扌艹人木
捶	扌千艹二
勵	厂艹日冂厶力
毓	𠂉母亠厶川
苔	艹厶口
鉗	金甘
奸	女一十
黏	禾人水卜口
縷	絲數女
甭	不用
瞟	目西示
舅	臼田力
錚	金⺈彐
阪	阝斤又
恕	女口心
轎	車丿大口冂口
啼	口亠丷冖巾
繭	艹冂絲丨虫
鬱	牛山木木冖乂凵匕彡
曠	日广廿由八
睹	目者
禿	禾儿
諦	言亠丷冖巾
疲	疒皮
褪	衤之艮
鞠	革勹米
釉	釆由
彰	立日十彡
綴	絲又又又又
軋	車乚
酬	酉⺍川
橘	木又㇕亻冂八口
啪	口扌白
睛	目丰月
斂	人一口口人人攵
遁	之斤十目
晝	彐二日一
殲	一夕人人戈非一
樸	木业羊
窟	穴尸凵山
鈍	金七凵
垢	土斤一口
愿	厂白小心
奚	爪幺大
誼	言宀且
紛	絲八刀
褚	衤者
腮	月田心
枉	木王
鍍	金广廿又
涓	氵口月
嗟	口羊工
蠱	虫虫虫皿
笙	⺮生
沸	氵弓川
妓	女十又
儉	亻人一口口人人
猿	犭土口𧘇
漠	氵艹日大
撬	扌毛毛毛
巍	山禾女鬼
鉑	金白
漾	氵羊丶水
擎	艹勹口攵手
詐	言𠂉卜
絃	絲亠幺
靶	革巴
鴉	牙鳥
俐	亻禾刂
胚	月不一
楷	木匕匕白
侶	亻口鬼
迭	之牛人
詔	言刀口
嗣	口冂艹㇆一口
嵩	山亠口冂口
驕	馬丿大口冂口
蠅	虫黽
蹄	足亠丷冖巾
穫	禾艹隹又
潰	氵中一貝
褐	衤日勹人乚
丞	㇕水一
梭	木厶八夂
瘡	疒人户口
槓	木工貝
唷	口亠厶月
鯨	魚亠口小
鎊	金亠丷冖方
畜	亠幺田
廬	广虎田皿
粽	米宀示
韌	韋口㐄刀丶
囉	口四絲隹
鸞	言絲絲鳥
鈾	金由
宵	宀小月
榆	木人一月刂
嚷	口亠口口甘𧘇
釵	金又丶
絮	女口絲
戊	戊
剷	立丿生刂
罕	冖八一十
糾	絲凵
駝	馬宀匕
叩	口卩
箏	⺮爪彐
俯	亻广亻寸
瀑	氵日廿八水
肇	户攵彐二
窪	穴氵土土
毋	母大
暇	日㇕卜㇕又
岐	山十又
睬	目爪木
郊	亠八乂阝
璧	尸口辛王丶
挾	扌大人人
捎	扌小月
嶼	山臼一乚丨八
糸	絲
嘀	口亠丷冂十口
斃	水冂攵一夕匕
犁	禾刂牛
怔	忄一止
焚	木木火
鷗	匚口口口鳥
癖	疒尸口辛
灼	火勹丶
孽	艹丿㠯辛子
岱	亻弋山
麓	木木鹿
匙	日一止匕
嚎	口亠口冖豕
爻	乂乂
鏢	金西示
涇	氵一巛工
摧	扌山隹
械	木戈艹
乞	𠂉乙
卯	氏丿卩
凋	冫周土口
蕙	艹車心
噗	口业羊
筠	⺮土勹冫
諧	言匕匕白
喧	口宀二日
癲	疒十且八頁
瓢	西示瓜
嚕	口魚日
裳	小冖口亠𧘇
釗	金刂
謊	言艹亡川
晤	日工㇕口
竭	立日勹人乚
妨	女方
玻	王皮
聾	龍耳
宸	宀辰
擅	扌亠圍口日一
諫	言木四
烹	亠口了灬
卉	十艹
綾	絲土八夂
括	扌舌
漬	氵丰貝
戟	十日十戈
韜	韋口㐄爪臼
尸	尸
椎	木隹
恬	忄舌
胥	㇕止月
檀	木亠圍口日一
葡	艹勹甫
仄	厂人
噯	口爪冖心夂
縛	絲甫寸
嬸	女宀釆田
塢	土烏
壙	土广廿由八
伙	亻火
蠍	虫日勹人乚欠
垣	土二日
拘	扌勹口
呱	口瓜
篤	⺮馬
鳩	九鳥
躁	足口口口木
噬	口⺮工人人
鎢	金烏
孚	爪子
穀	士冖一禾殳
蓓	艹亻立口
蛆	虫且
囚	圍人
癱	疒廿口夫隹
鞘	革小月
瀨	氵木口⺈貝
匣	匚甲
凳	癶一口䒑几
隙	阝小日小
娣	女丷弓亻
驟	馬耳又乑
莞	艹宀二儿
曆	厂禾禾日
伶	亻人之
謠	言夕牛山
璽	一八巾乂乂乂乂王丶
拭	扌弋工
醃	酉大日乚
墅	甲二又㇕丨土
懵	忄艹四冖目
碾	石尸艹展
雋	隹冂一冂
禧	礻士口䒑口
鷺	足夂口鳥
鵑	口月鳥
脅	力力力月
榨	木穴𠂉卜
黯	四二灬立日
侖	人一冂艹
荼	艹人禾
苞	艹勹巳
戚	戊上小
頒	八刀頁
倘	亻小冂口
怯	忄土厶
淪	氵人一冂艹
礁	石隹灬
睏	日圍木
瞻	目⺈厂八言
躬	身弓
餌	食耳
脖	月十冖子
襟	衤木木示
尉	尸示寸
軼	車牛人
亥	亠乡人
蘋	艹止小頁
肢	月十又
悄	忄小月
紐	絲㇕十
貯	貝宀丁
僕	亻业羊
憎	忄丷四日
禎	礻卜貝
隴	阝龍
緬	絲石圍卜丨
頰	大人人頁
砷	石申
糙	米之牛口
炯	火冂口
莘	艹辛
盔	大火皿
睦	目土八土
仟	亻千
炕	火亠几
渦	氵咼
鬢	長彡宀一小貝
荔	艹力力力
嗷	口丰力攵
籲	⺮人一口口口冂艹頁
鯊	氵小丿魚
藩	艹氵釆田
楨	木卜貝
奢	大者
尬	尤人川
趾	足止
贖	貝士四貝
瘀	疒方人冫
悼	忄卜日十
臍	月亠丷丨刀氏川
抿	扌巳七
憾	忄戊一口心
孓	了丶
滌	氵亻丨夂木
兀	一儿
嶽	山犭言大丶
稚	禾隹
褒	亠亻口木𧘇
痔	疒土寸
烘	火廿八
渭	氵田月
嘻	口士口䒑口
錨	金艹田
鍛	金亻三殳
麒	鹿其
熄	火自心
艮	艮
薯	艹四者
禦	行牛止卩示
蕉	艹隹灬
荀	艹勹日
逍	之小月
拗	扌幺力
轍	車亠厶月攵
毯	毛火火
鐸	金四土半
邸	氏丶阝
柵	木冂艹
炙	夕火
倭	亻禾女
熾	火立日戈
馱	馬大
莽	艹大丶艹
笠	⺮立
勉	⺈口儿力
羌	羊儿
璋	王立日十
毆	匚口口口殳
咚	口夂冫
槳	爿夕寸木
恪	忄夂口
妒	女户
噹	口小冖口田
暑	日者
軀	身匚口口口
鈷	金十口
疫	疒殳
歉	䒑彐刂八欠
汐	氵夕
績	忄丰貝
樟	木立日十
豁	宀丰口八人口
窖	穴牛口
驥	馬丬匕田廿八
扭	扌㇕十
胰	月大弓
梟	鳥木
泗	氵四
邇	之一八巾乂乂乂乂
啟	户口攵
帘	穴巾
隅	阝日冂厶
岔	八刀山
弛	弓也
渚	氵者
纜	絲臣⺮四見
枴	木口刀
鑼	金四絲隹
廁	广貝刂
撼	扌戊一口心
雛	勹凵勹凵隹
痞	疒不口
瘟	疒日皿
樽	木丷酉寸
崢	山爪彐
颳	風舌
歧	止十又
咀	口且
箋	⺮戈戈
寮	宀大丷日小
繃	絲山月月
蒿	艹亠口冂口
悍	忄日一十
嬋	女口口日十
駭	馬亠乡人
硼	石月月
啤	口鬼十
壬	丿士
叛	半斤又
浚	氵厶八夂
霽	雨亠丷丨刀氏川
嘮	口火火冖力
勘	其乚力
剌	木口刂
樵	木隹灬
啄	口豕
倡	亻日日
肛	月工
糜	广木木米
漪	氵犭大丁口
迴	之圍口
駒	馬勹口
瑕	王㇕卜㇕又
蔽	艹水冂攵
鐳	金雨田
糯	米雨而
茫	艹氵亡
噎	口士冖一口䒑
飼	食㇆一口
狹	犭大人人
凰	几白王
溺	氵弓冫弓冫
霓	雨臼儿
硝	石小月
囤	圍七凵
吭	口亠几
靡	广木木非
厥	厂䒑凵欠
凜	冫亠圍口禾
跺	足几木
萃	艹亠人人十
埔	土甫
扼	扌厂巳
吱	口十又
竺	⺮二
綢	絲周土口
霏	雨非
蛟	虫亠八乂
圃	圍甫
鋤	金且力
誕	言廴丿止
瘸	疒力口冂人人
琢	王豕
酉	酉
棘	木冂木冂
蚌	虫丰
虜	虎田力
吋	口寸
夥	日木夕夕
譁	言艹一艹工
辮	辛絲辛
恍	忄小尤
貽	貝厶口
糠	米广彐氵
渺	氵目小丿
瀛	氵亡口月女凡
祀	礻巳
瓏	王龍
琅	王丶艮
苛	艹丁口
苓	艹人之
丕	不一
唬	口虎
夭	丿大
姍	女冂艹
橡	木⺈口豕
眩	目亠幺
弈	亠川八艹
拈	扌卜口
茸	艹耳
倔	亻尸凵山
諜	言廿乚木
艱	廿口夫艮
貂	豸刀口
諒	言亠口小
耙	三小巴
跋	足大又丶
踱	足广廿又
叭	口八
恢	忄大火
彝	彑米絲艹
綰	絲宀㠯
磯	石絲絲戈人
旌	方𠂉生
孜	子攵
踐	足戈戈
舵	舟宀匕
廝	广其斤
寐	宀爿二小
璃	王亠乂凵冂厶
荻	艹犭火
懈	忄⺈用刀牛
漕	氵艹日日
磐	舟殳石
宦	宀臣
漱	氵木口欠
櫥	木广士口䒑寸
諱	言韋口㐄
庶	广廿灬
癬	疒魚羊
馭	馬又
掄	扌人一冂艹
釜	八乂王丷
騫	宀甘八馬
釐	二小攵厂甲二
茉	艹一木
隸	木示彐氵
匾	匚户冂艹
膳	月羊䒑口
濡	氵雨而
蕪	艹𠂉廿灬
恃	忄土寸
淞	氵木八厶
頹	禾儿頁
舀	爪臼
閑	門木
搔	扌又丶虫
矇	目艹冖一豕
縈	火火冖絲
嬪	女宀一小貝
梧	木工㇕口
匝	匚巾
羈	四革馬
屹	山𠂉乙
頃	匕頁
鯉	魚甲二
灸	⺈丶火
甦	一日乂生
熹	士口䒑灬
鵲	廿日鳥
鑰	金人一口口口冂艹
焙	火立口
蹈	足爪臼
牡	牛土
秧	禾冂大
飢	食几
狸	犭甲二
訥	言冂人
沼	氵刀口
襠	衤小冖口田
毗	田匕匕
慫	行人人止心
懲	行山一王攵心
炬	火匚㇕
逞	之口王
曖	日爪冖心夂
簧	⺮廿由八
鰭	魚者匕日
窘	穴尹口
赦	土川八攵
柚	木由
溯	氵䒑凵月
宙	宀由
斟	其乚冫十
柑	木甘
匿	匚艹大口
剔	日勹彡刂
眷	半目
癸	癶一大
緞	絲亻三殳
馴	馬川
顱	虎田皿頁
嘲	口十日十月
噤	口木木示
弒	乂木丶弋工
諭	言人一月刂
謬	言习习人彡
甕	亠乡隹瓦
噩	王口口口口
鬚	長彡彡頁
蟒	虫艹大丶艹
偵	亻卜貝
攆	扌夫夫車
巔	山十且八頁
燮	言火火又
汲	氵㇆人
筷	⺮忄㇕大
輿	臼車八
詭	言⺈厂巳
滔	氵爪臼
姣	女亠八乂
丐	一卜乚
檸	木宀心皿丁
硃	石牛小
戌	戊一
敝	水冂攵
壟	龍土
諮	言冫欠口
疹	疒人彡
炊	火欠
涕	氵丷弓亻
瑣	王小貝
摹	艹日大手
樞	木匚口口口
杵	木𠂉十
棣	木彐氵
羚	羊人之
渤	氵十冖子力
蝨	乙十虫虫
墟	土虎业
柿	木亠巾
綏	絲爪女
薔	艹土人人圍口
蹙	戊上小足
噪	口口口口木
頑	二儿頁
氖	气㇆丿
帛	白巾
膨	月士口䒑彡
甬	又用
琉	王亠厶川
抒	扌又㇕丨
酌	酉勹丶
榭	木身寸
鐺	金小冖口田
爍	火白幺幺木
沅	氵二儿
濠	氵亠口冖豕
嬉	女士口䒑口
殖	一夕十且
珀	王白
眶	目匚王
稼	禾宀豕
咎	夂卜口
絢	絲勹日
莓	艹𠂉母
嘈	口艹日日
馥	禾日𠂉日夂
粹	米亠人人十
祗	礻氏丶
穢	禾止戊一小
褂	衤土土卜
娼	女日日
鳶	弋鳥
叟	臼丨又
墾	豸艮土
廓	广亠口子阝
弼	弓一白弓
翡	非习习
曳	日乚丿
偕	亻匕匕白
羲	羊禾了戈
汾	氵八刀
藺	艹門隹
軾	車弋工
蛹	虫又用
儷	亻一冂丶一冂丶鹿
啖	口火火
籬	⺮亠乂凵冂厶隹
豚	月豕
熨	尸示寸火
犀	尸水牛
摯	土半丸手
冕	日⺈口儿
褶	衤习习白
髻	長彡士口
擂	扌雨田
檬	木艹冖一豕
咕	口十口
嘶	口其斤
昀	日勹冫
卹	丿皿卩
疝	疒山
孑	了一
槌	木之丿㠯
吮	口厶儿
芋	艹一寸
萎	艹禾女
榻	木日习习
嗡	口八厶习习
漣	氵之車
妤	女又㇕丨
訟	言八厶
燬	火臼工殳
巒	言絲絲山
吠	口大丶
囑	口尸水四勹虫
篷	⺮之夂丰
聆	耳人之
騁	馬由了
嗑	口土厶皿
稟	亠圍口禾
漳	氵立日十
沱	氵宀匕
卅	一川
碌	石彐水
颱	風厶口
燴	火人一四日
怠	厶口心
擄	扌虎田力
砰	石一丷十
曙	日四者
稽	禾尤匕日
簪	⺮七儿七儿日
偎	亻田展
恙	羊心
敞	小冂口攵
徙	行止止
嬴	亡口月女凡
祚	礻𠂉卜
巽	巳巳廿八
拇	扌母
兢	十口儿十口儿
觴	⺈用𠂉日一勹彡
汕	氵山
纓	絲貝貝女
綻	絲宀一止
磺	石廿由八
囂	口口頁口口
啜	口又又又又
螢	火火冖虫
壑	卜冖一八人口又土
峨	山手戈
濂	氵广䒑彐刂八
閨	門土土
姊	女丿乚亻
驪	馬一冂丶一冂丶鹿
嘖	口丰貝
謁	言日勹人乚
讒	言⺈口匕匕⺈口儿丶
愉	忄人一月刂
溥	氵甫寸
緇	絲巛田
捨	扌人舌
罔	冂䒑亡
衙	行工㇕口
懇	豸艮心
厝	厂廿日
鄙	口十圍口阝
勛	口貝力
餃	食亠八乂
桀	夕㐄木
澎	氵士口䒑彡
宥	宀大月
聿	彐二
頡	士口頁
骸	骨亠乡人
彿	行弓川
煽	火户习习
澱	氵尸廿八殳
檻	木臣⺮皿
隕	阝口貝
餉	食自口
狙	犭且
惶	忄白王
酣	酉甘
輒	車耳乚
杳	木日
顰	止小頁鬼十
煦	日勹口灬
庇	广匕匕
芥	艹人川
戍	戊丶
蝗	虫白王
鱷	魚王口口口口
床	广木
陋	阝一冂人乚
戮	习习人彡戈
壤	土亠口口甘𧘇
揖	扌口耳
攙	扌⺈口匕匕⺈口儿丶
愕	忄口口一了
紳	絲申
呷	口甲
唧	口艮卩
朧	月龍
詣	言匕日
烽	火夂丰
慨	忄艮七儿
乒	丘丿
朦	月艹冖一豕
粱	氵刀八米
峙	山土寸
征	行一止
詰	言士口
淒	氵一彐女
畦	田土土
庾	广臼人
掖	扌亠亻夂丶
柬	木四
犢	牛士四貝
逵	之土八土
秩	禾牛人
颯	立風
蕃	艹釆田
朽	木了
塹	車斤土
杞	木己
蛛	虫牛小
啡	口非
晦	日𠂉母
餿	食臼丨又
扉	户非
嫉	女疒矢
蓆	艹广廿巾
謨	言艹日大
垠	土艮
嗤	口凵一虫
幌	巾日小尤
篆	⺮彑豕
臼	臼
傭	亻广彐用
諷	言風
慚	忄車斤
怖	忄大巾
灶	火土
扈	户口巴
嫡	女亠丷冂十口
磬	士尸殳石
鍥	金丰刀大
哺	口甫
踝	足日木
叱	口匕
婢	女鬼十
婿	女㇕止月
挽	扌⺈口儿
氾	氵巳
歹	一夕
矗	十且十且十且
叨	口刀
晰	日木斤
鼬	臼巛由
閏	門王
揩	扌匕匕白
罈	牛山西日十
偃	亻匚日女
濛	氵艹冖一豕
蝸	虫咼
銻	金丷弓亻
氐	氏丶
酪	酉夂口
幔	巾日四又
渥	氵尸至
瑰	王鬼
蔗	艹广廿灬
嗓	口又又又木
籮	⺮四絲隹
膛	月小冖口土
幟	巾立日戈
蛻	虫八口儿
剿	巛日木刂
掣	牛巾刂手
娑	氵小丿女
蔬	艹㇕止亠厶川
俑	亻又用
腋	月亠亻夂丶
癒	疒人一月刂心
憫	忄門文
吆	口幺
憊	亻廿丿用心
舫	舟方
瀏	氵氏丶刀金刂
羿	习习艹
為	丷㇕㇕㇆灬
璜	王廿由八
拄	扌丶王
誡	言戈艹
吝	文口
渙	氵⺈冂八大
穹	穴弓
岫	山由
筵	⺮廴丿止
裊	鳥亠𧘇
矜	又㇕亻人丶㇕
掬	扌勹米
皿	皿
纂	⺮目大絲
徊	行圍口
鰓	魚田心
誨	言𠂉母
鬍	長彡十口月
嗽	口木口欠
悖	忄十冖子
耘	三小二厶
蜃	辰虫
銓	金人王
鏽	金彐片爿
鑾	言絲絲金
榴	木氏丶刀田
蹺	足土土土尤
伺	亻㇆一口
饑	食幺幺戈人
榛	木春禾
簍	⺮數女
筏	⺮亻戈
銬	金者了
奐	⺈冂八大
癩	疒木口⺈貝
淅	氵木斤
澹	氵⺈厂八言
禱	礻士㇕工一口寸
辟	尸口辛
姥	女者匕
欖	木臣⺮四見
譏	言幺幺戈人
坷	土丁口
莢	艹大人人
靄	雨言日勹人乚
顎	口口一了頁
嶄	山車斤
仆	亻卜
脯	月甫
痢	疒禾刂
汰	氵大丶
濯	氵习习隹
萼	艹口口一了
楔	木丰刀大
軻	車丁口
輻	車一口田
圳	土川
煉	火木四
甌	匚口口口瓦
峭	山小月
猥	犭田展
惺	忄日生
締	絲亠丷冖巾
嘩	口艹一艹工
僚	亻大丷日小
忿	八刀心
孵	氏丿丶卩丶爪子
紊	文絲
罄	士尸殳牛山
髯	長彡冂土
贅	丰力攵貝
魘	厂日月大丶鬼
齲	齒丿口冂厶
帷	巾隹
雉	矢隹
膈	月一口冂丷丁
寞	宀艹日大
櫓	木魚日
畸	田大丁口
箕	⺮其
匆	勹彡丶
壕	土亠口冖豕
涎	氵廴丿止
渲	氵宀二日
闋	門癶一大
耽	其冖儿
菅	艹宀㠯
猩	犭日生
詮	言人王
疵	疒止匕
遐	之㇕卜㇕又
袂	衤㇕大
霾	雨豸甲二
虔	虎文
鉸	金亠八乂
舶	舟白
燎	火大丷日小
闔	門土厶皿
殃	一夕冂大
遏	之日勹人乚
銼	金人人土
舛	夕㐄
匕	匕
隘	阝䒑八皿
騾	馬田絲
檜	木人一四日
稈	禾日一十
鵠	牛口鳥
衢	行目目隹
譴	言之中一㠯
泌	氵心丿
礬	乂乂木木大石
岷	山巳七
贍	貝⺈厂八言
俘	亻爪子
狩	犭宀寸
蠡	彑豕虫虫
殆	一夕厶口
鬃	長彡宀示
晌	日自口
睫	目一彐止
飭	食𠂉力
琍	王禾刂
蝠	虫一口田
鑣	金鹿灬
訛	言亻匕
靛	丰月宀一止
礪	石厂艹日冂厶
氦	气亠乡人
佯	亻羊
膀	月亠丷冖方
瀆	氵士四貝
姻	女圍大
繽	絲宀一小貝
鑒	臣⺮四金
贓	貝爿戈臣
耆	者匕日
捫	扌門
拚	扌厶艹
籤	⺮人人戈非一
夙	几一夕
腑	月广亻寸
噙	口人亠乂凵冂厶
訖	言𠂉乙
潼	氵立甲二
窒	穴至
翌	习习立
夔	䒑自止巳八夂
刈	乂刂
鍬	金禾火
舷	舟亠幺
鱔	魚羊䒑口
誑	言犭王
氓	亡巳七
豢	半豕
忱	忄冖儿
雇	户隹
閭	門口口
媳	女自心
蠹	一中冖石虫虫
荐	艹大丨子
庖	广勹巳
埂	土一日乂
琥	王虎
賁	十艹貝
俟	亻厶矢
懾	忄耳耳耳
汙	氵一寸
缶	牛山
鏤	金數女
忝	一大忄
躡	足耳耳耳
喱	口厂甲二
鴛	夗鳥
誣	言工人人
諍	言⺈彐
怵	忄木丶
湍	氵山而
輟	車又又又又
僻	亻尸口辛
鏃	金方𠂉矢
鶉	亠口子鳥
羯	羊日勹人乚
拯	扌㇕水一
俸	亻春工
翱	白大十习习
奠	丷酉大
肱	月大厶
瘧	疒虎匚
邕	巛口巴
茱	艹牛小
梔	木斤一巴
楹	木㇆丿又皿
僥	亻土土土尤
倖	亻土半
慍	忄圍人皿
玟	王文
礎	石木木㇕止
矽	石夕
蛭	虫至
骰	骨殳
鏜	金小冖口土
飧	夕食
訕	言山
翩	户冂艹习习
祟	凵山示
殉	一夕勹日
剋	十口儿刂
皰	皮勹巳
苒	艹冂土
箔	⺮氵白
輦	夫夫車
牲	牛生
氳	气圍人皿
牒	片廿乚木
漩	氵方𠂉㇕止
玳	王亻弋
礫	石白幺幺木
賄	貝大月
悵	忄長
涸	氵圍十口
攘	扌亠口口甘𧘇
歟	臼一乚丨八欠
鐲	金四勹虫
剜	宀夗刂
苣	艹匚㇕
芍	艹勹丶
菩	艹立口
蠔	虫亠口冖豕
哂	口西
佣	亻用
仞	亻刀丶
冽	冫一夕刂
喳	口木日一
鏗	金臣又土
戾	户大丶
亟	了口又一
蘑	艹广木木石
輾	車尸艹展
跛	足皮
顓	山而頁
鎔	金穴人口
鯽	魚艮卩
憬	忄日亠口小
愀	忄禾火
湮	氵西土
闡	門口口日十
亙	二⺈冫
撻	扌之土羊
蒞	艹氵亻立
盹	目七凵
脩	亻丨夂月
謗	言亠丷冖方
寤	宀爿工㇕口
盎	冂大皿
灤	氵言絲絲木
繕	絲羊䒑口
歿	一夕勹又
逕	之一巛工
哮	口者子
乓	丘丶
誥	言牛口
狡	犭亠八乂
蹶	足厂䒑凵欠
蹋	足日习习
篡	⺮目大厶
俚	亻甲二
魷	魚尤
鰻	魚日四又
恣	冫欠心
紂	絲寸
胄	由月
矚	目尸水四勹虫
笆	⺮巴
竣	立厶八夂
悸	忄禾子
煬	火日一勹彡
韭	非一
睨	目臼儿
倌	亻宀㠯
肪	月方
孺	子雨而
緝	絲口耳
殮	一夕人一口口人人
儼	亻口口厂㇕耳攵
皎	白亠八乂
瘓	疒⺈冂八大
癆	疒火火冖力
蜇	扌斤虫
莒	艹口口
橇	木毛毛毛
翳	匚矢殳习习
賑	貝辰
崛	山尸凵山
篁	⺮白王
偌	亻艹大口
釧	金川
諺	言立丿彡
庵	广大日乚
隧	阝之丷豕
靨	厂日月大丶石圍卜丨
蜈	虫口一大
冑	由冂二
澧	氵日刂一口䒑
屜	尸行廿乚
姒	女厶人
枋	木方
惰	忄大工月
懺	忄人人戈非一
蚤	又丶虫
婊	女丰𧘇
斡	十日十人冫十
韃	革之土羊
轅	車土口𧘇
栩	木习习
睞	目木人人
僖	亻士口䒑口
倏	亻丨夂大丶
蕨	艹厂䒑凵欠
茴	艹圍口
藐	艹豸白儿
酵	酉者子
蛔	虫圍口
匈	勹乂凵
醞	酉圍人皿
叵	匚口
齦	齒艮
唾	口千艹二
惚	忄勹彡心
瑙	王巛鬼乂
棹	木卜日十
蜥	虫木斤
蛀	虫丶王
螟	虫冖日亠八
黍	禾人水
緘	絲戊一口
攣	言絲絲手
轂	士冖一車殳
佇	亻宀丁
鈐	金人丶㇕
貉	豸夂口
瀕	氵止小頁
妊	女丿士
櫛	木⺮艮卩
斫	石斤
咻	口亻木
箴	⺮戊一口
飴	食厶口
訝	言牙
淙	氵宀示
嫦	女小冖口巾
弁	厶艹
賒	貝人示
慷	忄广彐氵
寥	宀习习人彡
摑	扌圍戈口一
蔑	艹四戊丶
砥	石氏丶
迄	之𠂉乙
鴕	鳥宀匕
咫	尸丶口八
搪	扌广彐口
噫	口立日心
瞰	目㇕耳攵
僮	亻立甲二
佗	亻宀匕
塾	亠口子丸土
旎	方𠂉尸匕
壅	亠乡隹土
懦	忄雨而
繚	絲大丷日小
繹	絲四土半
藹	艹言日勹人乚
爰	爪一大又
鏘	金爿夕寸
詼	言大火
狽	犭貝
羔	羊灬
騖	又㇕亻攵馬
盂	一寸皿
髦	長彡毛
萸	艹臼人
卮	斤一巳
詬	言斤一口
癥	疒行山一王攵
綵	絲爪木
娓	女尸毛
蘚	艹魚羊
籟	⺮木口⺈貝
榫	木隹十
蹊	足爪幺大
肴	乂大月
諂	言⺈臼
痿	疒禾女
湃	氵手一丰
祉	礻止
擻	扌數女攵
睪	四土半
釁	臼冂一口酉八刀
啻	亠丷冖巾口
旖	方𠂉大丁口
姘	女䒑艹
稔	禾人丶㇕心
詫	言宀丿七
疚	疒⺈丶
瀋	氵宀釆田
啾	口禾火
崙	山人一冂艹
腱	月廴彐二
鱸	魚虎田皿
瘁	疒亠人人十
漓	氵亠乂凵冂厶
闆	門口口口
迂	之一寸
菰	艹子瓜
鐮	金广䒑彐刂八
洌	氵一夕刂
袒	衤日一
櫚	木門口口
囁	口耳耳耳
唳	口户大丶
篙	⺮亠口冂口
氛	气八刀
嬤	女广木木幺
垃	土立
牘	片士四貝
佃	亻田
膺	广亻隹月
洱	氵耳
邏	之四絲隹
琶	王王巴
稷	禾田八夂
簣	⺮中一貝
痙	疒一巛工
讖	言人人戈非一
燻	火千四二灬
沮	氵且
轡	車絲絲口
鞅	革冂大
骯	骨亠几
酋	丷酉
并	䒑艹
檳	木宀一小貝
匱	匚中一貝
踵	足千日二
罹	四忄隹
臏	月宀一小貝
懊	忄自米大
瀰	氵弓一八巾乂乂乂乂
遽	之虎豕
陛	阝匕匕土
萄	艹勹牛山
薜	艹尸口辛
囈	口艹土八土丸二厶
崆	山穴工
銖	金牛小
獺	犭木口⺈貝
芻	勹凵勹凵
惻	忄貝刂
闈	門韋口㐄
嫵	女𠂉廿灬
舂	春臼
璦	王爪冖心夂
橢	木阝大工月
豕	豕
呎	口尸丶
冗	冖几
蓀	艹子丿絲
鮫	魚亠八乂
瘴	疒立日十
憚	忄口口日十
媼	女圍人皿
絀	絲凵山
酊	酉丁
笞	⺮厶口
侮	亻𠂉母
胱	月小尤
肓	亡月
麴	木人人夕勹米
鑠	金白幺幺木
悴	忄亠人人十
梆	木丰阝
乩	卜口乚
呶	口女又
賂	貝夂口
疽	疒且
淄	氵巛田
逅	之斤一口
菽	艹上小又
苧	艹宀丁
蟆	虫艹日大
齪	齒足
鼾	自田一川一十
猷	丷酉大丶
葩	艹白巴
舐	舌氏
倨	亻尸十口
餒	食爪女
溉	氵艮七儿
赭	土川八者
桅	木⺈厂巳
嘹	口大丷日小
嚀	口宀心皿丁
庠	广羊
慟	忄千日二力
砧	石卜口
蟀	虫亠幺氵艹
惕	忄日勹彡
惘	忄冂䒑亡
惦	忄广卜口
潦	氵大丷日小
窠	穴日木
裨	衤鬼十
贗	厂亻鳥貝
蜓	虫廴丿士
褻	亠土八土丸𧘇
袞	亠八口𧘇
懍	忄亠圍口禾
蚩	凵一虫
殯	一夕宀一小貝
耒	三小
榷	木冖隹
奄	大日乚
窈	穴幺力
豉	一口䒑十又
劾	亠乡人力
憧	忄立甲二
孿	言絲絲子
荏	艹亻丿士
榔	木丶艮阝
燧	火之丷豕
遑	之白王
嗇	土人人圍口
駢	馬䒑艹
藪	艹數女攵
噥	口日刂辰
嗥	口白大十
颼	風臼丨又
駟	馬四
砭	石丿之
蟑	虫立日十
蚓	虫弓丨
憩	舌自心
臚	月虎田皿
紉	絲刀丶
葫	艹十口月
鞣	革又㇕亻木
饜	厂日月大丶食
嘗	小冖口匕日
牯	牛十口
囪	鬼彡丶
儈	亻人一四日
鷂	爪牛山鳥
麝	鹿身寸
沌	氵七凵
婀	女阝丁口
瑁	王日目
齷	齒尸至
喋	口廿乚木
悽	忄一彐女
悚	忄木口
驀	艹日大馬
囀	口車車寸
骷	骨十口
爨	臼冂一口木木大火
羸	亡口月羊凡
攫	扌目目隹又
齜	齒止匕
秣	禾一木
僭	亻七儿七儿日
樅	木行人人止
儔	亻士㇕工一口寸
羶	羊亠圍口日一
汨	氵日
閡	門亠乡人
譬	尸口辛言
摒	扌尸䒑艹
齬	齒工㇕口
瞑	目冖日亠八
穡	禾土人人圍口
穌	魚禾
阡	阝千
璩	王虎豕
豺	豸寸丿
獐	犭立日十
琺	王氵土厶
芟	艹殳
俎	人人且
肫	月七凵
彗	丰丰彐
鞦	革禾火
躉	艹日冂厶足
泱	氵冂大
鴆	冖儿鳥
帚	彐冖巾
茁	艹凵山
檄	木白方攵
竽	⺮一寸
咨	冫欠口
逖	之犭火
羋	丨卜卜工
靼	革日一
吩	口八刀
簞	⺮口口日十
佞	亻二女
諉	言禾女
瘍	疒日一勹彡
闐	門十且八
縊	絲䒑八皿
戛	一自戈
璣	王幺幺戈人
蚪	虫冫十
吒	口丿七
倥	亻穴工
猓	犭日木
褥	衤辰寸
孀	女雨木目
菠	艹氵皮
嚶	口貝貝女
跚	足周周一
牖	片户甫
徨	行白王
阱	阝二川
皴	厶八夕皮
黜	四二灬凵山
兗	亠八口儿
磋	石羊工
徘	行非
烊	火羊
鄹	耳又乑阝
彫	周土口彡
紜	絲二厶
嚨	口龍
鏍	金田絲
滓	氵宀辛
娌	女甲二
槨	木亠口子阝
踴	足又用力
驃	馬西示
恫	忄冂一口
憔	忄隹灬
雹	雨勹巳
橄	艹㇕耳攵
皚	白山一口䒑
揆	扌癶一大
婪	木木女
碉	石周土口
譎	言又㇕亻冂八口
奘	爿士大
痱	疒非
疙	疒𠂉乙
湔	氵䒑月刂
潺	氵尸子子子
覲	廿口丰見
劬	勹口力
恿	又用心
坍	土周亠
蚶	虫甘
曷	日勹人乚
侈	亻夕夕
鰍	魚禾火
忖	忄寸
惆	忄冂土口
閂	門一
邐	之一冂丶一冂丶鹿
齟	齒且
鸚	貝貝女鳥
蚵	虫丁口
蛄	虫十口
蠣	虫厂艹日冂厶
俳	亻非
屐	尸行十又
瞽	士口䒑十又目
氤	气圍大
臆	月立日心
徇	行勹日
腆	月冂廿八
遨	之丰力攵
駑	女又馬
匏	大一了勹巳
尷	尤臣⺮皿
蝴	虫十口月
鴦	冂大鳥
峰	山夂丰
飩	食七凵
餾	食氏丶刀田
胛	月甲
獰	犭宀心皿丁
詁	言十口
訃	言卜
疳	疒甘
惴	忄山而
窕	穴氵儿
鼙	士口䒑十又鬼十
鴣	十口鳥
蕈	艹西日十
楫	木口耳
呻	日申
咄	口凵山
骼	骨夂口
饅	食日四又
餛	食日匕匕
狎	犭甲
麾	广木木毛
瑚	王十口月
琿	王冖車
螞	虫馬
蜘	虫矢口
唁	口言
鈸	金大又丶
鰱	魚之車
粳	米一日乂
麩	木人人夕夫
歙	人一口习习欠
諄	言亠口子
媲	女鬼乂匕匕
繅	絲巛日木
盍	土厶皿
萵	艹咼
傀	亻鬼
飪	食丿士
胭	月圍大
謄	月半言
悻	忄土半
圯	土巳
朮	十儿丶
堊	一业土
琵	王王匕匕
頊	王頁
拮	扌士口
頷	人丶㇕口頁
悌	忄丷弓亻
妣	女匕匕
赳	走凵
圾	土㇆人
柞	木𠂉卜
跆	足厶口
牝	牛匕
鏑	金亠丷冂十口
滂	氵亠丷冖方
嫘	女田絲
倀	亻長
皈	白斤又
槁	木亠口冂口
奩	大匚口口口
獗	犭厂䒑凵欠
愴	忄人户口
抉	扌㇕大
柩	木匚⺈丶
螳	虫小冖口土
咆	口勹巳
翕	人一口习习
夤	夕宀一由八
冢	冖豕
醺	酉千四二灬
喟	口田月
咐	口亻寸
甥	生田力
篾	⺮四戊丶
裟	氵小丿亠𧘇
弭	弓耳
媾	女甘冂土
霹	雨尸口辛
蚣	虫八厶
跎	足宀匕
嶝	山癶一口䒑
霑	雨氵卜口
犧	牛羊禾了戈
蚱	虫𠂉卜
罟	四十口
髏	骨數女
磴	石癶一口䒑
臃	月亠乡隹
愎	忄𠂉日夂
軛	車厂巳
苜	艹目
霎	雨立女
蜿	虫宀夗
簸	⺮其皮
惋	忄宀夗
泅	氵圍人
靂	雨厂禾禾止
兕	冂一冂尤
鄱	釆田阝
賃	亻丿士貝
墀	土尸水牛
挈	丰刀手
蟯	虫土土土尤
仃	亻丁
狷	犭口月
麋	鹿米
縲	絲田絲
瓠	大一了瓜
蚯	虫丘
蠕	虫雨而
蹼	足业羊
儐	亻宀一小貝
鈽	金大巾
詆	言氏丶
鬲	一口冂丷丁
螫	土川八攵虫
酩	酉夕口
戢	口耳戈
躂	足之土羊
刎	勹彡刂
簑	⺮亠日𧘇
颺	風日一勹彡
膾	月人一四日
褸	衤數女
擘	尸口辛手
綞	絲千艹二
縑	絲䒑彐刂八
鵡	一弋止鳥
餞	食戈戈
剽	西示刂
枇	木匕匕
砝	石土厶
蟈	虫圍戈口一
愜	忄匚大人人
枸	木勹口
詛	言且
瘩	疒艹人一口
疥	疒人川
迢	之刀口
畚	厶大田
梃	木廴丿士
櫝	艹士四貝
嶇	山匚口口口
幗	巾圍戈口一
鴒	人之鳥
愾	忄气米
紇	絲𠂉乙
坼	土斤丶
嫗	女匚口口口
鬨	刂王王廿八
莠	艹禾㇆丿
螂	虫丶艮阝
暹	之日隹
佾	亻八月
胳	月夂口
瘠	疒氵人月
杷	木巴
颶	風且八
鷥	絲絲鳥
慄	忄西木
黠	四二灬士口
麂	鹿几
毽	毛廴彐二
猖	犭日日
孱	尸子子子
瞠	目小冖口土
覬	山一口䒑見
侏	亻牛小
坩	土甘
蓿	艹宀亻一白
戡	其乚戈
蜻	虫丰月
鍰	金爪一大又
猾	犭骨
戕	爿戈
痊	疒人王
洶	氵勹乂凵
疋	㇕止
隍	阝白王
噱	口虎豕
黝	四二灬幺力
缽	牛山木一
蹉	足羊工
鰥	魚四水
漯	氵田絲
貲	止匕貝
鐃	金土土土尤
鷓	广廿灬鳥
糢	米艹日大
萋	艹一彐女
鯧	魚日日
邂	之⺈用刀牛
岌	山㇆人
舨	舟斤又
赧	土川八卩又
幛	巾立日十
剴	山一口䒑刂
玷	王卜口
嚅	口雨而
箝	⺮扌甘
佝	亻勹口
傯	亻鬼夂心
髭	長彡止匕
傖	亻人户口
匐	勹一口田
陲	阝千艹二
嚏	口十冖田㇕止
佻	亻氵儿
盥	臼水皿
仳	亻匕匕
袈	力口亠𧘇
耜	三小㠯
胴	月冂一口
壢	土厂禾禾止
鵪	大日乚鳥
訐	言一十
犖	火火冖牛
蹂	足又㇕亻木
猙	犭爪彐
袱	衤亻大丶
遴	之米夕㐄
紼	絲弓川
駙	馬亻寸
鏝	金日四又
嗾	口方𠂉矢
妁	女勹丶
捩	扌户大丶
豌	一口䒑宀夗
躊	足士㇕工一口寸
帑	女又巾
瞌	目土厶皿
濘	氵宀心皿丁
懣	氵廿巾人人心
抨	扌一丷十
蝌	虫禾冫十
矓	目龍
臾	臼人
淆	氵乂大月
酗	酉乂凵
伉	亻亠几
貊	豸一白
賅	貝亠乡人
睽	目癶一大
匍	勹甫
吁	口一寸
犒	牛亠口冂口
癘	疒艹日冂厶
娩	女⺈口儿
睥	目鬼十
臬	自木
祆	礻一大
螃	虫亠丷冖方
獷	犭广廿由八
蟋	虫釆心
鱖	魚厂䒑凵欠
陴	阝鬼十
犛	二小攵厂牛
軔	車刀丶
靦	石圍卜丨見
埤	土鬼十
琊	王牙阝
躇	足艹者
儡	亻田田田
圬	土一了
螻	虫數女
覦	人一月刂見
潸	氵木木月
霪	雨氵爪丿士
玀	犭四絲隹
遘	之甘冂土
慝	匚艹大口心
紕	絲匕匕
划	戈刂
躅	足四勹虫
肄	匕矢彐二
娠	女辰
蜴	虫日勹彡
鰾	魚西示
蝙	虫户冂艹
褫	衤斤虎
籐	⺮月半水
襤	衤臣⺮皿
怏	忄冂大
蜢	虫子皿
褓	衤亻口木
鏖	鹿金
崁	山土欠
孳	䒑幺幺子
鮪	魚大月
黷	四二灬士四貝
妯	女由
燐	火米夕㐄
簷	⺮⺈厂八言
鼴	臼巛匚日女
蹣	足廿巾人人
輊	車至
躑	足丷酉大阝
啕	口勹牛山
輜	車巛田
韁	革三田田
轔	車米夕㐄
舢	舟山
溘	氵土厶皿
甽	田川
躪	足艹門隹
坏	土不
撚	扌夕大丶灬
踟	足矢口
訌	言工
嫻	女門木
荸	艹十冖子
嚥	口廿口丬匕灬
谿	爪幺大八人口
塭	土日皿
跼	足尸㇆口
犄	牛大丁口
勗	日且力
篛	⺮弓冫弓冫
聱	丰力攵耳
鉋	金勹巳
迆	之也
綑	絲圍木
瞇	目之米
祐	礻大口
迺	之西
痺	疒鬼十
証	言一止
姪	女至
踫	足䒑业
痴	疒矢口
珮	王几一巾
痲	疒十儿十儿
虱	乙丿虫
倣	亻方攵
抬	扌厶口
韆	革之西大巳
瑯	王丶艮阝
瘉	疒人一月刂
徬	行亠丷冖方
伕	亻夫
鼇	丰力攵黽
餽	食鬼
櫂	木习习隹
偽	亻丷㇕㇕㇆灬
搾	扌穴𠂉卜
偺	亻夂卜日
濬	氵卜冖一八目
浬	氵甲二
嚮	乡丶艮阝自口
蘗	艹尸口辛木
啣	口牛止卩
貍	豸甲二
勦	巛日木力
梱	木圍木
霉	雨𠂉母
晒	日西
燄	⺈臼火火
鼕	士口䒑十又夂冫
玨	王王
囌	口艹魚禾
慇	斤彐㇆殳心
嬝	女鳥亠𧘇
